sqft_living,sqft_lot,floors,view,sqft_above,sqft_basement,price,yr_built
1180,5650,1,0,1180,0,221900,1955
2570,7242,2,0,2170,400,538000,1951
770,10000,1,0,770,0,180000,1933
1960,5000,1,0,1050,910,604000,1965
1680,8080,1,0,1680,0,510000,1987
5420,101930,1,0,3890,1530,1.23E+06,2001
1715,6819,2,0,1715,0,257500,1995
1060,9711,1,0,1060,0,291850,1963
1780,7470,1,0,1050,730,229500,1960
1890,6560,2,0,1890,0,323000,2003
3560,9796,1,0,1860,1700,662500,1965
1160,6000,1,0,860,300,468000,1942
1430,19901,1.5,0,1430,0,310000,1927
1370,9680,1,0,1370,0,400000,1977
1810,4850,1.5,0,1810,0,530000,1900
2950,5000,2,3,1980,970,650000,1979
1890,14040,2,0,1890,0,395000,1994
1600,4300,1.5,0,1600,0,485000,1916
1200,9850,1,0,1200,0,189000,1921
1250,9774,1,0,1250,0,230000,1969
1620,4980,1,0,860,760,385000,1947
3050,44867,1,4,2330,720,2.00E+06,1968
2270,6300,2,0,2270,0,285000,1995
1070,9643,1,0,1070,0,252700,1985
2450,6500,2,0,2450,0,329000,1985
1710,4697,1.5,0,1710,0,233000,1941
2450,2691,2,0,1750,700,937000,1915
1400,1581,1.5,0,1400,0,667000,1909
1520,6380,1,0,790,730,438000,1948
2570,7173,2,0,2570,0,719000,2005
2320,3980,2,0,2320,0,580500,2003
1190,1265,3,0,1190,0,280000,2005
2330,5000,1.5,0,1510,820,687500,1929
1090,3000,1.5,0,1090,0,535000,1929
2060,6659,1,0,1280,780,322500,1981
2300,3060,1.5,0,1510,790,696000,1930
1660,34848,1,0,930,730,550000,1933
2360,6000,2,0,2360,0,640000,1904
1220,8075,1,0,890,330,240000,1969
2620,7553,2,0,2620,0,605000,1996
2570,5520,2,0,2570,0,625000,2000
4220,24186,1,0,2600,1620,775000,1984
3595,5639,2,0,3595,0,861990,2014
1570,2280,2,0,1570,0,685000,1922
1280,9656,1,0,920,360,309000,1959
3160,13603,2,0,3160,0,488000,2003
990,8528,1,0,990,0,210490,1966
2290,13416,2,0,2290,0,785000,1981
1250,5963,1,0,1250,0,450000,1953
2753,65005,1,2,2165,588,1.35E+06,1953
1190,9199,1,0,1190,0,228000,1955
3150,9134,1,0,1640,1510,345000,1966
1410,4080,1,0,1000,410,600000,1950
1980,8550,1,0,990,990,585000,1981
2730,6000,1.5,0,2130,600,920000,1927
2830,5000,2,0,2830,0,885000,1995
2250,4495,2,0,2250,0,292500,2008
2420,4750,2,0,2420,0,301000,2003
3250,14342,2,4,3250,0,951000,1968
1850,9976,2,0,1850,0,430000,1991
2150,21235,1,3,1590,560,650000,1959
1260,8400,1,0,1260,0,289000,1954
2519,8690,2,0,2519,0,505000,1973
1540,1044,3,0,1540,0,549000,2014
1660,6000,1,0,1110,550,425000,1979
2770,3809,1.5,0,1770,1000,317625,1925
2720,11049,2,0,2720,0,975000,1989
2240,4648,2,0,2240,0,287000,2005
1000,12070,1,0,1000,0,204000,1968
3200,20158,1,0,1600,1600,1.33E+06,1965
4770,50094,1,0,3070,1700,1.04E+06,1973
1260,5612,1,0,1260,0,325000,1972
2750,7807,1.5,0,2250,500,571000,1916
2380,5000,2,0,2380,0,360000,2005
1790,50529,1,0,1090,700,349000,1965
3430,35102,2,0,2390,1040,832500,1986
1760,7300,1,0,880,880,380000,1956
1040,5060,1,0,1040,0,480000,1941
1410,5060,1,0,910,500,410000,1956
3450,39683,2,0,3450,0,720000,2002
2350,5100,2,0,2350,0,390000,2003
1900,5889,2,0,1900,0,360000,1992
2020,6720,1,0,1010,1010,355000,1948
1680,8712,1,0,1680,0,356000,1964
960,6634,1,0,960,0,315000,1952
2140,3600,2,0,1900,240,940000,1925
2660,8400,1.5,0,2660,0,305000,1961
2770,6278,2,0,1980,790,461000,2006
1610,2040,2,0,1610,0,215000,1979
1030,1066,2,0,765,265,335000,2006
1980,7403,2,0,1980,0,243500,1988
3520,6353,2,0,3520,0,1.10E+06,2001
1200,10500,1,0,1200,0,153000,1962
1580,5000,1,0,1290,290,430000,1939
1580,5000,1,0,1290,290,700000,1939
3300,10250,1,0,2390,910,905000,1946
1960,15681,1,0,1960,0,247500,1967
1160,6400,1,0,1160,0,199000,1975
1810,41800,1,0,1210,600,314000,1980
2320,36847,2,2,2320,0,437500,1992
2070,13241,1.5,0,1270,800,850830,1910
1980,3478,1.5,0,1440,540,555000,1929
2190,107593,2,0,2190,0,699950,1983
2920,8113,2,0,2920,0,1.09E+06,1950
1210,33919,1,0,1210,0,290000,1954
2340,10005,1,0,1460,880,375000,1978
1670,4005,1.5,0,1170,500,460000,1939
1240,2493,1,0,1240,0,188500,1985
3140,28037,2,0,3140,0,680000,1991
2030,12342,2,0,2030,0,470000,1942
2310,9624,2,0,2310,0,597750,1984
1260,3328,1,0,700,560,570000,1905
1540,12600,1,0,1160,380,272500,1980
2080,5969,1,2,1080,1000,329950,1971
3230,16171,2,3,2520,710,480000,2001
4380,6350,2,0,2780,1600,740500,1900
1590,1102,3,0,1590,0,518500,2010
880,6780,1,0,880,0,205425,1945
1570,9600,1,0,1570,0,171800,1950
1610,2982,1.5,0,1610,0,535000,1925
2400,6474,1,2,1560,840,660000,1964
1450,9132,1,0,1450,0,391500,1987
770,6000,1,0,770,0,395000,1953
2100,4400,1.5,0,1720,380,445000,1924
2910,10204,2,0,2910,0,770000,1990
2750,17789,1.5,0,1980,770,1.45E+06,1914
2100,8201,1,2,1620,480,445000,1967
2160,8811,1,0,1360,800,260000,1978
2320,4960,2,0,1720,600,822500,1926
2070,4310,2,0,2070,0,430000,2004
1060,7875,1,0,1060,0,212000,1986
2010,9603,1,0,1440,570,660500,1986
3950,111078,1.5,0,2460,1490,784000,1989
2010,2287,2,0,1390,620,453246,2014
2140,2278,3,0,2140,0,675000,2005
1320,17390,1,0,1320,0,199000,1956
2020,7840,1,0,1010,1010,220000,1968
2590,10002,1,0,1340,1250,452000,1968
1190,4440,1,0,1190,0,382500,1981
1170,1249,3,0,1170,0,519950,2014
1110,3200,1,0,1110,0,665000,1925
2820,9375,1,0,1550,1270,527700,1968
1610,8579,1,0,1010,600,205000,1962
1060,8097,1,0,940,120,420000,1923
2030,8517,1,0,1380,650,500000,1961
3670,315374,2,0,3670,0,921500,1994
2550,4000,2,0,2370,180,890000,1905
2420,60984,2,0,2420,0,430000,2007
2260,12500,1,0,1130,1130,258000,1960
1430,3455,1,0,980,450,511000,1947
1360,3090,2,0,1360,0,532170,1990
1110,5000,1.5,0,1110,0,560000,1947
1250,8200,1,0,1250,0,282950,1954
5180,19850,2,3,3540,1640,2.25E+06,2006
700,5100,1,0,700,0,350000,1942
1180,7669,1,0,1180,0,215000,1967
3960,25245,2,0,2500,1460,650000,1996
2640,7500,1,0,1620,1020,320000,1967
1270,7198,1.5,0,1270,0,247000,1916
1760,11180,1,0,1760,0,320000,1968
2060,8632,1,0,1030,1030,255000,1962
1780,9660,1,0,1780,0,438000,1962
3400,16603,2,0,3400,0,900000,2000
1910,7280,1,0,1160,750,441000,1979
2020,38332,1,0,1010,1010,420000,1975
1580,7000,1,0,1180,400,370000,1976
1340,7250,1,0,700,640,269950,1949
2680,4499,2,0,2680,0,807100,1999
2680,9750,1,0,1610,1070,653000,1979
1370,8336,1,0,1370,0,371500,1964
1560,21000,1,0,1560,0,284000,1954
2160,7140,1,0,1670,490,272000,1978
1340,7912,1.5,0,1340,0,313000,1955
3880,35003,2,0,2570,1310,917500,1984
2590,8190,2,0,2590,0,673000,1980
1120,1100,2,0,820,300,425000,2008
1970,5400,1,0,1320,650,399950,1986
1220,4800,1,0,1220,0,385000,1901
1950,7560,1,2,1320,630,269950,1975
1350,8220,1,0,1060,290,330000,1949
1670,5797,2,0,1670,0,260000,1988
2380,5125,1.5,0,1680,700,470000,1925
2440,9600,2,0,2440,0,589000,1961
1050,3419,2,0,1050,0,163500,1996
3130,13412,2,0,2140,990,835000,1993
4090,12850,1,2,2090,2000,1.10E+06,1986
1490,10000,1,0,1100,390,269000,1969
1900,8744,2,0,1900,0,560000,1987
1330,2400,1.5,0,1330,0,615000,1901
2230,10026,1,0,1430,800,585188,1975
1650,9480,1,0,1220,430,305000,1977
1190,8820,1,0,1190,0,166950,1959
2140,9897,1,0,2140,0,799000,1959
2180,7508,1,0,1420,760,400000,1962
1060,10228,1,0,1060,0,230000,1948
1690,5025,2,0,1690,0,256883,2003
1970,6480,1.5,0,1130,840,423000,1920
2150,4084,2,0,2150,0,465000,2007
1910,66211,2,0,1910,0,440000,1997
1350,155073,1,0,1350,0,385000,1969
860,11725,1,0,860,0,210000,1943
1940,14952,2,0,1940,0,297000,1994
1010,5000,1,0,1010,0,470000,1952
1300,7370,1,0,900,400,226500,1976
910,8450,1,0,910,0,274250,1962
2480,11010,1,0,1630,850,840000,1966
2440,4587,2,0,2440,0,677900,2010
1010,5864,1,0,1010,0,425000,1915
900,9600,1,0,900,0,180250,1941
2300,3404,2,0,1600,700,464000,1920
1550,7579,2,0,1550,0,320000,1993
1270,1566,2,0,1060,210,625504,2014
2240,12032,1,0,2240,0,592500,1983
2714,17936,2,0,2714,0,465000,2005
1720,6270,2,0,1720,0,477000,1978
850,16400,1,0,850,0,280000,1923
3300,33474,1,3,1870,1430,1.51E+06,1957
2250,5692,2,0,2250,0,445838,2000
3900,14864,1,3,1950,1950,1.07E+06,1947
1320,10800,1,0,1320,0,467000,1947
2760,6440,2,0,2760,0,686000,1999
1750,9750,1,0,1350,400,279950,1961
2330,19436,2,0,2330,0,527000,1987
2220,16020,1,0,1780,440,325000,1966
2020,8379,2,0,2020,0,328000,1994
1250,7500,1,0,1250,0,390000,1942
1510,6516,1,0,1510,0,479950,2005
1720,9753,1,0,1120,600,264950,1978
1430,15246,1,0,980,450,235000,1961
1480,4729,2,0,1480,0,516500,2004
1450,15798,2,4,1230,220,655000,1915
2280,15347,1,0,2280,0,500000,1960
2940,7350,1,0,1780,1160,315000,1978
1000,10200,1,0,1000,0,213000,1961
2480,5280,1.5,0,1620,860,475000,1947
3760,28040,2,0,3760,0,1.03E+06,1983
2220,94300,1,0,1640,580,416000,1976
1970,4740,1.5,0,1670,300,410000,1904
3830,221284,2,0,3530,300,800000,1993
4410,14034,1,2,2350,2060,472000,1965
1430,8505,1,0,1430,0,225000,1968
830,6000,1,0,830,0,210000,1940
1430,5000,1.5,0,1430,0,455000,1925
1300,8316,1,0,1300,0,225000,1954
1030,3060,1,2,790,240,480000,1918
2740,11872,2,0,2740,0,363000,1990
3650,8354,1,4,1830,1820,2.40E+06,2000
720,5120,1,0,720,0,181000,1954
2010,7312,1,0,2010,0,250000,1976
1560,3000,1,0,770,790,481000,1918
1810,7209,1,0,1240,570,260000,1978
3360,7685,2,0,3360,0,455000,2001
1510,36224,2,0,1510,0,415000,1991
1400,3538,1,0,800,600,349500,1953
1730,7442,2,0,1730,0,245000,1987
1420,9191,1.5,2,1420,0,592500,1928
2360,7620,1,0,1180,1180,385000,1955
1580,11455,1,0,1200,380,315000,1974
1230,10170,1,0,1230,0,255000,1979
2460,4425,2,0,2460,0,693000,2006
1660,4400,1.5,0,1460,200,780000,1911
1270,8470,1,0,1270,0,237000,1960
2100,40510,2,0,1320,780,525000,1979
770,5040,1,0,770,0,425000,1930
760,10079,1,4,760,0,369900,1936
1700,7280,2,0,1700,0,290000,1988
1120,10701,1,0,1120,0,285000,1954
1070,4500,1,0,1070,0,415000,1937
2070,9900,1,0,1420,650,272500,1979
5050,20100,1.5,2,4750,300,2.90E+06,1982
5310,57346,2,0,5310,0,1.37E+06,1989
1040,7538,1,0,1040,0,436000,1939
1700,11390,1,0,1700,0,210000,1967
1300,5898,1,0,1300,0,236000,1961
1080,1306,1,0,580,500,331000,1954
2653,4510,2,0,2653,0,365000,2006
2290,16258,1,0,2290,0,450000,1960
3820,26300,2,0,2850,970,770000,2014
2210,49375,1,0,2210,0,455000,1997
2390,6000,1,0,1240,1150,405000,1908
2600,11325,1,0,1610,990,304900,1969
860,5265,1,0,860,0,170000,1931
3830,8480,2,1,2630,1200,2.05E+06,1905
3500,7048,2,0,3500,0,780000,2005
2420,13959,1,0,1740,680,330000,1988
2720,8666,2,0,2720,0,370000,1992
2500,13500,1,0,1850,650,467000,1979
1670,6720,1,0,1140,530,405000,1980
2900,10300,1,0,1450,1450,675000,1985
1640,14100,1,0,1140,500,500000,1954
1890,15770,2,0,1890,0,389999,1968
2950,9025,1,2,1780,1170,630000,1975
2160,9528,2,0,2160,0,360000,1992
3280,11060,2,0,2270,1010,580000,1986
1970,4166,2,3,1270,700,550000,1929
3360,22111,2,0,3360,0,879000,1994
1320,8959,1,0,1320,0,265000,1993
2650,7286,2,0,2650,0,446500,1990
2030,8880,1,0,1330,700,404000,1963
1590,11914,1,2,1090,500,267500,1957
4550,18641,1,4,2600,1950,3.08E+06,2002
2440,7632,2,0,2440,0,335000,1998
1940,9000,1,0,970,970,576000,1948
2040,3810,2,0,2040,0,208633,2006
2200,8750,1,0,1120,1080,315000,1964
1920,3300,1,0,960,960,725000,1913
1800,7750,1,0,1400,400,550000,1965
2180,7297,2,0,2180,0,610750,1984
1010,5000,1.5,0,1010,0,550700,1908
3320,10574,2,0,2220,1100,665000,1960
2370,4000,1.5,2,1980,390,834000,1928
1660,78408,1.5,0,1660,0,201000,1915
3650,9050,2,4,3370,280,2.38E+06,1921
4290,12103,1,3,2690,1600,1.38E+06,1997
4290,12103,1,3,2690,1600,1.40E+06,1997
1950,7700,1,0,1350,600,305000,1979
2590,14052,1,0,1720,870,487000,1948
1930,64904,1,0,1930,0,390000,1988
1470,3864,1,0,1170,300,548000,1916
800,8775,1,0,800,0,268750,1943
3150,7119,2,0,3150,0,819900,2013
2030,16200,2,0,2030,0,520000,1984
1450,11204,1,0,1450,0,230000,2003
1510,10248,1,0,1510,0,240000,1969
1240,12092,1,0,960,280,232000,1922
1240,12092,1,0,960,280,240500,1922
3030,45004,2,0,3030,0,274975,1987
2050,4400,1.5,0,2050,0,740000,1922
1000,7636,1,0,1000,0,186375,1952
2370,10289,1,0,1590,780,790000,1977
2800,6750,2,0,1890,910,880000,1951
2240,11180,2,0,2240,0,279000,1955
1810,10530,1,2,1810,0,295000,1991
1070,5000,1,0,1070,0,640000,1924
2490,9525,2,0,2490,0,940000,1968
1960,5238,2,0,1960,0,260000,2003
2930,5569,1,0,1860,1070,559900,2004
1510,3500,1.5,0,1510,0,791500,1911
1420,8250,1,0,1420,0,265000,1954
1740,11547,1,0,1740,0,245000,1954
2560,43995,2,0,2560,0,485000,1962
3040,8414,2,0,2420,620,684000,2010
2500,6840,1,0,1300,1200,425000,1957
1275,20000,1,0,1275,0,309600,1991
2580,5823,2,0,2580,0,552250,2002
1000,7134,1,0,1000,0,165000,1943
1000,7134,1,0,1000,0,239900,1943
1070,32633,1,0,1070,0,320000,1930
1390,13464,1,0,1390,0,206600,1987
2500,7690,1,0,1250,1250,387000,1973
560,12120,1,0,560,0,299000,1967
2270,10460,2,0,2270,0,855000,1965
1900,14400,1,0,1300,600,315000,1954
990,3120,1,2,790,200,437500,1907
1550,19800,1,0,1050,500,252000,1969
2200,7475,1,0,1100,1100,375000,1955
1910,4862,2,0,1910,0,300000,2005
1750,9600,1.5,0,1750,0,420000,1954
1330,77972,1,0,1330,0,900000,1928
2440,5750,2,2,1980,460,679900,2000
1640,29970,2,0,1640,0,463000,1992
2760,11340,2,0,2760,0,380000,1978
1820,7912,2,0,1820,0,329500,1994
2110,5608,1,0,1340,770,604950,2013
3040,9570,1,2,1640,1400,795000,1966
1840,40438,2,0,1840,0,465000,1994
2990,10400,2,0,2990,0,673000,2002
3520,15420,2,0,3520,0,810000,1991
2440,69415,1,0,1910,530,785000,1989
2090,7500,1,0,1370,720,338000,1986
1430,7222,2,0,1430,0,280000,1993
2180,10754,1,0,1100,1080,315000,1954
2180,10754,1,0,1100,1080,530000,1954
3450,9914,2,0,3450,0,380000,2004
1450,7562,2,0,1450,0,297000,1994
3230,7331,2,0,3230,0,730000,2004
1640,13500,1,0,1110,530,450000,1940
1590,7750,1,0,1060,530,275000,1997
2020,2849,2,0,2020,0,595000,1960
1300,3348,1.5,0,1300,0,435000,1904
1380,209959,1,0,1380,0,270000,1954
4040,14338,2,0,3030,1010,950000,1986
2130,5337,2,0,2130,0,389000,2001
2550,7800,1,0,1580,970,560000,1968
4800,14984,2,2,3480,1320,1.35E+06,1998
2510,11585,2,0,2510,0,799000,1969
1410,9600,1,0,1410,0,365500,1983
1650,7352,1,0,1160,490,252350,1979
2120,13780,2,0,2120,0,403950,1993
2040,10726,1,0,1380,660,385000,1954
1550,7620,1.5,0,1550,0,345000,1957
1980,3128,2,0,1980,0,490000,1979
1600,26977,2,0,1600,0,330000,2005
3300,12090,2,0,3300,0,927000,1953
3840,16619,2,1,3840,0,1.12E+06,1983
1220,10000,1,0,1220,0,330000,1950
2720,8800,1,0,1500,1220,530000,1958
1940,25600,1,0,1940,0,365000,1962
2160,3000,1.5,0,1260,900,378750,1909
1530,8750,1.5,0,1530,0,269900,1968
1710,2096,2,0,1290,420,557000,2008
3730,16980,1,0,2150,1580,360000,1974
940,5000,1,0,940,0,352000,1937
1750,22357,2,0,1750,0,437000,1994
1820,6753,2,0,1820,0,322500,1994
1510,2000,2,0,1330,180,650000,2001
1290,1213,3,0,1290,0,450000,2001
1570,5250,1,0,1570,0,278500,1998
1930,6957,2,0,1930,0,364950,1995
2840,40139,1,4,2840,0,840000,1986
1550,8134,2,0,1550,0,268000,1991
833,143947,1,0,833,0,517534,2006
2990,32239,2,0,2990,0,632925,1978
2000,7251,2,0,2000,0,577500,1995
2390,7480,1.5,2,2390,0,339000,1920
2910,37461,1,0,1530,1380,570000,1967
2085,174240,1,0,1610,475,563500,1964
2200,9351,1,0,1290,910,423000,1962
1860,5028,2,0,1860,0,355000,2012
6070,171626,2,0,6070,0,1.55E+06,1999
950,3960,1,0,950,0,482000,1941
1600,9135,1,0,1600,0,625000,1955
2250,11632,2,0,2250,0,538000,1988
2280,10255,2,0,2280,0,380000,1985
940,5120,1,0,940,0,375000,1909
1530,8500,1,0,1030,500,245000,1996
2190,27260,1,0,2190,0,310000,1947
2350,15021,1,0,1770,580,1.30E+06,1976
1440,7680,1,0,1200,240,397000,1971
2200,4052,2,0,2200,0,365000,2005
2290,8250,2,0,2290,0,328500,1990
4040,19700,2,0,4040,0,988000,1987
2610,3277,1.5,0,1920,690,1.00E+06,1922
1490,2138,2,0,1490,0,237000,2005
2450,5280,2,0,2450,0,525000,2003
1710,9627,1,0,1440,270,749000,1976
4870,11800,2,0,3470,1400,722500,1983
3130,8750,2,0,3130,0,843000,1991
1270,1372,3,0,1270,0,438000,2000
2120,10875,1,2,1540,580,578000,1977
1670,8230,1,0,1670,0,227950,1954
2070,11576,2,0,2070,0,196000,1974
1420,5332,1,0,1070,350,641000,1953
1250,219978,1,0,1250,0,350000,1980
940,7980,1,0,940,0,205000,1960
1920,9102,1,0,1920,0,400000,1968
3545,9816,1,0,2610,935,1.03E+06,2005
1260,5460,1,0,1260,0,505000,1972
2340,7200,1,0,1300,1040,475000,1975
2590,9263,1,0,1440,1150,520000,1977
3970,24920,2,2,3260,710,1.45E+06,1977
1220,9732,1,0,1220,0,333500,1965
1400,10403,1,0,1400,0,232000,1976
2360,16117,1,0,1710,650,691100,1983
1870,9897,1,0,1870,0,811000,1960
2830,5802,2,0,2830,0,551000,2001
2260,3640,2,0,2260,0,496500,1994
1970,20978,2,3,1770,200,705000,1980
3140,9225,1,2,1770,1370,578000,1966
1240,8659,1,0,1240,0,255000,1986
3450,7832,2,0,3450,0,1.05E+06,2007
2570,8491,2,0,2570,0,348000,1989
1510,3413,2,0,1510,0,230000,1985
2390,11250,2,0,2390,0,359500,1988
980,7000,1,0,980,0,330000,1953
430,5050,1,0,430,0,80000,1912
1480,6360,1,0,1480,0,465000,1954
1850,7324,2,0,1850,0,325000,1997
2270,28025,1,0,1920,350,340500,1947
1810,5192,2,0,1810,0,342500,1993
1610,17600,2,0,1610,0,290900,1930
3840,6161,2,0,3840,0,868700,2000
4110,8400,2,1,3130,980,1.20E+06,1928
4190,10259,2,0,3150,1040,1.15E+06,2000
3390,6298,2,0,3390,0,859900,2011
1890,3006,2,0,1890,0,520000,2003
1610,2527,2,2,1080,530,460000,2005
1050,4590,1,0,850,200,438924,1949
630,6550,1,0,630,0,315000,1918
2910,10650,1,2,1780,1130,590000,1975
1700,8640,1,0,850,850,378500,1955
1950,8130,2,0,1950,0,328500,1990
2990,9773,2,0,2990,0,849950,1973
1350,6000,1,2,900,450,525000,1950
4860,181319,2.5,0,4860,0,1.39E+06,1993
2160,7725,1,0,1460,700,295000,1978
4860,11793,2,0,3860,1000,1.07E+06,1998
890,5000,1,0,890,0,207950,1917
2810,7302,2,0,2810,0,699900,2002
3400,9500,2,1,3400,0,1.28E+06,1977
1580,7350,1,0,960,620,452000,1963
1680,5036,1,1,1680,0,370000,1987
1300,11230,1,0,1300,0,232000,1968
2820,14062,2,0,2380,440,669950,1960
1510,6710,1,0,1070,440,397500,1972
1230,1391,2,0,870,360,490000,2004
2110,4140,2,0,1710,400,725000,1925
3080,19635,1,2,1610,1470,299000,1958
1490,5750,1.5,0,1190,300,625000,1900
2120,4500,2,0,2120,0,437500,2000
3180,5438,2,0,3180,0,650000,2003
1490,3825,1,0,860,630,475000,1929
1930,11947,1,0,1930,0,342000,1966
2770,7800,2,0,2770,0,1.20E+06,1999
1670,11610,1,0,1670,0,280000,1963
1330,7200,1,0,1330,0,240000,1993
1210,3328,1.5,0,1210,0,529000,1924
1190,5100,1,0,1030,160,442000,1941
1540,6872,1,0,820,720,615000,1946
4030,10800,2,0,4030,0,1.49E+06,2006
2430,7559,1,0,1580,850,585000,1981
2600,7787,2,0,2600,0,480000,2005
4410,57063,2,0,4410,0,1.10E+06,1990
1330,8184,1.5,0,1330,0,290000,1949
1900,5000,1,0,950,950,615000,1951
1100,7680,1,0,1100,0,300000,1950
1980,39150,1.5,0,1580,400,308000,1932
2400,7745,2,0,2400,0,750000,2001
4760,8036,2.5,0,3390,1370,2.25E+06,1916
3180,194278,2,0,3180,0,890000,2005
1190,7560,1,0,1190,0,288000,1958
630,6000,1,0,630,0,190000,1943
2530,5105,1,0,1520,1010,515000,2005
1690,11054,1,0,1690,0,235000,1930
940,5000,1,0,940,0,275000,1951
1240,9119,1,0,1240,0,727500,1952
3040,6587,2,0,3040,0,650000,2003
6050,230652,2,3,6050,0,1.60E+06,2001
1590,7085,1.5,0,1590,0,365000,1944
2500,36947,1,0,2500,0,662000,1984
1780,7848,1,0,1320,460,270500,1978
1360,1898,2,0,1360,0,200000,1978
4740,76230,2,0,4740,0,970000,1987
1010,9600,1,0,1010,0,160000,1962
1040,7405,1,0,1040,0,204000,1971
1610,6655,2,0,1610,0,358000,1985
1570,8268,1,0,1570,0,452000,1979
1510,4000,1,0,1010,500,595000,1900
1360,6082,1,0,1360,0,249000,1994
1970,5106,2,0,1970,0,346900,1999
5403,24069,2,4,5403,0,2.13E+06,1976
1560,4350,2,0,1560,0,280000,2003
2320,12000,1,0,2270,50,318888,1973
2120,40518,1,0,2120,0,530000,1967
2120,18500,2,0,2120,0,375000,1983
3350,29242,2,0,3350,0,910000,1988
2380,9614,2,0,2380,0,782000,1991
1070,649,2,0,720,350,259950,2008
2300,18360,1,0,1560,740,315000,1979
1320,8865,1,0,1320,0,215000,1943
2180,10221,1,2,1140,1040,705000,1946
4380,6320,2,3,3580,800,1.45E+06,1952
1790,9813,2,0,1790,0,451000,1949
750,8125,1,0,750,0,261000,1943
1300,8280,1,0,1300,0,396000,1956
2990,29170,2,3,2990,0,725000,1999
4640,15235,2,1,2860,1780,1.95E+06,1965
1400,7242,1.5,0,1400,0,238000,1959
2750,9563,2,0,2750,0,750000,1973
2050,10271,2,0,2050,0,331500,1998
2230,108900,1,0,1410,820,460000,1978
2340,217014,1,0,2340,0,404950,1982
2870,5163,2,0,2870,0,880000,2014
4120,22370,2,0,4120,0,863000,1997
2080,9162,1,0,1370,710,638700,1960
1840,5680,2,0,1840,0,435000,2008
1180,5350,1.5,0,1180,0,260000,1959
2160,4000,1.5,0,1530,630,671500,1927
1180,3400,1.5,0,1180,0,610000,1907
1160,15029,1,0,870,290,405000,1937
1830,5612,2,0,1830,0,338900,2003
3200,7708,2,0,3200,0,720000,2004
2560,5445,1.5,0,1760,800,442000,1927
2550,5040,1.5,0,2550,0,650000,1902
1330,9917,1,0,1040,290,263500,1981
1220,75794,1,0,1220,0,300000,1963
1805,3402,2,0,1805,0,266000,2009
6050,84942,2.5,2,4150,1900,930000,2009
2320,5493,2,0,2320,0,530000,2004
1384,8960,1,0,1384,0,180000,1965
2720,6439,2,0,2720,0,619000,2005
1820,10608,1,0,1820,0,264000,1962
2130,4920,1.5,4,1530,600,730000,1941
2060,10070,2,0,2060,0,439000,1975
1420,7500,1,0,1080,340,268500,1981
1510,15744,1,0,1510,0,330000,1985
2160,4000,1.5,0,1960,200,640000,1903
3180,12600,2,0,3180,0,900000,1978
2110,13300,2,0,2110,0,370000,1985
2060,2900,1.5,0,1330,730,685000,1931
1830,217800,1,0,1010,820,505000,1981
1820,32666,1,0,1820,0,265000,1966
1610,2937,2,0,1610,0,290000,2006
1780,3600,2,0,1780,0,296000,2006
1840,9611,2,0,1840,0,360000,1996
1460,10584,1,0,990,470,240500,1997
1400,2958,2,0,1400,0,372500,2007
3370,14402,2,2,3370,0,595000,2004
3590,8249,2,0,3590,0,515000,1997
3200,15367,2,0,3200,0,1.22E+06,1962
1670,6460,1,0,1670,0,507000,2004
2420,31465,1,0,2420,0,399950,1984
1430,10816,2,0,1430,0,185000,1994
1440,7070,1,0,1440,0,460000,1980
1450,4789,2,0,1450,0,435500,1985
3550,13938,1,0,2100,1450,469000,1966
1270,1175,2,0,1110,160,531000,2000
940,6804,1,0,940,0,443500,1949
1670,6824,1,0,1300,370,223000,1990
3100,15842,2,0,2400,700,590000,1996
1100,1760,3,0,1100,0,340000,1997
1870,3388,1,0,1230,640,650000,1925
1930,5080,2,0,1930,0,533600,1990
2540,4694,2,0,2540,0,695000,2005
1280,7524,1.5,0,1280,0,242000,1988
1820,8814,1,0,1280,540,425000,1967
1490,9414,2,0,1490,0,525000,1981
1880,5502,2,0,1880,0,485000,1988
1250,9775,1,0,1250,0,175000,1971
1440,7210,1,0,1440,0,210000,1983
1920,7415,2,0,1920,0,260000,1989
2060,5750,1,0,1330,730,577000,1976
1210,10588,1,0,1210,0,200000,1958
1760,5000,1,0,940,820,605000,1927
990,6750,1,0,990,0,325000,1947
960,6400,1,0,820,140,289500,1944
1660,1458,3,0,1660,0,559950,2014
1900,9375,1,1,1330,570,1.04E+06,1941
1270,2790,1,0,990,280,543500,1970
3250,34293,2,0,3250,0,480000,1983
960,9633,1,0,960,0,218000,1982
1330,6000,1,0,960,370,565000,1914
2080,7700,1,0,1600,480,426700,1968
2690,11575,1,3,2130,560,650000,1957
890,3060,1,0,770,120,542000,1910
1070,8000,1,0,1070,0,415000,1977
1200,8316,1,0,1200,0,214000,1953
1360,8910,2,0,1360,0,245000,1949
2050,13303,1,0,2050,0,314500,1993
3000,5750,2,0,2000,1000,1.12E+06,1924
1300,3850,1,0,800,500,378000,1963
2250,9091,1,0,1340,910,305000,1982
3740,6750,1,0,1980,1760,595000,1978
1660,1091,3,1,1530,130,729500,2015
2360,6699,2,0,2360,0,430000,2003
1760,6500,1,0,1150,610,240000,1987
1680,6200,1.5,0,1680,0,545000,1916
1320,2500,1,0,870,450,530000,1918
870,26326,1,0,870,0,157000,1939
1260,7645,1.5,0,1260,0,425000,1925
1000,6020,1,0,1000,0,220000,1944
2020,36400,1,0,1550,470,521000,1976
1920,6862,1,2,1120,800,325000,1952
2150,5400,1.5,0,1380,770,597500,1911
1470,3976,2,0,1470,0,337000,1999
3180,10492,2,2,3180,0,1.00E+06,1991
3930,55867,1,4,2330,1600,3.07E+06,1957
990,6000,1,0,990,0,495000,1943
2770,3330,2,0,1970,800,748000,2001
1250,8710,1,0,1250,0,888000,1953
1140,22267,1,0,1140,0,269900,1986
2250,14440,1,0,1550,700,496500,1967
1640,5097,2,0,1640,0,475000,1969
1255,1374,3,0,1255,0,312000,2004
1290,12231,1,0,1290,0,323000,1976
1300,9079,1,0,1300,0,331000,1986
1220,1086,3,0,1220,0,306000,2007
2630,4000,3,0,2630,0,655000,2002
1950,15954,1,0,1950,0,290000,1959
3160,5000,2,0,2360,800,1.25E+06,1965
1550,4708,1,0,860,690,460000,1949
1700,6380,1,0,850,850,435000,1940
2510,11880,1,0,1630,880,664000,1978
1800,4180,2,3,1800,0,865000,1921
1800,18000,1,0,1200,600,385000,1968
1870,9315,1,0,1350,520,497000,1975
1010,3000,1,0,1010,0,280000,1925
1120,17487,1,0,1120,0,188000,1924
2090,4755,1,2,1200,890,478500,1969
4370,18361,2,0,4370,0,1.15E+06,2001
1440,7187,1,0,970,470,222000,1981
2580,209523,2,0,2580,0,799000,1984
3190,7399,2,0,3190,0,609900,2006
2380,5809,2,0,1750,630,413000,1995
1420,4875,1.5,0,1420,0,400000,1930
2990,6768,2,0,2990,0,802541,2014
2680,7757,2,0,2680,0,320000,1990
2730,7649,2,0,2730,0,507000,2006
1220,8329,1,0,1220,0,387500,1946
1500,12616,1,0,1500,0,396000,1967
1830,11788,1,1,1430,400,373000,1958
4570,19252,2,0,4570,0,1.48E+06,1965
2470,7698,2,0,2470,0,359900,1983
800,4342,1,0,670,130,410000,1927
2900,23488,2,0,2900,0,690000,1992
1410,5760,1,0,1410,0,245000,1985
2830,25958,1,1,1610,1220,700000,1979
1680,9966,1,0,1100,580,268000,1977
1760,26055,1,0,920,840,225000,1979
2240,11034,2,0,2240,0,980000,1976
1380,5000,1.5,2,1380,0,795000,1905
820,5100,1,0,820,0,195000,1953
2180,10575,1,0,1730,450,480000,1950
1400,3600,1,0,1100,300,485000,1900
880,9000,1,0,880,0,130000,1928
1060,5703,1,2,1060,0,325000,1946
1530,7245,1,0,1530,0,440000,1984
2480,14782,1,3,1460,1020,550000,1958
1490,7150,1,0,1490,0,310000,1967
3660,39478,2,2,3260,400,530000,1989
2340,8548,2,0,2340,0,390000,1993
1450,12125,1,0,1450,0,243000,1981
2210,9875,2,0,2210,0,639000,1990
1130,7400,1,0,1130,0,215000,1969
1550,10500,1,0,1100,450,405000,1961
1710,7140,1,0,1010,700,250000,1968
1010,8108,1,0,1010,0,405500,1954
2660,13579,2,0,2660,0,452000,1937
2660,13579,2,0,2660,0,730000,1937
1300,9644,1,0,1300,0,267000,1994
1670,6186,2,0,1670,0,289950,2002
960,4080,1,0,960,0,565000,1911
4670,51836,2,0,4670,0,1.58E+06,1988
2140,2770,2,0,1770,370,636000,2007
2520,5500,1,0,1550,970,350000,2004
1650,9380,1,0,1130,520,320000,1978
1440,5680,1,0,1440,0,210000,1978
1050,5900,1,0,1050,0,245000,1950
1470,7650,1,0,1130,340,328000,1983
4230,37769,2,0,4230,0,985000,1989
1970,7972,1,3,1370,600,501000,1976
1540,17424,2,0,1540,0,315000,1992
2090,8354,2,0,2090,0,403000,2012
2380,17950,2,0,2110,270,550000,1934
2156,3562,2,0,2156,0,347500,2012
2070,8893,2,0,2070,0,365000,1986
1910,8167,1,0,1270,640,588000,1951
1920,7400,1,0,1260,660,605000,1977
3400,5979,2,0,2290,1110,1.30E+06,1937
1400,9177,1,0,1400,0,233000,1974
2210,17715,2,0,2210,0,360000,1997
1170,4887,1,0,1020,150,459000,1929
2100,72745,1,0,2100,0,740000,1995
1160,9750,1,0,1160,0,305000,1967
1500,4000,1,0,900,600,395000,1925
2940,6000,2,0,2940,0,560000,2000
2010,5070,1,1,1300,710,650000,1963
2170,4912,2,0,2170,0,449950,2003
1430,5200,1,3,1250,180,517500,1940
1510,6460,1,0,1070,440,435000,1970
1150,6908,1,0,800,350,329999,1952
2150,4200,1,4,1140,1010,950000,1960
1370,6001,1,0,1230,140,447000,1944
2380,6600,1,0,2380,0,699800,2010
1370,3850,1,0,770,600,850000,1911
1600,14250,1,0,1070,530,316500,1979
3750,9612,1,2,2030,1720,942500,1981
3950,3938,2,4,2910,1040,1.31E+06,1991
2400,13430,1,0,2400,0,856600,1964
2830,4000,2.5,0,2830,0,405600,1918
2440,22594,2,0,2440,0,565000,1996
1190,1149,2,0,1050,140,400000,2008
1400,218252,1,0,1400,0,330000,1997
2730,4683,2,0,2730,0,374950,2005
2390,7939,1,0,1610,780,405300,1983
2060,31400,2,0,2060,0,560000,1984
2490,9864,1,0,1290,1200,824000,1961
1100,10968,1,0,1100,0,260000,1984
2430,6099,1,0,1470,960,760000,1965
3170,12750,2,0,2360,810,405000,1995
2640,8625,2,0,2640,0,429900,1987
1130,7223,1,0,1130,0,341500,1961
1940,7642,1.5,0,1940,0,465250,1957
1100,3000,1.5,0,1100,0,450000,1912
1200,10800,1,0,1200,0,390000,1955
2000,8030,1,0,1000,1000,420000,1963
1890,4838,2,0,1730,160,269950,2002
1910,2874,1,0,1060,850,493000,1910
2710,5880,2,0,2710,0,370000,1998
4860,9453,1.5,1,3100,1760,2.25E+06,1905
1250,23680,1,0,1250,0,305000,1967
1590,8219,1.5,0,970,620,400000,1938
1240,1221,2,0,1050,190,320000,2009
2000,4800,2,0,2000,0,715000,1911
3610,10003,1.5,0,3610,0,650000,1966
1930,8040,1,0,1930,0,218000,1966
1280,5400,1,0,1280,0,500000,1964
2090,40419,1,0,2090,0,460000,1984
1940,9887,1,0,1140,800,232500,1969
1800,5761,2,0,1800,0,408200,1990
1730,8400,1,0,1400,330,522000,1980
2810,11120,2,0,2810,0,675000,1982
3550,11000,1,2,2260,1290,1.36E+06,1999
1330,7980,1.5,0,1330,0,249950,1952
750,34133,1,0,750,0,210000,1950
1760,7216,1,0,1090,670,429950,1947
3200,36276,2,0,3200,0,737500,1993
1740,9000,1,0,1740,0,710000,1958
2100,4700,2,0,2100,0,470000,1999
4270,40097,1,0,4270,0,1.10E+06,1993
1340,2720,1.5,0,1340,0,650000,1913
3190,8684,1,3,1680,1510,1.22E+06,1967
1630,4534,2,0,1630,0,422120,1987
2990,15085,2,0,2990,0,625000,2007
1550,7740,1.5,0,1550,0,385200,1954
1690,4964,2,0,1690,0,500000,1989
1960,12243,2,0,1960,0,308000,1989
2390,9966,1,0,1360,1030,565000,1977
2600,4438,2,0,2600,0,581000,2004
1950,8698,1,0,1950,0,361000,1999
1250,7210,1,0,1250,0,345000,1964
1180,1253,2,0,840,340,419000,2008
1680,4308,2,0,1680,0,347000,2004
2220,36085,2,0,2220,0,625000,1989
4890,15188,2,2,3090,1800,2.40E+06,1999
2660,17852,2.5,0,2660,0,379000,2014
1150,3323,2,0,1150,0,310000,1988
1130,5500,1,0,1130,0,250000,1941
2760,5000,2,0,2760,0,682000,2005
1430,8919,1,0,1430,0,246500,1992
1490,57381,1.5,0,1490,0,325000,1932
2030,4997,2,0,2030,0,310950,2004
3010,5000,2,2,1890,1120,1.10E+06,1931
1810,7200,1,0,1130,680,287500,1954
1810,7200,1,0,1130,680,431000,1954
970,5000,1,0,970,0,226000,1968
2010,3090,1.5,0,1510,500,825000,1926
1300,6030,1.5,0,1300,0,175000,1947
1260,10350,1,0,1260,0,465750,1959
2610,24931,2,0,2610,0,659000,1983
1910,5753,1,3,1110,800,595000,1941
1780,16290,2,0,1780,0,350000,1987
1900,8600,1,0,1900,0,270000,1975
2450,25600,1,2,1340,1110,662500,1957
1380,14000,1,0,1380,0,249900,1939
1920,11340,1,0,1230,690,324500,1977
1350,4003,1,0,1350,0,430000,2004
1350,4003,1,0,1350,0,419950,2004
2510,7440,1,2,1290,1220,285000,1962
2470,7780,2,0,2470,0,332000,2002
1660,10725,1,0,960,700,282000,1956
1340,5175,1,0,940,400,320000,1987
1620,30736,1.5,0,1620,0,428750,1911
2300,35287,2,0,2300,0,330000,1977
2000,2309,3,0,2000,0,456500,2008
1640,11050,1,0,1640,0,352000,1972
1530,4080,1.5,0,1530,0,664000,1912
4000,11894,1,0,2190,1810,628000,1987
1610,12555,1,0,1080,530,512000,1977
2070,9000,1,0,1450,620,254000,1969
1900,5790,2,0,1900,0,535800,1994
1050,16050,1,0,1050,0,287653,1960
1520,1304,2,0,1180,340,438000,2006
2390,23899,1,0,1750,640,450000,1949
2400,8050,2,0,2400,0,327000,1998
1790,6120,2,0,1790,0,370500,2005
1720,6271,2,0,1720,0,265000,1993
2980,13260,1,0,1800,1180,450000,1979
1520,213444,1.5,3,1520,0,425000,1988
1150,8690,1,0,1150,0,166600,1977
380,15000,1,0,380,0,245000,1963
910,5212,1,0,910,0,565000,1951
1650,10150,1,0,1230,420,539900,1976
2480,3200,2,0,2480,0,910000,2010
2050,7416,2,0,2050,0,280000,1990
1420,8549,2,0,1420,0,275000,1989
3460,6590,2,0,3460,0,467000,2001
1500,4445,2,0,1500,0,457500,1996
1320,3090,1,0,1320,0,381156,1908
2180,8240,1,0,1220,960,289999,1977
1830,4160,1,0,1230,600,642450,1919
1620,8701,1,0,1220,400,469950,1962
2920,13650,1,2,1460,1460,795000,1975
3300,10514,2,0,3300,0,785000,1984
3060,12095,2,0,3060,0,860000,1983
3064,4764,3.5,2,3064,0,1.10E+06,1990
1530,8498,1,0,1530,0,147500,1959
1910,11576,1,0,1410,500,390000,1978
1020,8100,1,0,1020,0,229000,1954
1150,8100,1,0,1150,0,185000,1932
1260,9570,1,0,870,390,414900,1941
1920,4822,1,0,920,1000,200000,1914
1800,9350,1,0,1800,0,225000,1969
2040,4000,2,0,1360,680,720000,1924
2200,4000,2,0,1430,770,930000,1908
3200,17204,1,0,2160,1040,1.27E+06,1952
2400,3118,2,0,1780,620,700000,1928
1140,1058,3,0,1140,0,466000,2005
1330,10640,1,0,1330,0,374000,1976
1940,10035,2,0,1940,0,480000,1994
3000,25341,2,0,3000,0,740000,1995
1820,5400,1.5,0,1820,0,1.01E+06,1923
2910,5000,2,0,2910,0,395000,2002
1090,6771,1,0,1090,0,340000,1954
1230,1340,2,0,1020,210,209000,2003
1710,7700,1.5,0,1710,0,431650,1962
3160,11470,1,0,1780,1380,980000,1971
2680,28243,2,0,2680,0,660000,1993
2190,9009,2,0,1840,350,730000,1977
1260,9600,1,0,1260,0,291500,1988
2970,14486,2,0,2340,630,905000,1997
2570,50308,1.5,0,2570,0,800000,1993
3810,13592,1,1,2560,1250,839900,2013
1010,1157,2,0,950,60,200000,2007
1480,6698,1,0,1080,400,300000,1979
1250,6041,1.5,0,1250,0,530000,1942
1654,8479,2,0,1654,0,314950,1995
1410,9315,1,0,1410,0,255000,1960
2160,5720,1,0,1500,660,550000,1950
1400,4800,1,0,700,700,435000,1917
1420,8738,1,0,1420,0,234000,1966
2500,10062,1,0,1600,900,615000,1975
1410,8384,1,0,1410,0,205000,1985
2100,7135,1,0,1050,1050,384000,1955
1750,7208,2,0,1750,0,324000,1994
2070,5500,1,0,1130,940,645000,1946
1570,1777,2,0,1260,310,570000,2007
1920,5322,2,0,1920,0,324000,1999
1000,10320,1,0,1000,0,270000,1943
2120,7700,1.5,0,2120,0,290000,1962
1440,9220,1,0,1440,0,250000,1965
1660,16275,2,0,1660,0,342000,1990
1340,8450,1,0,1340,0,255000,1958
2380,11824,1,0,1450,930,800000,1972
1560,4049,1.5,2,1000,560,451000,1926
2780,10480,1,3,1390,1390,990000,1967
1860,6687,1,0,1220,640,288400,1983
2390,4600,2,0,1750,640,420000,1920
1370,1140,2,0,1080,290,359000,2009
2570,262018,1,0,1420,1150,390000,1988
1320,2614,2,0,1320,0,300000,2005
2520,7863,1,0,1500,1020,545000,1981
1250,18616,1,0,1250,0,288349,1972
1560,35026,1,0,1290,270,299900,1985
2330,5000,1.5,0,1720,610,891000,1925
3660,22410,1,3,1830,1830,1.20E+06,1947
2790,4650,2,0,2790,0,378000,2004
1060,7200,1,0,1060,0,299995,1951
2020,6564,1,0,1310,710,253000,1994
1580,47916,1,0,1580,0,350000,1979
2020,4300,1.5,0,2020,0,565000,1900
970,5665,1,0,970,0,315000,1908
1490,6766,1.5,1,1490,0,570000,1915
4390,10140,2,0,3350,1040,971000,2005
2750,5589,1.5,0,1840,910,915000,1910
2150,23568,1,0,2150,0,419000,1950
1810,7480,1,0,1230,580,260000,1977
2230,12968,2,0,2230,0,1.32E+06,1990
2430,10720,1,0,2430,0,369950,1977
3680,13384,2,0,3680,0,1.03E+06,1994
1410,6750,1.5,0,1410,0,435000,1929
1330,6743,1,0,1330,0,601000,1958
1490,10650,1,0,1150,340,460500,1963
2020,1159,3,3,2020,0,720000,2000
3130,13202,2,0,3130,0,851000,1996
2670,5000,2,2,2670,0,550000,1916
1980,4560,1.5,0,1980,0,700000,1920
2100,14850,1,0,2100,0,323000,1963
1350,8581,1,0,1350,0,345500,1944
2140,7920,1,0,1190,950,378000,1959
2208,5000,3,0,2208,0,650000,1917
1010,7380,1,0,1010,0,385000,1982
970,2970,1,0,970,0,425000,1910
1520,6174,1.5,0,1520,0,210000,1920
2740,43101,2,0,2740,0,630000,1993
1570,7500,1,1,1300,270,335000,1953
1320,9000,1,0,1320,0,196500,1966
2550,7636,1,0,1440,1110,582800,1986
1560,7207,1,0,1250,310,440000,1983
2360,8616,2,0,2360,0,752500,1974
1330,5000,2,0,1210,120,532500,1909
1070,9000,1,0,1070,0,265000,1950
1510,13737,1,3,810,700,397500,1961
1710,3469,2,0,1710,0,524250,1999
2790,10819,2,0,2790,0,765000,1996
2620,5450,2,0,2620,0,648000,2001
2970,24759,1,0,1670,1300,469500,1969
1050,7854,1,0,1050,0,237500,1975
1280,8712,1,0,1280,0,216000,1956
1030,8400,1,0,1030,0,427200,1963
1900,7800,1,0,1390,510,280000,1977
3070,9804,1,0,1740,1330,718000,1968
1760,4139,2,0,1760,0,420000,2010
930,5400,1,0,930,0,379000,1952
880,7683,1,0,880,0,326100,1942
1360,1016,3,0,1310,50,535000,2003
2130,8560,1,0,1560,570,283000,1992
1480,7469,1.5,0,1120,360,260000,1940
1500,6388,1.5,0,1500,0,399000,1951
1670,5004,2,0,1670,0,484950,1987
2060,9828,1,0,2060,0,640000,1960
2160,8158,1,0,1660,500,585000,1952
2780,11583,1,3,1190,1590,645000,1955
1490,7651,1,0,1490,0,253000,1988
740,6460,1,0,740,0,178500,1953
1860,6325,2,0,1860,0,291000,1991
1590,20917,1.5,0,1590,0,199950,1920
850,2340,1,0,850,0,553500,1922
1030,4188,1,0,1030,0,189950,1981
1850,9550,1,0,1850,0,289000,1988
1830,4590,2,0,1830,0,700000,1908
1560,8853,1,0,1560,0,270000,1967
1730,8320,1,0,1230,500,258000,1977
1930,7214,2,0,1930,0,530000,2005
1422,3677,2,0,1422,0,245000,2012
1380,5000,1.5,0,1380,0,563000,1917
2430,4203,2,0,2430,0,515000,2001
2610,7091,2,0,2610,0,325000,1987
2000,217800,2,0,2000,0,540000,1996
920,5000,1,0,490,430,280300,1949
1750,5500,1.5,0,1050,700,460000,1926
2020,8970,1,0,1180,840,475000,1981
2460,44431,1,0,2460,0,900000,1957
1780,7260,1,0,1780,0,538200,1964
1080,3600,1,0,1080,0,429000,1922
1250,5411,1,0,1250,0,164808,1980
1870,7700,2,0,1870,0,520000,1977
1700,8432,1,0,1230,470,475000,1977
1480,47045,1,0,1480,0,283000,1942
1930,6228,2,0,1930,0,321500,2000
3130,21810,2,0,3130,0,840000,1993
1370,6000,2,0,1370,0,287000,1992
960,8106,1,0,960,0,375000,1962
1260,7128,1,0,1260,0,349500,1969
1480,7749,1,0,1480,0,446450,1960
1930,9643,2,0,1930,0,315000,1992
870,5340,1.5,0,870,0,271310,1906
1300,8400,1.5,0,1300,0,315000,1953
1490,6930,1,0,1490,0,245000,1990
1380,5484,1,0,1030,350,543115,1947
1190,8190,1.5,0,1190,0,900000,1945
4250,6552,2,3,2870,1380,2.45E+06,2008
1920,6045,1,0,1920,0,554000,2003
2080,12522,1,0,2080,0,249900,1950
3220,54160,2,2,2690,530,768000,1981
3680,5854,1,3,2060,1620,980000,1967
2070,9600,1,0,1270,800,395000,1962
1480,2200,2,0,1480,0,415000,1995
2000,6921,2,0,2000,0,380000,2003
1560,5259,2,0,1560,0,566000,1999
1600,8961,1,0,1390,210,218500,1949
1940,10500,1,0,1140,800,550000,1976
1540,3000,1,2,770,770,512031,1920
820,8860,1,0,820,0,197500,1950
1780,8784,1,0,1230,550,470000,1977
1560,242629,1,0,1560,0,590000,1981
2210,8862,1,0,1270,940,465000,1977
2040,114562,1,0,2040,0,499000,1968
1920,11500,1,0,1920,0,515000,1972
1930,5000,1,0,1230,700,716500,1936
1700,4250,1,0,890,810,410000,1944
3450,6500,2,0,2450,1000,850000,1994
3440,35021,2,0,3440,0,1.05E+06,1983
2380,13435,2,0,2380,0,648000,1992
2400,5350,1.5,0,1460,940,620000,1929
5670,84267,2,2,5670,0,935000,2008
1140,10320,1,0,1140,0,379000,1963
1670,5375,1,0,1270,400,699000,1952
1910,8005,1,0,1280,630,528000,1960
1560,9452,1,0,1560,0,425000,1974
1500,8645,1,0,1500,0,249500,1963
4475,6642,2,0,4475,0,1.04E+06,2014
2840,11900,1,3,1640,1200,790000,1961
1020,18050,1,0,1020,0,399950,1969
1410,9000,1,0,1410,0,275000,1953
1520,2500,1.5,0,1520,0,550000,1912
730,6890,1,0,730,0,140000,1926
1190,6250,1,0,990,200,250000,1954
1410,8909,2,2,1410,0,318000,1988
1240,57000,1,0,1240,0,505000,1962
2500,9248,1,0,1300,1200,470500,1966
1050,9206,1.5,0,1050,0,360000,1954
2680,8500,1,4,1480,1200,1.24E+06,1962
2380,16080,1,2,1340,1040,986000,1964
1060,4228,1,0,860,200,515000,1906
2300,41900,1,0,1310,990,320000,1939
2010,7426,1,0,1090,920,310000,1951
1090,5000,1,0,730,360,356700,1942
2320,5595,1,0,1510,810,775000,1956
1040,7541,1,0,1040,0,325000,1951
1810,8677,1.5,0,1810,0,208000,1962
1150,12775,1,4,1150,0,825000,1908
2360,11254,1,2,2360,0,515000,1990
1970,3400,1.5,0,1420,550,490000,1929
2690,28300,1,0,2690,0,675000,1954
2080,4080,1,0,1040,1040,360000,1962
2080,4080,1,0,1040,1040,550000,1962
1370,9000,1,0,1370,0,225000,1962
3410,9360,1.5,0,3410,0,500000,1967
1850,11700,1,0,1850,0,385000,1969
3010,12611,2,0,3010,0,837700,1994
1530,3056,2,0,1530,0,448000,2003
2690,21357,1,0,1420,1270,730000,1952
2810,7140,1,2,1490,1320,575000,1954
1810,7300,1,0,1240,570,430000,1976
1560,3987,2,0,1560,0,435000,2002
1010,9611,1,0,1010,0,241000,1973
1000,1760,1,0,600,400,453500,1924
990,1380,3,0,990,0,285000,2001
720,4222,1,0,720,0,151000,1942
6070,14731,2,0,6070,0,1.57E+06,2004
2270,2400,2,0,2270,0,631000,1905
1380,1073,2,0,1140,240,285000,2011
1260,8378,1,0,840,420,195000,1959
2910,35679,2,0,2910,0,817500,1987
1810,12825,1,0,1810,0,550000,1960
3160,8281,2,0,3160,0,1.13E+06,1995
1910,1369,3,0,1910,0,609850,2002
1230,4380,1,0,1230,0,200000,1947
2960,6219,2,0,2960,0,367000,2006
2200,8375,2,0,2200,0,285167,1988
1270,32175,1,0,1270,0,275000,1947
2540,12843,2,0,2540,0,350900,1992
3030,9273,2,0,3030,0,660000,1988
1520,8835,1,0,1520,0,525000,1957
1560,7800,2,0,1560,0,262000,1997
970,4560,1,0,970,0,690000,1907
3570,14648,2,0,3570,0,624000,2005
1350,7740,1,0,860,490,353000,1947
3710,10400,2,0,2290,1420,552500,2002
1430,8355,1.5,0,1430,0,224500,1983
940,8571,1,0,940,0,239000,1950
4300,12250,2,0,4300,0,975000,2004
3990,13470,2,0,3990,0,1.20E+06,2006
1380,4000,1.5,0,1380,0,505000,1910
2020,7865,1,0,1010,1010,302000,1963
1480,5670,1,0,780,700,170000,1944
1190,27007,1,0,1190,0,195000,1910
2550,6300,1,0,1560,990,272000,1959
2550,6300,1,0,1560,990,369000,1959
1500,6332,1,0,1500,0,332500,1953
3000,8250,1,0,1760,1240,515000,1963
1690,4250,1,0,1020,670,269000,1967
4390,17832,1,0,2430,1960,1.28E+06,1994
1560,4100,2,0,1560,0,303000,1985
2940,8624,1,0,1690,1250,420000,1977
1130,4100,1,0,990,140,400000,1941
1020,8437,1,0,1020,0,225000,1987
1310,2550,2,0,1310,0,219000,2004
2570,9487,2,3,2570,0,605000,1989
2020,6867,1,0,1010,1010,625000,1942
1680,3240,1,0,840,840,380000,1906
1770,7700,1.5,0,1770,0,620000,1962
3190,10970,2,0,3190,0,687500,1994
1440,7950,1,0,1440,0,225500,1962
1150,6000,1,0,1150,0,252500,1956
1860,3658,2,0,1860,0,510000,1994
2430,5203,2,0,2430,0,510000,2003
1940,4000,1.5,0,1940,0,725000,1906
670,43377,1,0,670,0,75000,1966
880,2970,1,0,880,0,492000,1927
1930,14196,1,0,1330,600,425000,1977
3120,7898,1,4,1560,1560,1.96E+06,1963
1830,6162,2,0,1830,0,298900,1994
3230,40319,2,0,3230,0,699000,1987
700,3000,1,0,700,0,310000,1918
1010,8580,1,0,1010,0,350000,1961
2460,10061,1,4,1410,1050,790000,1961
2230,5000,2,0,2230,0,305000,2003
1570,2865,2,0,1570,0,315000,2003
2390,6600,2,0,2390,0,267500,1977
3460,7749,2,1,3020,440,1.75E+06,1950
2400,8620,2,0,1640,760,435000,1987
2940,7500,1.5,0,2940,0,482500,1966
8010,45517,2,4,5990,2020,5.11E+06,1999
1570,8400,1,0,1570,0,439995,1959
1520,7500,1,0,1180,340,460000,1967
1070,6440,1,0,1070,0,194000,1971
440,8313,1,3,440,0,290000,1943
2440,9600,1,0,1220,1220,274700,1963
2660,3672,2,0,1800,860,900000,1910
4460,103382,2,0,4460,0,1.15E+06,2001
2010,3667,2,0,2010,0,605000,2008
1450,3850,2,0,1450,0,359000,2004
1400,9900,1,0,1400,0,850000,1951
1500,2500,2,0,1500,0,505000,2002
2500,7394,2,0,2500,0,565000,1990
1280,7110,1,0,1000,280,585000,1955
3380,7500,2,3,2420,960,328000,1990
2910,18700,1,0,2210,700,749950,1957
3060,7140,2,0,3060,0,826000,2006
1330,40259,1,0,1330,0,535000,1977
3300,101930,2,0,3300,0,925000,1991
3250,6000,2,0,2500,750,875000,2001
2530,9200,1,0,1570,960,902000,1976
1830,13900,1,0,1830,0,423000,1951
1170,11100,1,0,1170,0,235000,1968
2930,14057,1,2,1680,1250,545000,1980
1230,7560,1,0,1230,0,343000,1961
1620,2930,2,0,1620,0,334950,2002
1760,5355,1,0,1160,600,405000,1956
1440,8250,1,0,1440,0,220000,1959
1740,8100,1,0,1050,690,173000,1947
1270,3600,1.5,0,1270,0,655000,1906
880,3000,1,0,880,0,406000,1924
2560,8320,1,0,1370,1190,632000,1961
1540,4000,1,0,1140,400,357000,1990
1150,17585,1,0,1150,0,361000,1964
770,8149,1,0,770,0,277000,1948
4610,40202,1,0,2500,2110,630000,1980
1850,4597,2,0,1850,0,254000,2003
1840,8400,1,0,1290,550,472800,1961
1490,3800,1,0,700,790,263000,1913
1490,3800,1,0,700,790,510000,1913
960,10125,1,0,960,0,179950,1952
1580,7307,1,0,1160,420,525000,1973
1260,889,3,0,1260,0,479000,2008
1940,6440,1,2,970,970,651000,1940
2490,7834,1,3,1240,1250,949000,1958
2520,27951,1.5,0,1890,630,392400,1942
1760,5356,1,0,920,840,585000,1950
4190,7504,2,0,4190,0,460000,2004
1170,4400,1,0,870,300,470000,1951
1600,4271,2,0,1600,0,245000,2003
2760,27631,2,0,1800,960,500000,1978
2090,8653,2,0,2090,0,455000,1989
2320,3974,2,0,2320,0,485500,1999
4110,7920,2,3,3150,960,1.88E+06,1921
770,17334,1,0,770,0,100000,1978
1410,16105,1,0,1410,0,307000,1982
3660,14401,2,0,2660,1000,475000,1994
2180,7210,1,0,1190,990,330000,1972
1110,7520,1,0,1110,0,130000,1960
2280,7417,2,0,2280,0,320000,1998
2820,6180,2,0,2050,770,735000,2013
1570,9600,1,0,800,770,365000,1972
1200,11935,1,0,1200,0,234000,1968
1710,8288,1.5,0,1710,0,211000,1970
3000,6320,2,2,2400,600,680000,1969
2800,7845,2,0,2800,0,457000,2002
1640,7261,2,0,1640,0,349000,1989
2030,6840,1,0,1210,820,360000,1979
2530,10155,2,0,2530,0,350000,1998
990,7420,1,0,990,0,208000,1960
790,11234,1,0,790,0,250275,1942
790,11234,1,0,790,0,435000,1942
1800,7763,1,0,1470,330,270000,1984
1650,12940,1,0,1650,0,438000,1961
1980,23625,2,0,1980,0,659000,1938
2340,6350,1,0,1310,1030,645000,1974
2790,5423,2,0,2790,0,685100,1999
2800,9569,1,2,1400,1400,350000,1963
1840,81892,1,0,1840,0,375000,1955
1350,81549,1,0,1350,0,170000,1966
3030,3841,3,0,3030,0,880000,2005
1980,5000,2,0,1980,0,410500,2008
3690,13609,2,2,3690,0,780000,1996
3732,4426,2.5,0,2932,800,1.23E+06,2001
1510,6852,1,0,1510,0,449000,2005
2000,5000,1,0,1110,890,546000,1921
1760,11410,1,0,1060,700,317000,1977
1270,7566,1,0,1270,0,276900,1958
2620,7030,1,0,1420,1200,399000,1965
2630,10165,1,0,1690,940,495000,1976
2270,9000,1,0,1330,940,258000,1978
2410,102366,1,0,1940,470,600000,1912
1120,881,3,0,1120,0,265000,1999
3030,7000,1,0,1540,1490,321000,1978
2120,4000,1.5,0,1720,400,682000,1910
1720,5805,2,0,1720,0,295700,2000
2150,37981,2,0,2150,0,609000,1985
4380,47044,2,3,3720,660,995000,1968
2010,11817,2,0,2010,0,530000,1986
3150,5150,2,0,1870,1280,614000,1907
2500,21780,1,0,1770,730,390000,1986
1690,6642,2,0,1690,0,467000,2004
3300,13501,1,0,2060,1240,484000,1980
1240,1115,3,0,1240,0,340000,2003
2200,7201,2,0,2200,0,302495,1994
1620,3360,1,0,980,640,532500,1927
2420,9592,2,0,1780,640,441500,1993
2680,8062,1,3,1530,1150,470000,1967
4250,8570,2,0,4250,0,2.30E+06,2004
2400,99752,1,0,2400,0,590000,1996
2300,12000,1,0,1770,530,320000,1942
920,1201,2,0,800,120,363000,2009
2350,18600,2,0,2350,0,747500,1977
2630,7957,2,0,2630,0,750000,2003
2170,4000,2,0,1610,560,831000,1982
1700,4125,2,0,1700,0,403000,2004
2470,4565,2,0,2470,0,445000,2005
1250,17380,1,0,1250,0,345000,1970
3110,14872,1,0,3110,0,2.26E+06,2003
1530,8925,1,0,1530,0,371025,1977
960,6250,1,0,960,0,355000,1916
1240,14110,1,0,1240,0,270000,1972
2440,15349,2,1,2440,0,425000,1957
2320,7875,1,0,1620,700,364808,1967
1580,6561,1,0,1200,380,320000,1981
2963,5797,2,0,2963,0,325000,2006
2470,10290,2,0,2230,240,350000,1984
1370,10176,1,0,1370,0,170000,1947
960,28717,1,0,960,0,255000,1984
1130,7500,1,0,880,250,550000,1947
4930,25714,2,0,4930,0,835000,2005
1150,5120,1,0,800,350,420000,1946
2190,7350,2.5,0,2190,0,925000,1958
1490,4080,1,0,930,560,389250,1956
2600,10183,1,0,1300,1300,748000,2004
1530,9600,1,0,1200,330,284000,1988
1680,5000,1,0,980,700,588000,1950
1680,8648,1,0,1680,0,372500,1963
1900,7194,2,0,1900,0,285000,1988
1570,9467,1,0,1570,0,360000,1954
1370,17859,1,0,1150,220,275000,1930
1350,4225,1,0,1350,0,428000,2003
3010,17864,2,0,3010,0,847000,1969
1010,7838,1,0,1010,0,316000,1977
2050,7205,2,0,2050,0,375000,2000
1670,4080,1,0,1170,500,533000,1967
3840,16905,2,0,3840,0,556000,1991
2220,14120,1,0,1200,1020,225000,1966
2590,9530,1,0,1640,950,537250,1978
1180,13650,1,0,1180,0,255000,1967
2950,4836,2,0,2950,0,530000,2006
7390,24829,2,4,5000,2390,5.30E+06,1991
2150,31238,2,0,2150,0,595000,1996
2100,8880,1,0,2100,0,548000,1958
1650,8073,1,0,1100,550,234975,1980
1620,1325,2.5,0,1430,190,600000,2005
1750,12528,1,0,1750,0,432000,1967
1380,6657,2,0,1380,0,455000,1986
1510,11234,1,0,1210,300,279950,1965
1600,9072,1,0,1600,0,267500,1963
1840,220308,2,0,1840,0,620000,2000
830,7590,1,0,830,0,110000,1943
1810,1846,2,0,1440,370,625000,2009
910,7000,1,0,910,0,389000,1952
2120,3360,2,0,2120,0,1.20E+06,1905
2510,133729,2,0,2510,0,788500,1977
2100,6936,1,0,1600,500,567000,1974
2690,15000,1,2,1870,820,515000,1987
2430,11870,1,0,1590,840,605000,1968
2452,4800,2,0,2452,0,430000,1936
1550,6000,1,1,1550,0,805000,1920
2080,4556,2,0,2080,0,567500,1999
1290,3870,1,0,1290,0,647500,1916
1850,2530,2.5,0,1850,0,495000,1903
3370,5000,2,0,3370,0,825000,2006
2730,7506,2,0,2730,0,435000,1987
1300,7800,1,0,1300,0,445950,1968
3040,10257,2,0,3040,0,960000,1993
2440,3600,1.5,0,1480,960,780000,1929
1720,9000,1,0,1320,400,274500,1969
3230,5167,1.5,0,2000,1230,729953,1909
1200,890,2,0,1030,170,464950,2008
2350,18800,1,2,2350,0,620000,1959
3100,5600,2,0,3100,0,735000,2005
2040,9565,1,0,1400,640,450000,1959
2000,4676,1.5,0,1250,750,450000,1916
2160,5298,2.5,0,2160,0,842500,1902
1970,79714,1,0,1070,900,360000,1979
2270,100545,2,0,2270,0,585000,1998
1850,7923,1,0,1150,700,461000,1977
1350,4494,1,0,920,430,345000,1949
3280,10302,1,0,1680,1600,1.08E+06,1970
2270,8391,2,0,2270,0,643000,1988
2820,8307,2,0,2820,0,690000,1990
1200,11111,1.5,0,1200,0,282000,1949
2000,6130,1,0,1120,880,549000,1951
2310,6000,2,1,1560,750,815000,1926
4640,22703,2,4,2860,1780,2.20E+06,1952
2330,11424,2,0,2330,0,700000,1984
3940,10360,2,0,3110,830,933399,1992
1440,11250,1,0,1440,0,290000,1967
1960,9300,1,0,1340,620,372000,1979
1250,2890,1,0,790,460,450000,1920
1981,5700,2,0,1981,0,303700,2010
2440,10049,2,0,2440,0,672000,1989
1150,9360,1.5,0,1150,0,334000,1970
1120,5650,1,0,1120,0,260000,1944
1800,5700,1,0,1000,800,749950,1941
2380,122038,2,0,2380,0,330000,1984
2920,2808,2,0,2140,780,830000,1960
2790,13791,1,3,2790,0,1.13E+06,2006
1560,7552,1,0,910,650,320000,1948
1550,15250,1.5,0,1550,0,260000,1920
1700,11475,1,0,970,730,225000,1945
640,6350,1,0,640,0,279200,1939
2680,10000,2,0,2040,640,520000,1942
1860,8060,2,0,1860,0,505000,1987
1490,8366,1,0,1010,480,234000,1975
2470,5044,2,0,2470,0,503000,2005
2390,8858,1,0,1740,650,606000,1979
1230,6000,1,0,780,450,433500,1937
2840,10182,1,0,1510,1330,250000,1951
2120,9307,2,0,2120,0,719000,1984
1770,14400,1,0,1770,0,381000,1959
2495,4400,2,0,2495,0,267000,2007
1170,14149,1,0,880,290,275000,1962
2740,7140,2,0,2740,0,651000,1993
1050,5671,1,0,850,200,439000,1949
1130,5070,1,0,1130,0,325000,1955
880,6380,1,0,880,0,490000,1938
2403,6172,2,0,2403,0,519900,1999
3410,35040,2,0,3410,0,545000,1984
5320,20041,2,0,5320,0,1.06E+06,2003
1900,8250,1,0,950,950,542000,1955
1810,21650,2,0,1810,0,465000,1961
1200,3900,1,0,1200,0,408000,2006
2060,5950,2,0,2060,0,292000,2000
1250,10122,1,0,1250,0,253000,1994
910,4662,1,0,910,0,280000,1942
2560,41346,2,0,2560,0,658588,1986
1920,8910,1,0,1200,720,635000,1969
2240,8300,2,0,2240,0,439000,1978
1260,3855,2,0,1260,0,300000,1999
1360,13496,1,0,1360,0,345000,1960
2100,8050,2,0,2100,0,283500,1978
2110,4920,1.5,0,1460,650,425000,1911
2210,8955,1,1,1560,650,685000,1974
2360,12987,2,0,2360,0,750000,1983
1280,8000,1,0,1280,0,245000,1960
2740,6924,1,2,1640,1100,585444,1962
2740,7571,2,0,2740,0,706000,2009
2630,9099,1.5,0,1830,800,445000,1944
1650,6000,1,0,1650,0,241000,1990
1770,7155,2,4,1770,0,1.18E+06,1957
1500,5750,1.5,0,1050,450,530000,1927
1430,12199,1,0,1130,300,350000,1948
3190,17186,2,4,3190,0,1.70E+06,1999
1280,9630,1,0,1280,0,389000,1968
2390,6820,2,0,2140,250,799000,1945
4040,9630,1,3,2020,2020,1.40E+06,1951
920,8612,1,0,920,0,340895,1947
2730,10281,2,2,2730,0,780000,1996
1320,73600,1,0,1320,0,350000,1993
2620,4874,2,0,2620,0,470000,1999
3180,80837,2,0,3180,0,914600,1985
2900,4762,2,0,2900,0,354000,2005
1900,6000,1.5,0,1900,0,470000,1920
1760,5400,1,0,1160,600,715000,1927
760,4000,1,0,760,0,265000,1950
3710,20000,2,2,2760,950,2.54E+06,1936
1530,4944,1,0,1530,0,640000,1950
1990,18900,2,0,1870,120,290000,1929
3830,35000,1,0,2130,1700,480000,1976
2040,5600,1,1,1120,920,535000,1954
2170,12220,1,0,2170,0,907000,1965
1620,7330,1,0,1090,530,459000,1974
3600,21399,1,3,2310,1290,1.36E+06,1950
1470,11599,1,0,1070,400,264950,1967
1760,3000,1.5,0,1760,0,352950,1900
2230,13100,1,0,1510,720,491500,1974
3770,37034,2,0,2830,940,1.23E+06,1989
1200,9194,1,0,1200,0,369500,1952
2090,6294,2,0,2090,0,566000,2004
1500,7308,1,0,1210,290,290000,1968
8000,23985,2,4,6720,1280,5.35E+06,2009
870,5330,1,0,870,0,180000,1969
1010,6000,1,0,1010,0,215000,1944
1010,6000,1,0,1010,0,302000,1944
1860,7881,1,0,1160,700,352500,1986
1330,5926,1,0,1330,0,235867,1942
1760,11946,2,0,1760,0,500000,1978
1800,4500,2,0,1800,0,382000,1995
1690,2402,1.5,0,990,700,515000,1930
660,2600,1,0,660,0,250000,1919
2400,5300,1.5,0,1250,1150,672500,1939
3020,13031,2,0,3020,0,755000,1989
1500,2555,2,2,1500,0,707500,1910
1560,3840,1,0,960,600,459000,1924
1090,10620,1.5,0,1090,0,140000,1959
970,4284,1,0,970,0,495000,1905
3190,5283,2,0,3190,0,757000,2007
3190,5283,2,0,3190,0,765000,2007
1890,6052,1,0,1890,0,359000,1955
1050,7500,1,0,1050,0,440000,1900
1390,7200,1,0,1140,250,400000,1965
1700,4080,1,0,850,850,652000,1941
1050,5850,1,0,1050,0,260000,1980
3340,10796,1,2,2120,1220,1.33E+06,1964
1540,17859,1,0,1540,0,519500,1964
1710,5992,1.5,0,1560,150,650000,1928
2100,8075,2,0,2100,0,280000,1978
1730,7980,1,0,1730,0,515000,1965
1500,2692,2,0,1500,0,400000,1986
2380,5017,2,0,2380,0,652100,2003
2180,7956,2,0,2180,0,235000,1980
1840,10080,2,0,1840,0,701000,1907
2341,9594,2,0,2341,0,640000,1997
1690,4584,2,0,1690,0,455800,2002
2490,21937,2,0,2490,0,504750,1993
2440,15540,2,0,2440,0,483000,1992
920,20412,1,2,920,0,530000,1950
1030,8786,1,0,1030,0,250000,1956
2000,5885,1,0,1260,740,229950,1994
4210,9414,2,0,4210,0,884744,2001
1610,9964,1,0,1080,530,514000,1977
1910,35015,1,0,1430,480,532000,1977
2660,5539,2,0,2660,0,423000,2004
820,4025,1,2,820,0,420000,1922
1730,18250,1,0,1730,0,521000,1988
2360,7490,2,0,2360,0,577000,1979
970,8040,1,0,970,0,425000,1956
2460,4862,2,0,2460,0,495000,2004
2690,8577,2,0,2690,0,340000,1987
1820,1991,2,0,1430,390,499950,2014
3470,4750,2,2,2370,1100,1.22E+06,2014
3370,7634,1,2,2110,1260,720000,1977
1700,8247,1,0,1010,690,249000,1970
1340,11070,1,0,1340,0,206135,1978
2000,9276,2,0,2000,0,300000,1968
3840,14040,1.5,3,2460,1380,612000,1949
3890,27311,2,2,3890,0,1.10E+06,1950
1220,9100,1.5,0,1220,0,230000,1970
2280,4600,1,2,1250,1030,850000,1936
2770,7000,1,0,1940,830,355000,1979
2520,7253,2,0,2520,0,442000,1990
3060,5000,2,0,3060,0,399000,2001
2390,7115,2,0,2390,0,360000,1999
1320,7725,1,0,1320,0,390000,1978
2900,8711,1,0,1650,1250,413000,1977
700,9500,1,0,700,0,190000,1951
2210,9226,2,0,2210,0,432900,1998
2180,7741,2,0,2180,0,621138,1986
2080,4252,1.5,0,1550,530,270000,2003
2090,35040,1,0,1490,600,610000,1980
1720,5525,1,2,960,760,500000,1941
2460,40635,1,0,2460,0,715000,1968
1470,14821,1,0,1470,0,264000,1958
1650,3200,1.5,0,1650,0,550000,1901
1690,9087,1,0,1690,0,337000,1997
970,8710,1,0,970,0,170000,1962
2030,9095,1,0,1130,900,405000,1972
2540,28563,1,0,2540,0,775000,1984
1570,7475,1,0,1200,370,425000,1983
2580,9242,2,2,1720,860,713000,1967
2090,8712,1,0,1420,670,555000,1966
3260,5608,2,0,3260,0,810000,2003
3830,41263,2,0,3830,0,1.25E+06,1990
2130,6150,2,2,1530,600,819000,1908
1690,1200,2,0,1410,280,409900,2013
1780,2067,2,0,1780,0,935000,1974
1620,7560,1,3,1380,240,657500,1947
4210,6105,2,0,3280,930,900000,2008
2980,7095,2.5,0,2980,0,932800,1998
1490,9000,1,0,1490,0,391000,1977
2110,9825,2,0,2110,0,420000,2000
6563,32670,2,0,5153,1410,1.30E+06,2002
1510,16800,1,0,1510,0,415000,1956
1830,9425,1,0,1590,240,350000,1946
1230,1820,2,0,830,400,375000,1948
2180,14135,1,2,1300,880,860000,1947
2220,8872,1,0,1110,1110,495000,1961
1730,8400,1,0,1730,0,250000,1962
1990,21312,1,0,1990,0,365000,1968
1540,6760,1,0,1210,330,503000,1980
1100,7200,1,0,1100,0,150000,1944
1640,1480,1,0,820,820,450000,1912
2590,7213,2,0,2590,0,355000,2001
1450,9333,2,0,1450,0,245000,1972
1180,7793,1,0,1180,0,265900,1992
1820,7575,1,0,1220,600,299000,1975
2360,11523,2,0,2360,0,957500,1968
1120,7250,1,0,1120,0,343000,1972
1646,7364,2,0,1646,0,307500,1994
4210,14599,2,3,4210,0,937500,2004
2480,45302,1,0,1620,860,610000,1976
1590,7080,1,2,1310,280,720000,1952
2130,2620,1.5,0,1650,480,610000,1919
1650,7965,1,0,1650,0,434500,1967
3090,47044,1,0,2250,840,602500,1979
2180,4000,2,0,1700,480,607010,2002
1800,5750,1,0,1040,760,610000,1947
3720,35000,2,0,3720,0,828500,1983
1100,8560,1,0,1100,0,199990,1961
1530,9362,1,0,1530,0,294000,1987
3010,6100,2,0,3010,0,789500,2005
3500,9473,2,0,3500,0,797000,2008
3100,5250,2,0,3100,0,539950,2006
2000,6778,1,0,1170,830,284950,1962
2290,10372,1,0,1510,780,776500,1965
2400,10070,1,0,1510,890,525000,1967
1850,4957,2,0,1850,0,303000,1999
3680,7650,2,0,2340,1340,722080,1988
1060,7473,1,0,1060,0,140000,1959
1060,7473,1,0,1060,0,235000,1959
1610,5500,1.5,0,1610,0,440000,1903
2330,6000,1.5,0,1630,700,605000,1940
1210,4800,1,0,1060,150,380000,1950
1530,8890,1,0,980,550,352000,1925
2270,12000,1,0,1360,910,420000,1979
2590,7220,2,2,2590,0,1.18E+06,1930
1850,10572,1,0,1850,0,1.38E+06,1953
1500,14750,1.5,0,1500,0,300000,1933
4740,49091,2,0,4740,0,1.15E+06,1990
1710,4189,1,1,1160,550,453500,1951
1920,7598,1,0,1920,0,443500,1972
1150,8138,1,0,1150,0,332000,1954
2320,4721,2,0,2320,0,655000,2004
1420,6000,1.5,0,1420,0,475000,1950
1550,12956,1,0,1210,340,372500,1988
2920,7200,1,3,1470,1450,1.05E+06,1921
1620,4200,1,0,830,790,500000,1945
2300,24773,1.5,0,2300,0,900000,1950
1070,7140,1,0,1070,0,327500,1989
1790,7123,1,0,1790,0,390000,1913
1510,1962,2,0,1510,0,451101,1985
1340,5800,1.5,2,1340,0,455000,1914
3350,46748,2,0,3350,0,650000,2004
2500,7746,2,0,1910,590,895000,1993
2350,10664,1,1,1510,840,800000,1952
2550,12918,2,0,2550,0,703770,1987
1320,10454,1,0,1320,0,249950,1968
1270,3881,1,0,610,660,512000,1926
3480,74052,1,0,1980,1500,780000,1972
2820,11625,2,0,2820,0,336000,1986
2110,6900,1.5,0,1220,890,285000,1955
1100,7224,1,0,1100,0,229900,1981
1920,4000,1.5,0,1540,380,667500,1931
1890,12236,1,0,1230,660,378000,1978
2530,43733,2,0,1530,1000,454000,1991
2550,4630,2,0,2550,0,537500,2005
1550,4160,1.5,0,1550,0,425000,1926
1760,6600,1,0,1760,0,290000,1998
1270,3600,1,0,1270,0,349500,1963
1250,1655,2,0,830,420,370000,2006
1620,8438,1,0,1620,0,549500,1961
710,6322,1,0,710,0,245000,1942
1070,7200,1,0,1070,0,208000,1994
2320,8760,1,0,1160,1160,248000,1966
5450,37058,1.5,0,5450,0,610000,1984
1670,5116,2,0,1670,0,550000,1999
3010,206910,2,2,3010,0,750000,2001
1340,7380,1,0,1340,0,192000,1940
790,4000,1,2,790,0,169317,1908
3400,3850,2.5,0,2790,610,1.20E+06,2008
1530,6350,1.5,0,1530,0,880000,1923
930,7129,1,0,930,0,210000,1948
1540,9800,1,0,1010,530,180500,1973
1990,29078,2,0,1990,0,540000,1984
2300,35722,1,0,2300,0,520000,1984
1220,6000,1,0,1220,0,177500,1968
2380,5650,1,2,1190,1190,415000,1956
2020,7200,1,0,1010,1010,495000,1968
1890,9646,1,0,1890,0,325000,1966
1330,4903,1,0,1330,0,440000,1985
1490,9844,1,0,1190,300,411000,1959
3550,9600,2,0,2550,1000,810000,1998
2040,8996,1,2,1020,1020,561750,1962
2380,12573,1,0,2380,0,835100,1963
1780,9969,1,0,1450,330,450000,1985
1650,2807,2,0,1650,0,238000,2004
1510,142803,1,0,1510,0,299000,1974
1100,6240,1,0,1100,0,570000,1941
2190,12626,2,0,2190,0,340000,1978
1760,2275,1.5,0,1040,720,450000,1912
1800,8786,1,0,1330,470,272750,1966
2000,6380,2,0,1860,140,520000,1949
990,10723,1,0,990,0,284950,1960
1480,9660,1,0,1480,0,255000,1949
1200,9488,1,0,1200,0,231500,1941
3000,204732,2.5,2,3000,0,415000,1979
3504,6000,2,0,3504,0,330000,2006
1300,12240,1,0,1300,0,365000,1963
1330,9188,1.5,0,1330,0,425000,1928
1850,6480,1,0,1120,730,400000,1958
2240,9701,2,0,2240,0,335000,1989
1260,1251,2,0,1040,220,342000,2003
2800,2580,2,0,1880,920,490000,1997
1820,14319,1,0,1820,0,331500,1969
1730,4102,3,4,1730,0,960000,1996
3350,35298,2,0,3350,0,720500,1985
3370,6550,2,2,2840,530,830000,1912
1240,3600,1.5,0,1240,0,662990,1926
2340,10507,1.5,0,2340,0,220000,1959
1880,4179,1,0,940,940,349950,1952
1810,2159,1,0,1010,800,550000,1922
2340,5668,1,0,1200,1140,396000,1941
2820,4000,2,0,2820,0,635000,1911
1020,7650,1,0,1020,0,293000,1940
2090,10120,1,0,1290,800,339000,1979
1830,8734,2,0,1830,0,285000,1991
2980,5000,1.5,0,2480,500,775000,1916
1600,9289,1,0,1600,0,224000,1959
4440,8125,2,3,3140,1300,2.25E+06,1922
1200,8514,1,0,1200,0,165050,1959
1230,4500,1.5,0,1230,0,275000,1913
2930,5500,1,0,1750,1180,445000,1951
2370,38639,1,0,1930,440,510000,1978
3040,7000,2,0,3040,0,1.23E+06,2001
1610,13500,1,0,1060,550,390000,1970
2350,10450,1,0,1390,960,460000,1977
2000,14733,1,0,2000,0,700000,1958
3530,14406,2,1,2570,960,874150,1987
2220,9800,2,0,2220,0,470000,1987
2000,9416,1,0,2000,0,374000,1961
1210,131115,1.5,0,1210,0,510000,1950
1140,1181,3,0,1140,0,467000,2007
2440,28405,2,0,2440,0,576000,2002
1560,7352,1,0,1560,0,196440,1992
3210,18901,2,0,3210,0,825000,1993
930,2600,1,0,930,0,281000,1981
1782,1577,3,0,1782,0,326000,2000
1740,46580,1,0,1740,0,340000,1980
3690,36036,1,0,1890,1800,440000,1985
2930,18199,2,0,2930,0,749000,1998
1230,8316,1.5,0,1230,0,340000,1963
2000,7000,2,0,2000,0,561000,1916
1520,7930,1,0,1160,360,270000,1988
1040,3600,1,0,1040,0,600000,1919
1120,5427,1,0,1120,0,219900,1969
3020,360241,2,0,3020,0,617000,1992
1820,8446,2,0,1820,0,469000,1978
1370,56628,1,0,1370,0,229000,1942
3130,2646,2.5,0,2290,840,1.27E+06,1906
1640,8301,1,0,1290,350,365000,1958
2650,9301,2,0,2650,0,429000,2001
2850,6809,2,0,2850,0,550000,2003
1820,16300,1,0,1220,600,453000,1955
1180,7000,1,0,1180,0,187500,1977
1880,14350,1,0,1640,240,520500,1955
1280,12776,1,0,1280,0,300000,1977
3120,5000,2,0,2370,750,799000,2005
2470,4948,2,0,2470,0,338000,2003
1700,4400,1.5,0,1700,0,800000,1906
1180,3200,1,1,590,590,360000,1945
2800,10490,1,0,1400,1400,442500,1968
1300,1651359,1,3,1300,0,700000,1920
3040,9601,1,0,1970,1070,830000,1968
1630,11592,2,0,1630,0,360400,1987
1340,9339,1,0,1340,0,345000,1960
1830,51836,1,0,1430,400,300000,1966
1240,10800,1,0,1240,0,350000,1959
2500,36900,1,0,1540,960,368000,1972
1760,7482,1,0,1760,0,264000,1966
2660,16677,1,0,2210,450,435000,1990
2060,15837,1.5,0,2060,0,200000,1903
2540,3832,2,0,1760,780,620000,1929
4830,11466,2,0,3720,1110,1.68E+06,2014
1400,6000,1,0,700,700,337000,1919
4280,20296,2,0,4280,0,1.93E+06,1984
2230,10414,1,0,1450,780,544500,1974
680,1638,1,4,680,0,252000,1910
2340,3784,2,0,2340,0,445000,2008
2070,14196,2,0,2070,0,379500,1989
1910,4225,1,0,910,1000,189950,1919
950,4250,1.5,0,950,0,469000,1948
2910,53898,1,0,1510,1400,600000,1979
2930,33981,2,2,2930,0,785000,2000
2610,8967,2,0,2610,0,372000,1990
3880,7180,2,0,3880,0,445000,2004
3320,53392,2,0,2000,1320,508000,1986
1940,4800,2,0,1940,0,780000,1905
2510,9800,2,0,2510,0,541100,1978
2660,5608,2,0,2660,0,729000,2003
1710,134489,1,2,1710,0,397000,1952
1320,4520,1,1,1320,0,451555,1912
960,8153,1,0,960,0,300000,1947
1790,11542,1,0,1190,600,416000,1969
950,3060,1,0,810,140,490000,1925
2940,5054,2,0,2940,0,480000,1942
930,1662,1,0,670,260,368000,2002
4570,10615,2,0,4570,0,1.04E+06,1991
2370,9000,1,3,1570,800,545000,1952
3430,15119,2,0,3430,0,850000,1998
3540,4750,2,0,3540,0,550000,2003
2240,9314,2,0,2240,0,600000,1984
2710,12138,1,0,1700,1010,535000,1968
2660,4975,2,0,2660,0,599950,2014
2540,5022,1,0,1540,1000,531000,1955
2210,7665,2,0,2210,0,530000,1968
3570,8250,2,0,2860,710,597326,2015
3450,33460,2,0,3450,0,805000,1997
2330,8364,1,0,2330,0,390000,1968
1690,3250,1.5,0,1550,140,487250,1901
1030,8414,1,0,1030,0,301000,1967
2560,5618,1.5,2,2220,340,1.18E+06,1923
1950,3000,2,0,1950,0,299000,2002
4370,22863,2.5,3,3670,700,2.35E+06,1907
2350,3904,2.5,0,2350,0,400000,1999
3160,7210,1,0,1880,1280,467500,1969
2430,9103,2,0,2430,0,305000,1990
1340,306848,1,0,1340,0,210000,1953
1010,10168,1,0,1010,0,300000,1979
1770,8755,1,0,1330,440,327500,1981
1210,7136,1,0,1210,0,269000,2003
3330,17533,1,2,1750,1580,975000,1969
1240,5400,1,0,1060,180,355000,1940
1250,4620,1.5,0,1150,100,712000,1900
2960,41656,2,0,2960,0,883000,1985
840,12252,1,0,840,0,190000,1994
1530,8028,1,0,1200,330,443000,1967
3750,11025,2,0,3750,0,920000,1976
2150,8250,1,0,1240,910,285000,1978
1560,4080,1,0,1560,0,901000,1916
2040,5775,1,0,1410,630,552500,1958
860,5000,1,0,860,0,256000,1915
1720,7119,1.5,0,1720,0,341000,1952
2090,8941,2,0,2090,0,279000,1975
2130,10650,2,0,2130,0,686000,1977
1300,11867,1.5,0,1300,0,225000,1975
1220,15600,1,0,1220,0,215500,1972
2420,4800,1.5,0,1520,900,950000,1919
2940,156988,2,2,1870,1070,503000,1996
2610,7567,2,0,2610,0,780000,1997
1880,7500,1,0,980,900,212000,1946
2330,6703,1.5,0,1710,620,580000,1983
2200,3141,2,0,2060,140,465000,1994
1720,7560,1,0,1720,0,206000,1959
2250,10171,2,0,2250,0,615000,1987
1640,6305,1.5,0,1640,0,519000,1907
4130,11444,2,0,4130,0,1.14E+06,2001
2600,3839,2,0,2600,0,330000,2005
1920,7973,1,0,1920,0,240000,1955
2060,7000,1,0,2060,0,574000,1988
5710,24663,2,0,5710,0,930000,2007
2720,183823,2,0,2720,0,850000,1975
1490,7275,1,0,1090,400,415000,1974
2360,9005,1,0,1340,1020,480000,1929
1940,8875,1,0,1940,0,300000,1957
2570,9503,2,0,2570,0,439000,1980
1160,36831,1,0,1160,0,450000,1938
2660,206480,1,0,2660,0,589000,1989
1260,3000,2,0,1260,0,477000,2003
1780,6120,1,0,1310,470,587500,1951
3180,6105,2,0,3180,0,1.32E+06,1905
3380,27589,2,0,3380,0,1.43E+06,1966
2690,15000,2,0,1890,800,700000,1978
1180,6552,1,0,1180,0,275000,1949
1660,11783,1,0,1160,500,367500,1978
2260,6300,2,0,2260,0,453250,2001
1910,5428,1,0,1390,520,607000,1954
2430,8960,1,0,1430,1000,255000,1960
1300,2500,1,0,770,530,501000,1926
1060,4650,1,0,910,150,450000,1950
2200,8000,2,0,2200,0,360000,1981
1720,3050,1.5,0,1040,680,460000,1929
2360,8290,1,0,1180,1180,753000,1950
820,4234,1,1,820,0,389950,1951
1030,4400,1,0,1030,0,469000,1924
2030,5688,2,4,1730,300,550000,1939
2700,11675,1.5,2,1950,750,565000,1948
1100,7600,1,0,1100,0,189650,1980
3620,5131,2,3,2350,1270,1.53E+06,1927
1340,8000,1,0,1340,0,260000,1980
1790,12000,1,0,1040,750,243000,1960
3830,13800,1,4,2030,1800,1.10E+06,1969
1580,7200,1,0,1080,500,249000,1976
2020,7200,1,3,1700,320,720000,1947
3330,9557,2,0,3330,0,905000,1995
2610,3500,1.5,0,1610,1000,824500,1927
2610,8760,1,0,1760,850,762500,1978
1740,1280,3,2,1740,0,580000,2008
1840,8580,1,0,1840,0,380000,1990
1080,3200,1,0,880,200,805000,1926
1240,4532,1.5,0,1240,0,520000,1944
5620,5800,3,3,4700,920,1.57E+06,1999
1170,8925,1,2,1170,0,175000,1911
1760,9602,2,0,1760,0,353500,1987
2230,26989,1,1,1400,830,500000,1962
1520,7350,1,0,1140,380,386500,1972
1450,4750,1,0,850,600,210000,1950
1600,6510,1,0,940,660,439500,1983
3220,5751,2,0,3220,0,315000,2002
1830,8601,2,0,1830,0,339000,2003
2200,9163,1,0,1430,770,655000,1971
2170,8678,1,0,2170,0,740000,2008
1900,7843,2,0,1900,0,685000,1966
2960,9877,1,0,1480,1480,550000,1960
1710,4234,2,0,1330,380,405000,1920
2620,17366,1,3,1430,1190,765000,1984
2140,3600,2,0,1680,460,625000,1911
2100,19680,1.5,0,2100,0,207000,1914
2100,19680,1.5,0,2100,0,370000,1914
1460,4961,1,0,1150,310,475000,1988
990,8250,1,0,990,0,365000,1955
2190,6800,1,0,1340,850,411800,1969
3990,42436,2,0,2710,1280,668000,2002
2340,3630,2,0,2340,0,618000,1998
2460,5921,1,0,1230,1230,247500,1948
2080,6150,1,0,1040,1040,345000,1950
1700,8400,2,2,1700,0,616300,1927
1330,6768,1,0,1330,0,348000,1952
1630,10762,1,0,1630,0,425000,1994
2920,11880,1,0,1660,1260,850000,1968
2830,6137,2,0,2830,0,820000,2010
3190,52953,2,0,3190,0,832000,1980
1490,3840,2,0,1490,0,835000,1984
1630,3425,2,0,1630,0,350000,1999
2280,4096,2,0,2280,0,349000,2003
3010,4360,2,0,2000,1010,1.13E+06,2014
1590,3480,2,0,1590,0,320000,2004
1250,7210,1,0,1250,0,150000,1968
1710,10190,1,0,1310,400,340000,1949
3280,8448,2,0,3280,0,785500,2007
3362,8601,2,0,3362,0,410500,2004
2200,11000,2,2,2200,0,580000,1978
830,920,2,0,830,0,345000,2005
2160,37000,1.5,0,1760,400,550000,1933
2580,7299,2,0,2580,0,449500,1998
2150,7007,1,0,2150,0,300000,1954
3510,28052,2,0,3510,0,915000,1988
3810,9916,2,0,3810,0,1.58E+06,1989
2020,2750,1,0,1010,1010,599000,1917
2120,10202,1,0,1620,500,755000,1960
1250,7157,1,0,1250,0,400000,1944
980,9115,1,0,980,0,133000,1968
1250,8400,1,0,960,290,330000,1951
1100,5000,1.5,0,1100,0,330000,1904
1330,9417,1,0,710,620,375000,1936
2560,8956,1,0,1500,1060,485000,1968
1850,11250,1.5,0,1210,640,470000,1981
2790,3600,2,0,1880,910,1.05E+06,1905
1660,4704,1.5,0,1260,400,548800,1930
1080,2674,1,0,720,360,315000,1919
3030,9374,1,1,2100,930,590000,1959
2380,12067,2,0,2380,0,439950,2002
2250,26337,1,0,2250,0,325000,1980
880,5111,1,0,880,0,400000,1931
2770,10051,2,0,2770,0,685000,1987
1340,10200,1.5,0,1340,0,339950,1953
1660,8160,1,0,1660,0,315000,1951
1710,3795,2,0,1710,0,411753,2009
1620,4879,1,0,1040,580,577000,1924
1530,8829,1,0,1530,0,500000,1972
1440,10111,1,0,1440,0,210000,1963
2020,16120,1,0,2020,0,640000,1969
1870,8663,1,0,1870,0,460000,1949
620,4760,1,0,620,0,265000,1941
5774,31675,1,2,4490,1284,740000,1984
1240,6195,1,0,1240,0,230000,1948
1890,10661,1,0,1460,430,315000,1978
2410,51763,1,0,1410,1000,432000,1981
1530,3984,2,0,1530,0,467000,1995
2800,9900,1,0,2800,0,255000,1964
1460,6360,1,2,1010,450,316500,1979
1580,6250,1,0,860,720,190000,1977
1450,2400,1.5,0,1450,0,490000,1900
1990,23200,1,0,1990,0,378000,1976
4470,17877,3,3,3230,1240,598800,2013
1980,3868,1,0,1220,760,333800,1990
2920,9904,2,0,2920,0,690000,1990
1660,6200,1,0,830,830,320000,1948
3190,6000,1.5,3,2410,780,1.25E+06,1912
1560,9600,1,0,1560,0,335000,1961
3050,33920,1,0,3050,0,840000,2004
3030,21780,2,0,3030,0,608250,1986
2260,4165,2,0,2260,0,550000,2005
1260,7920,1,0,1260,0,240000,1966
3370,11757,2,2,3370,0,998000,1980
1490,8000,1,0,1490,0,275000,1978
1570,9292,1,0,1110,460,284200,1977
4490,7623,2,0,3090,1400,1.72E+06,1941
4090,24825,2,0,3400,690,2.40E+06,1926
4150,96574,2,0,4150,0,930800,1988
2900,10400,1,3,1530,1370,930000,1959
1430,8775,1,0,1030,400,215000,1979
1008,26487,1,4,1008,0,480000,1943
1480,5120,1,0,840,640,483945,1951
1240,8050,1,0,1240,0,347000,1978
1370,9760,1,0,1110,260,232500,1979
1770,33132,1,0,1190,580,390000,1965
2160,15360,1,0,1410,750,550000,1965
2340,8971,2,0,2340,0,590000,1987
960,40946,1,0,960,0,420850,1945
2280,8190,1,3,1390,890,345000,1983
1970,7000,1,0,1970,0,429800,1986
1530,17664,1.5,0,1530,0,302000,1968
1790,3952,1.5,0,1790,0,800000,1932
1700,6000,2,0,1700,0,250000,1997
2660,4500,1,0,1330,1330,605000,1922
1950,52256,1,0,1950,0,412000,1985
1340,5670,2,0,1340,0,252000,1994
1130,12500,1.5,0,1130,0,375000,1954
1950,2719,1,0,1010,940,725000,1919
3790,8200,1,1,2120,1670,471750,2001
2020,85813,2,0,2020,0,490000,1995
800,5100,1,0,800,0,439000,1945
1770,8890,1,0,1770,0,355000,1949
940,87120,1,0,940,0,250000,1944
2260,16188,1,0,2260,0,780000,1984
890,3271,1,0,890,0,409000,1918
860,3880,1,0,860,0,420000,1916
680,9600,1,0,680,0,200000,1947
2130,35679,1,0,2130,0,830000,1963
2390,4555,2,0,2390,0,695000,2006
3488,9614,2,0,3488,0,815000,1998
1260,6223,1,0,820,440,210000,1983
2940,6000,1,2,1590,1350,635000,1957
2440,7322,2,0,2440,0,562500,1991
2600,11951,2,0,2600,0,402500,1988
2080,7020,1,0,1040,1040,555000,1951
1990,7173,1,0,1990,0,310000,1972
2840,18001,2,0,2840,0,500000,1994
2630,8800,1,0,1610,1020,430000,1959
2820,7200,2,0,2460,360,1.60E+06,1930
1560,4080,1.5,0,1560,0,627500,1923
2330,7050,2,0,2330,0,335000,1998
3320,20100,1,0,1810,1510,962000,1981
1730,14270,1,0,1730,0,299000,1959
3110,5868,2,0,3110,0,399950,2001
1230,9660,1,0,1230,0,322000,1968
950,4625,1,0,950,0,430000,1949
1890,13860,1,0,1890,0,307000,1966
1010,5000,1,0,1010,0,194000,1943
1010,8581,1,0,1010,0,180000,1920
2340,13383,1,0,1170,1170,465000,1983
2460,9296,2,0,2460,0,722500,1978
1010,3400,1,0,1010,0,470450,1921
1650,6000,2,0,1650,0,280000,1990
1440,6702,1,0,1440,0,176250,1966
1710,9100,1.5,0,1320,390,560000,1926
2760,11287,2,3,2000,760,830000,1991
1350,10096,1,2,1350,0,276900,1952
1660,4800,2,0,1660,0,625000,1906
2960,4760,2,0,2160,800,1.02E+06,1900
1090,8750,1,0,1090,0,463500,1924
3110,9015,2,0,3110,0,485000,1990
1380,7476,1,0,1380,0,272000,1989
1290,3140,2,0,1290,0,305000,2008
1980,13964,1,0,1980,0,760000,1959
870,6126,1,0,870,0,387500,1938
2470,5015,2,0,2470,0,352000,2004
2140,40098,1,0,1490,650,507000,1950
770,9750,1,0,770,0,156000,1941
1490,857,3,0,1220,270,580000,2001
2510,35020,1,0,1610,900,630000,1977
1950,9000,1,0,1130,820,275000,1964
3600,14720,1,2,1800,1800,835000,1960
2380,7850,2,0,2380,0,340000,1995
720,6687,1,0,720,0,329350,1942
4070,26000,2,0,4070,0,1.48E+06,1991
1250,150117,1,0,1250,0,475000,1975
2190,2416,3,0,2190,0,719950,2014
810,2451,1,0,810,0,235000,1941
2440,5750,1,0,1320,1120,875000,1939
1740,9150,1,0,1740,0,380000,1974
1480,97138,1.5,0,1480,0,325000,1984
2120,57050,2,0,2120,0,475000,1989
900,4368,1,0,900,0,152900,1915
1190,7570,1,0,1190,0,210000,1939
1010,6000,1,0,750,260,350000,1925
2100,17882,2,0,2100,0,505000,1985
2020,8424,1,0,1380,640,464900,1979
2520,5980,1,0,1790,730,650000,1957
1370,1140,2,0,1080,290,369950,2009
1530,2890,2,0,1530,0,250000,2001
1530,2890,2,0,1530,0,320000,2001
5040,16048,1,3,3420,1620,2.53E+06,1950
2530,24700,2,0,2530,0,340000,1974
1010,1968,1.5,0,1010,0,440000,1906
1200,7727,1,0,1200,0,219950,1959
2720,11740,1,0,2720,0,940000,1957
1850,6125,1.5,0,1110,740,399950,1945
2340,8828,1,0,2340,0,1.57E+06,1954
1860,9750,1,0,1460,400,528000,1969
1940,8990,1,0,1560,380,545000,1956
1680,6194,1,0,1680,0,575000,2004
1770,10184,1,0,1250,520,235000,1979
1790,6371,2,0,1790,0,272000,1998
1720,9600,1,0,1720,0,380000,1969
1280,6967,1.5,0,1280,0,195000,1949
1690,4988,2,0,1690,0,297000,2002
2190,7294,2,0,2190,0,349000,2003
710,5200,1,2,710,0,320000,1942
1890,10707,1,0,1890,0,319990,1962
1410,12282,1.5,0,1410,0,439900,1909
2210,3600,2,0,1820,390,429000,1995
1540,6250,1,0,1540,0,272500,1998
1350,7255,1,0,1350,0,400000,1959
1380,4300,1.5,0,1380,0,462000,1916
890,6095,1,0,890,0,510000,1947
1900,3255,2,0,1900,0,550000,1988
1240,5200,1,0,1240,0,150000,1969
1730,8490,1,0,1210,520,460000,1969
2090,10306,2,0,2090,0,632500,1986
1650,11220,1,0,1650,0,361000,1969
1130,1221,2,0,1030,100,437000,2004
3240,5750,1,0,2160,1080,370000,1950
3840,12151,2,0,3840,0,884250,1998
1200,9936,1,0,1200,0,225000,1969
870,5000,1,0,870,0,235000,1949
2410,6000,2,4,2220,190,767500,1916
1560,8078,1.5,4,1560,0,1.20E+06,1928
2410,46609,2,0,2410,0,715000,1989
2300,7700,1,0,1380,920,417000,1959
1390,12145,1,0,1390,0,199000,1964
2920,5568,2,0,2320,600,875000,1906
1370,3708,1.5,0,1370,0,545000,1926
950,7692,1,0,950,0,192500,1926
3090,7708,2,0,3090,0,822500,1999
2390,10000,1,0,1590,800,800000,1975
2070,4944,2,0,2070,0,1.25E+06,1930
5770,21300,2,4,5770,0,3.85E+06,1980
1460,7936,2,0,1460,0,295000,1995
1510,4980,1,0,1510,0,419000,2006
5180,19606,1,0,2610,2570,1.20E+06,1993
3430,13907,2,0,3430,0,750000,1995
1700,8400,1,0,1700,0,502000,1953
2640,8000,1,3,1320,1320,1.03E+06,1960
1200,15960,1.5,0,1200,0,398500,1945
1850,4945,1.5,2,1850,0,700000,1907
1510,9078,1,0,1510,0,248000,1959
2130,2800,1,0,1070,1060,800000,1922
2640,8055,2,0,2640,0,383000,2004
3000,4000,1.5,3,1970,1030,688000,1913
1870,5455,1,0,1060,810,521000,1926
990,9223,1,0,990,0,365000,1949
2005,7000,1,0,1605,400,491000,1980
2030,7700,1,0,1400,630,643000,1965
1500,7350,1,0,1060,440,279000,1979
1530,3900,1.5,0,1530,0,583500,1908
1990,3600,2,0,1990,0,310000,2004
1420,7650,1,0,1100,320,310000,1984
1400,13975,1,0,1400,0,280000,1956
1870,5692,2,0,1870,0,272000,2004
3040,36246,1.5,0,2680,360,870000,1923
1790,7259,1,0,1390,400,307000,1980
1590,4500,1,0,920,670,490000,1946
2050,9396,1,0,1170,880,399950,1960
4220,26784,1,0,2110,2110,1.64E+06,1958
4030,13474,2,0,4030,0,989000,2000
1770,9011,1,0,1050,720,264950,1983
2100,7236,1,0,1400,700,491500,1979
2120,15003,2,0,2120,0,345000,1984
2600,18042,1,0,2020,580,339900,1969
2400,4000,2,0,1860,540,852000,1905
3180,40946,1,3,1690,1490,585000,1968
2790,8793,1,0,1640,1150,723000,1977
2080,70567,2,0,2080,0,594000,1990
1370,4102,2,0,1370,0,405000,1987
2790,74495,2,0,2790,0,725500,1997
1740,5719,1,0,1740,0,800000,1955
6400,76665,1,2,3810,2590,1.33E+06,1966
1800,8518,2,0,1800,0,180500,1996
1800,8518,2,0,1800,0,325000,1996
1190,7280,1,0,1190,0,235000,1968
860,8308,1,0,860,0,330000,1948
2460,6600,1,2,1370,1090,678500,1952
1980,6660,2,0,1980,0,463000,1974
670,4640,1,0,670,0,250000,1943
1410,4800,1.5,0,1410,0,655000,1927
1860,7000,1,0,1120,740,239900,1979
980,9135,1,0,980,0,185000,1955
3040,5000,2,3,2080,960,1.74E+06,1926
1810,11800,1,0,1240,570,251700,1977
1560,8250,1,0,1320,240,400000,1964
2100,7960,1,0,1340,760,735000,1955
2500,15250,2,4,2500,0,1.70E+06,1942
520,22334,1,0,520,0,82500,1951
3010,7221,2,0,3010,0,765000,2004
2140,8162,1,0,1420,720,292500,1968
2390,7000,1,0,1990,400,270000,1970
1510,6807,1,0,1090,420,415000,1939
2210,19025,1,0,1460,750,950000,1952
2170,8396,2,0,2170,0,353000,1995
1790,2375,3,0,1790,0,670950,2007
1390,8700,1,3,840,550,280950,1912
1850,7735,1,0,1850,0,585000,1983
1480,43645,1,0,1480,0,525000,1974
1850,8823,1,0,1370,480,605000,1973
3350,3752,2,0,2550,800,1.01E+06,2007
1040,8410,1,0,1040,0,245990,1942
2810,12607,2,0,2810,0,535000,1985
1010,5750,1,0,1010,0,410000,1911
2250,7752,2,0,2250,0,550000,1988
1800,8000,1,0,1800,0,665000,1972
2400,17239,1,0,1890,510,455000,1940
1780,4000,1.5,0,1780,0,440000,1922
2120,14915,1,0,1720,400,332000,1979
1860,6607,2,0,1860,0,280000,1989
1460,1021,2,0,1150,310,570000,2006
1230,10350,1,0,1230,0,250000,1957
1088,8453,1,0,1088,0,238000,1952
800,5760,1,0,700,100,265000,1949
1190,10350,1,0,1190,0,306000,1959
1940,4182,1,0,1240,700,345000,2002
3300,10764,1,0,1720,1580,765000,1971
2590,11018,2,0,2590,0,346300,1998
2080,11375,1,0,2080,0,342500,2002
2680,5439,2,0,2680,0,501000,2000
1670,8364,1,0,1300,370,270000,1990
1830,4400,1.5,0,1720,110,638000,1930
1400,2003,1,0,700,700,460000,1908
2770,8521,1,0,1470,1300,760000,1953
3630,11019,1,0,2150,1480,1.09E+06,1972
1040,8128,1,0,1040,0,234000,1983
2690,8890,2,4,2690,0,1.65E+06,1975
2020,5000,1.5,0,2020,0,488000,1938
2450,20805,2,0,2450,0,1.55E+06,1963
2030,12675,2,0,2030,0,499000,1982
1450,6776,1,0,1450,0,150000,1952
2400,7270,2,0,2400,0,333000,1993
2870,8625,1,1,1860,1010,700000,1959
1340,22500,1.5,0,1340,0,275000,1926
1680,11312,1,0,1080,600,330000,1959
1850,8827,1,0,1850,0,360000,1969
1220,8040,1.5,0,1220,0,467000,1965
2320,57063,1,0,1790,530,568000,1979
3220,9603,2,0,3220,0,605000,1972
3190,9023,2,0,3190,0,750000,2005
3530,69834,2,0,3530,0,760000,1994
2050,10519,1,0,1240,810,265000,1979
1720,12540,1,0,1720,0,490000,1956
2850,4650,2,0,2850,0,360000,2004
2270,12000,1,0,1290,980,311750,1976
1880,12473,1,0,1420,460,399000,1958
2770,9751,2,0,2770,0,347000,1989
4490,34982,2,0,4490,0,1.68E+06,1998
3110,6479,2,0,3110,0,585000,2005
2360,7475,2,0,2360,0,340000,1992
2180,5496,2,0,2180,0,612000,1994
1910,3376,2,0,1910,0,230000,1980
2260,7753,2,0,2260,0,604000,1989
1770,8868,1,0,1770,0,250000,1959
1460,7930,1,0,1460,0,258500,1989
2080,5000,1,0,1470,610,783000,1940
2960,7680,1,2,1550,1410,1.05E+06,1958
3220,4031,2,0,3220,0,760000,2002
1140,5000,1,0,1140,0,276000,1960
1660,12377,1,0,1660,0,550000,1966
1430,6240,1.5,0,1430,0,398000,1953
1820,4300,1.5,0,1620,200,775000,1914
3540,10202,2,0,2720,820,1.03E+06,1988
1620,6000,1.5,0,1620,0,327000,1905
3100,14568,2,0,3100,0,564500,1995
1500,6820,1.5,0,1500,0,782000,1905
2820,5510,2,0,2820,0,398000,2005
1850,10920,1.5,0,1850,0,257000,1915
1570,9415,2,0,1570,0,235000,1984
2300,37533,1,3,1550,750,453000,1979
920,9000,1,0,920,0,535000,1954
1600,7000,2,0,1600,0,275000,1993
2630,10047,2,0,2630,0,665000,1996
3020,13530,1,0,1540,1480,670000,1977
1490,10757,1,0,1060,430,465000,1966
1160,5200,1,0,1160,0,210000,1970
2040,4443,2,0,2040,0,265000,2001
1550,2657,2,0,1550,0,426000,1987
1990,7610,1,0,1290,700,529219,1966
1900,46609,1.5,0,1440,460,600000,1969
3840,8279,2,0,3840,0,875000,2001
2400,7680,1,0,1200,1200,608000,1956
1660,21514,1,0,1660,0,220000,1973
6055,21630,1,3,3555,2500,1.76E+06,1996
2030,17120,1,2,1890,140,295450,1966
840,5087,1,0,840,0,315000,1925
1450,8175,1,0,1450,0,205000,1967
1460,9908,1,0,1460,0,310000,1952
2010,5210,1.5,0,1890,120,1.00E+06,1927
2910,7631,2,2,2910,0,525000,2006
1880,8800,1,0,1130,750,284000,1960
2170,26460,1,0,1450,720,510000,1986
1260,4377,1,0,1260,0,405000,1947
1970,9153,2,0,1970,0,509950,2007
2090,45738,2,0,2090,0,600000,1987
3450,4940,2,0,2570,880,990000,2006
1130,7200,1,0,1130,0,280005,1954
2600,7668,1,0,1300,1300,700000,1968
1030,7620,1,0,1030,0,330000,1953
1700,6718,1,2,1230,470,340000,1956
1480,2167,2,0,1390,90,468000,2007
4250,19387,2,2,3260,990,1.34E+06,1972
1600,20873,1,0,1600,0,515000,1955
1870,8750,1,2,1870,0,245000,1977
1440,7741,1,0,1000,440,265000,1983
2720,11937,2,0,2720,0,372400,1990
1240,8410,1,0,1240,0,390000,1948
1020,6120,1,0,1020,0,208000,1967
1180,7750,1,0,590,590,273000,1945
3080,7759,2,0,2310,770,455000,2003
1750,6397,2,0,1750,0,270000,1988
2530,8736,1,0,1210,1320,618000,1958
1580,8541,2,0,1580,0,213550,1990
2340,9148,2,0,2340,0,210000,1957
6300,16065,2,1,4360,1940,2.75E+06,2004
2400,3844,1,0,1200,1200,403500,1974
1300,7600,1,0,1300,0,235000,1963
1760,7147,1,0,880,880,287500,1936
1520,5910,1,0,1020,500,546800,1946
1070,8100,1,0,1070,0,183000,1957
2560,216777,1,0,2560,0,560000,1986
1280,6726,1,0,1280,0,299500,1958
1660,7350,1,0,1660,0,610000,1965
1860,7963,1,0,1200,660,288350,1963
950,4500,1,2,850,100,500000,1926
2140,4000,1,0,1190,950,625000,1951
1480,1349,2,0,1240,240,418000,2007
2260,1825,2,0,1660,600,660000,2002
2300,6158,2,0,2300,0,775000,1999
1650,7272,1,0,1230,420,429500,1972
1990,3000,1.5,0,1230,760,569000,1908
1960,7560,1,0,1160,800,250000,1978
1310,10491,1,0,1310,0,225000,1969
2450,15002,1,0,2450,0,530000,1974
910,8658,1,0,910,0,306000,1955
1580,9719,1,0,1580,0,517100,1962
1780,9689,1,0,1130,650,354950,1976
1040,1824,1,0,1040,0,348000,1925
2340,41600,1,0,1640,700,522250,1977
1720,8755,1,0,1000,720,275000,1983
1600,10440,1,0,1600,0,390000,1954
1320,9750,1,0,1320,0,260000,1954
2350,4178,1.5,0,1520,830,585000,1922
2740,5616,1.5,0,1670,1070,605000,1925
2300,6448,2,0,2300,0,342000,2001
4350,37169,2,0,2950,1400,900000,1972
1430,7700,1,0,980,450,252000,1981
2400,14012,1,0,2400,0,357000,1971
940,7910,1,0,940,0,370000,1959
1020,13504,1,0,1020,0,322500,1959
1680,5756,2,0,1680,0,210000,1910
1340,9840,1,0,1340,0,290000,1949
3960,7012,2,0,3960,0,860000,2005
2650,4621,1.5,0,2650,0,302000,1911
2120,9680,2,2,2120,0,369160,1965
2850,3000,2.5,0,2530,320,1.19E+06,2003
2850,14810,2,0,2490,360,993000,1954
1870,6969,1,0,1870,0,380000,1968
2660,8160,1,0,1380,1280,635000,1949
1190,11120,1,0,1190,0,260000,1947
1770,5522,1.5,0,960,810,243000,1943
2770,8879,2,0,2770,0,1.40E+06,2001
2080,8100,1,2,1220,860,665000,1952
2700,9000,2,0,2700,0,898000,1987
2200,9453,1,0,1100,1100,583000,1955
2160,7700,2,0,2160,0,429000,1977
2010,4059,2,0,2010,0,471000,1998
3780,8295,2,0,2430,1350,1.81E+06,1951
4460,51177,2,0,4460,0,739500,2005
1770,17208,1,0,1160,610,450000,1959
1430,5000,1,0,1430,0,552500,1949
1700,10642,1,0,850,850,437000,1954
1830,5220,1.5,0,1830,0,270000,1951
1410,8800,1,0,1410,0,226740,1965
3060,7920,1,0,1810,1250,446500,1974
1820,15068,2,2,1520,300,283000,1920
2430,13211,1.5,0,2430,0,445000,1909
740,6840,1,0,740,0,250000,1942
770,6552,1,0,670,100,307000,1942
2200,8580,1,0,1860,340,315000,1991
2920,23085,1.5,2,1540,1380,555000,1908
2040,7000,1,0,1250,790,264900,1979
1600,4510,1,0,990,610,510000,1978
1990,3980,2,0,1990,0,328000,2002
1830,7308,2,0,1830,0,358000,2002
2540,4260,2,0,2540,0,325000,2005
2700,3444,3,3,2700,0,1.37E+06,1990
1440,10800,1,0,1440,0,230000,1967
1550,4000,1,0,940,610,545000,1955
2490,4343,2,0,2490,0,705380,2003
2650,12987,1,0,1350,1300,459000,1979
2000,3800,2,0,2000,0,815000,2001
3440,4500,2,0,3280,160,495000,2007
2280,58712,2.5,3,2280,0,520000,1987
1320,1194,3,0,1320,0,430000,2001
2070,7800,2,0,2070,0,255000,1989
1860,4777,2,0,1860,0,588000,1908
940,7811,1,0,940,0,350000,1959
2290,21486,1,2,2290,0,625000,1963
1510,20685,1,0,1250,260,172500,1958
1830,3500,1.5,0,1290,540,554000,1909
3090,7112,2,0,3090,0,775000,2001
4340,217800,2,0,4340,0,1.19E+06,2003
3200,12682,2,1,3200,0,618000,1977
1560,8450,1.5,0,1560,0,305000,1954
1280,13356,1,0,1280,0,232000,1994
2020,6236,2,0,2020,0,262000,2002
1040,8122,1,0,1040,0,234000,1971
2260,7209,1,3,1330,930,500000,2002
860,7632,1,0,860,0,278000,1920
1920,19040,1,0,1160,760,230000,1961
2290,9215,1,0,1270,1020,500000,1969
2070,9300,1,0,1120,950,366500,1945
4250,4400,2.5,0,3020,1230,665000,1902
2220,4830,2,3,1790,430,1.10E+06,1928
1840,4076,1,0,1140,700,575000,1957
2590,9753,2,0,2590,0,674750,1993
3110,6131,1,0,1560,1550,719000,1940
2600,105587,1,0,1300,1300,482000,1980
1060,8187,1,0,1060,0,254000,1952
1250,3880,1,0,750,500,443725,1944
2520,35636,2,0,2520,0,575000,1980
2070,9957,1,0,1440,630,469000,1977
1300,44431,1,0,1300,0,175000,1958
2190,8316,1,0,1390,800,437000,1961
2760,13113,1,0,1760,1000,550000,1974
1710,7134,1,0,1130,580,172040,1979
1750,7000,1,0,1750,0,363000,1993
1552,3600,2,0,1552,0,282000,2012
2350,6554,2,1,2000,350,400000,1905
5110,10018,2,0,3850,1260,650000,2003
1720,99916,2,0,1720,0,365000,1990
1960,7230,2,0,1960,0,269950,2002
1270,19602,1,0,1270,0,260000,1977
1180,7000,1,0,1180,0,193000,1977
2230,6791,2,0,2230,0,340000,2005
4700,38412,2,0,3420,1280,900000,1978
2150,8361,2,0,2150,0,371000,1991
2400,81892,2,0,2400,0,592000,1985
1830,12750,2,0,1830,0,300000,1991
2800,6977,2,0,2800,0,449950,2003
2090,7163,2,0,2090,0,299500,1989
2340,13406,1,0,2340,0,995000,1963
1670,9472,1,0,1100,570,335000,1960
1990,7350,1,0,1180,810,280000,1978
2270,7800,1,0,1290,980,446000,1977
4910,15139,1,0,2560,2350,1.54E+06,1964
950,4500,1,0,950,0,325000,1943
1610,11200,1,0,1610,0,450000,1955
1940,7107,2,0,1940,0,322500,2000
1210,9473,1,0,1210,0,453000,1955
2570,4412,2,0,2570,0,655000,2001
1700,2800,2,0,1150,550,603000,1926
1610,24000,1.5,0,1610,0,235000,1947
4120,7304,2,0,3070,1050,968933,2006
2880,11340,1,0,1690,1190,1.02E+06,1980
1990,8548,2,0,1990,0,435000,1973
1260,8092,1,0,1260,0,242000,1986
4750,248600,2,0,4750,0,487000,1947
3010,10450,2,0,3010,0,810000,1996
2410,64073,1,0,1820,590,625000,1976
1280,7742,1,0,1280,0,165000,1973
2320,6750,1,0,1160,1160,335000,1960
1220,6600,1,0,1220,0,286700,1958
1400,4050,1,0,1400,0,699000,1954
1590,7280,1,0,1140,450,280000,1974
2220,7064,2,0,2220,0,580000,1988
2770,7781,2,0,2770,0,754800,2006
2303,16801,2,0,2303,0,525000,1995
1600,10530,1,2,1600,0,562000,1962
1280,6060,1,0,860,420,575000,1926
2900,5901,2,0,2900,0,808900,2006
2950,15207,1,0,2070,880,992000,1966
1700,6698,2,0,1700,0,335000,1997
1050,7200,1,0,1050,0,473000,1985
2990,11210,1,1,1880,1110,350000,1977
3100,5374,2.5,0,3100,0,1.60E+06,1906
1240,6090,1,0,1240,0,305500,1950
780,13500,1,0,780,0,306000,1946
850,1656,2,0,850,0,233000,2001
1540,9000,1,0,1540,0,490000,1971
2280,42077,2,0,2280,0,445000,1994
2550,9674,1,0,1850,700,355000,1959
1770,7607,1,0,1770,0,360000,1987
2320,10900,2,0,2320,0,737500,1935
2600,11920,2,0,2600,0,985000,1969
1570,2031,2,0,1310,260,349950,2006
3060,7161,2,0,2860,200,520000,2005
1960,8540,1,0,1220,740,355950,1955
3270,6129,2,0,3270,0,485000,2004
1090,3315,1,0,1090,0,143000,1969
6840,10000,2.5,4,4350,2490,3.28E+06,2001
940,8512,1,0,940,0,355000,1967
3880,13885,2,3,2540,1340,1.13E+06,1979
1770,15525,1,0,1770,0,200000,1959
3640,10576,2,0,3640,0,913000,1999
3160,12824,1,2,1820,1340,1.60E+06,1966
1590,1845,2,0,1590,0,409900,1997
1290,6034,1,0,1050,240,265000,1950
3655,51836,1,0,2174,1481,740000,1955
2490,8124,2,0,2490,0,306000,2001
1470,3999,2,0,1470,0,381000,2003
3960,6132,2,3,2600,1360,1.22E+06,1933
3190,29982,1,3,2630,560,1.05E+06,1941
810,7440,1,0,810,0,408000,1948
2980,5377,2,0,2980,0,739900,2006
2780,35000,1,0,2780,0,674250,1985
1340,8100,1,0,1340,0,438400,1953
4930,14649,2,3,4160,770,1.70E+06,2000
1360,5980,1.5,0,1360,0,703000,1945
1320,6530,1,0,1320,0,262000,1989
1210,14499,1,0,1210,0,353000,1984
1940,7607,2,0,1940,0,500000,1995
3160,4620,1.5,4,2020,1140,1.28E+06,1917
1980,6566,2,0,1980,0,332000,2004
2320,14240,1,0,1620,700,824000,1974
1660,4788,1,0,1660,0,290000,1968
1660,1545,2,2,1400,260,700000,2002
1080,3420,1,0,780,300,550000,1922
1510,11165,1.5,0,1510,0,549000,1921
2950,43560,1,2,2550,400,1.87E+06,1951
3070,13720,2,0,3070,0,858000,1978
970,10423,1,0,970,0,345000,1947
2140,11651,2.5,0,2140,0,340000,1930
2570,9600,2.5,0,2570,0,1.22E+06,1962
1260,1488,3,0,1260,0,275000,2009
1220,7771,1,0,1220,0,405000,1963
1720,8145,2,0,1720,0,432500,1949
2140,4217,1.5,0,1320,820,236500,1925
1420,4923,1.5,0,1420,0,679000,1928
2060,8451,2,0,2060,0,543000,1995
1320,9520,1,0,990,330,294000,1953
1810,10463,1,0,1810,0,340500,1969
2980,16263,2,0,2980,0,1.01E+06,1989
1350,2560,1,0,1350,0,335000,1976
1540,8011,1,0,1540,0,425000,1988
2510,9240,2,0,2510,0,353000,2001
1670,5146,2,0,1670,0,540000,1991
3690,11928,2,0,2540,1150,640000,2006
1320,11457,1,0,1320,0,339950,1959
1510,8400,1,0,980,530,195000,1979
1510,8400,1,0,980,530,322000,1979
1870,10450,1,0,1620,250,660000,1978
2400,9373,2,0,2400,0,280000,1991
2400,9373,2,0,2400,0,300000,1991
1170,8816,1,0,1170,0,207500,1966
1190,8726,1,0,1190,0,195000,1956
2080,3880,1,0,1160,920,700000,1954
2150,8555,1,2,1460,690,560000,1982
1580,7344,1,0,1580,0,260000,1911
1580,7344,1,0,1580,0,575000,1911
2370,3239,2,0,1950,420,475000,2006
1840,8601,1,0,920,920,285000,1905
2660,5500,2,2,2660,0,753888,2003
2190,3600,2,0,2190,0,650000,2003
1660,3478,1.5,0,1100,560,620000,1929
1780,37801,1,0,1300,480,526000,1977
700,5200,1,0,700,0,155000,1952
1570,11200,1,0,1120,450,342000,1959
1220,216332,1,0,1220,0,390000,1981
3150,219978,2,0,3000,150,685000,1990
2690,4736,2,0,2690,0,608000,2001
680,6400,1,0,680,0,179900,1943
3750,14150,2,2,2750,1000,1.25E+06,1936
1010,11675,1,0,1010,0,166000,1957
1710,4500,1.5,0,1410,300,462000,1928
2090,6023,2,0,2090,0,545000,1990
1560,4500,1.5,0,1560,0,415000,1903
1560,4200,2,0,1560,0,269000,2003
2570,11473,2,0,2570,0,356500,2008
1010,7633,1,0,1010,0,225000,1961
1020,5130,1,0,1020,0,175000,1948
1710,9720,2,0,1710,0,549000,1974
2300,12197,2,0,2300,0,535000,1989
1990,7712,1,0,1210,780,627000,1973
2730,15677,2.5,3,2730,0,565000,1976
2195,2681,1,0,1060,1135,392450,1912
1560,4675,1,0,1560,0,509000,2006
1400,4800,1,0,1200,200,340000,1921
1400,4800,1,0,1200,200,537000,1921
3690,9892,2,0,3690,0,865000,1998
1140,8340,1,0,1140,0,358000,1948
1920,3225,1.5,0,1300,620,595000,1923
2496,8058,2,0,2496,0,661000,1998
2280,8500,1,0,1680,600,419950,1977
3200,6420,2,0,3200,0,490000,2006
880,4000,1,0,880,0,525000,1940
1320,1298,3,0,1320,0,350000,1995
2450,3582,2,0,2450,0,552500,2008
1040,8970,1,0,1040,0,210000,1961
2480,53250,2,0,2480,0,390000,1990
1830,16650,1.5,0,1610,220,336800,1958
1440,4473,2,0,1440,0,465000,2003
1580,3632,2,0,1580,0,299900,2011
3230,5000,2,0,3230,0,715000,2006
1810,39639,1,0,1230,580,235000,1970
2495,4400,2,0,2495,0,276000,2007
1740,12728,1,0,1180,560,265000,1964
1680,3000,1,2,840,840,425000,1900
2460,10320,2,0,2460,0,313000,1993
3050,6000,1,3,1720,1330,715000,1984
1630,10969,2,0,1630,0,265000,1991
2460,6413,2,0,2460,0,646000,2004
1030,6600,1,0,1030,0,175000,1954
3410,13809,1,3,2450,960,649000,1973
2310,5200,1,0,1520,790,785000,1940
2610,4400,1,0,1260,1350,890000,1920
2330,10327,1,0,2330,0,612000,1998
2980,5674,2,0,2980,0,330000,2003
1790,11393,1,0,1790,0,493000,1978
2940,5735,1,0,1470,1470,1.60E+06,1957
3900,9750,1,4,2520,1380,1.62E+06,1972
3900,9750,1,4,2520,1380,1.65E+06,1972
1750,2150,2.5,0,1230,520,499000,1900
2660,8400,1,0,1550,1110,603500,1962
1580,3680,1,2,1280,300,530000,1941
2350,14197,1,0,1220,1130,895000,1962
2510,8165,1,0,1610,900,267345,1972
1480,15639,2,0,1480,0,275000,1987
1720,223377,1,0,1240,480,439950,1950
1470,4653,2,0,1470,0,455000,1985
1540,6930,1,0,1250,290,630000,1944
2820,5001,2,0,2820,0,690000,2004
1250,12705,1,0,1250,0,212000,1971
2080,7526,1,0,1280,800,231500,1985
5180,49936,2,0,5180,0,1.24E+06,1991
2860,43821,2,0,2860,0,378500,1990
2710,35868,2,0,2710,0,482000,1989
1140,3990,1,0,1140,0,695000,1924
4070,57587,2,0,4070,0,965000,1989
1710,5913,1,0,1120,590,675000,1941
1340,6500,1,0,1340,0,387000,1972
2290,7000,2,0,2290,0,347500,1977
1860,7400,1,0,930,930,385000,1922
1080,4930,1,0,1080,0,265000,1950
960,5264,1,0,960,0,406000,1953
980,5000,2,0,980,0,134000,1922
1500,3399,2,0,1300,200,415000,1926
1440,8775,1,0,1440,0,375000,1973
2580,7465,2,0,2580,0,620000,1993
2070,4698,2,0,2070,0,337500,1999
1880,12368,1,0,1260,620,565000,1967
2420,12676,2,0,2420,0,399500,1911
1890,9466,2,0,1890,0,1.07E+06,1987
1920,33630,1,0,1920,0,352500,1992
1870,5909,1,0,1270,600,259000,1986
900,7620,1,0,900,0,320000,1971
2160,9888,2,0,2160,0,733000,1989
900,2910,1,0,900,0,381500,1924
1180,9261,1,0,940,240,343000,1957
900,6400,1,0,900,0,205500,1938
1600,16530,1,0,1600,0,525000,1967
1500,8352,1,2,750,750,300000,1943
1070,189486,1,0,1070,0,299000,1942
2570,5250,2,0,2570,0,561000,1990
1210,4000,1.5,0,1090,120,450000,1928
1850,7850,2,0,1850,0,540000,1985
1740,30886,2,0,1740,0,379000,1992
1300,14000,1,0,1300,0,230000,1958
2000,30605,2,0,2000,0,399950,1989
3220,5806,2,0,3220,0,355000,2002
2160,9593,1,0,2160,0,580000,1969
2130,4299,1.5,0,1680,450,700000,1922
1580,8151,1,1,1100,480,279900,1962
1200,7500,1,0,1200,0,210000,1905
3790,5001,2,0,2810,980,1.17E+06,1989
860,3874,1,0,860,0,290300,1931
5130,43123,2,0,5130,0,1.60E+06,1996
1600,6380,1.5,0,1400,200,490000,1939
2110,13850,2,0,2110,0,606000,1987
1400,4980,1,0,950,450,359950,1943
2110,9199,1,0,2110,0,677100,1993
1430,7125,1,0,1430,0,465000,1984
6640,40014,2,4,6350,290,4.50E+06,2004
3040,41072,1,0,1520,1520,500000,1978
980,5000,1,0,980,0,455000,1950
2570,4240,1.5,0,1970,600,705000,1911
2060,7020,1,0,1460,600,420000,1967
1300,8284,1,0,1300,0,169575,1968
1300,8284,1,0,1300,0,250000,1968
1680,7262,1,0,1180,500,530000,1973
4020,40341,1,0,2170,1850,590000,1970
1530,14087,1,0,1070,460,257500,1979
1170,6700,1,0,1170,0,415000,1957
1580,3764,1.5,0,1280,300,536000,1945
1270,11600,1,0,1270,0,246500,1964
1480,7700,1,0,1480,0,395000,1975
2220,10530,1,0,1700,520,739000,1974
3200,13729,2,0,3200,0,1.27E+06,1984
910,10575,1,0,910,0,190000,1968
1480,9086,1,0,1480,0,305000,1962
3770,13058,2,0,3770,0,925000,1983
3500,13444,2,0,2360,1140,895000,1977
1480,7475,1.5,0,1480,0,656000,1943
1660,4690,1.5,0,1260,400,560000,1945
2520,11700,2,0,2520,0,610000,1977
2850,37522,2,0,2850,0,645000,1987
2153,4400,2,0,2153,0,259000,2007
3780,10962,2,0,3780,0,980000,1990
3770,9750,1,0,1940,1830,872000,1967
3600,9675,1,2,1940,1660,1.00E+06,1977
2980,12600,1.5,0,1590,1390,900000,1941
2320,5534,1.5,0,1540,780,475000,1915
2980,13482,1,0,1730,1250,350000,1975
2930,11562,1,3,1670,1260,840000,1947
2040,8400,1,0,1420,620,500000,1963
1510,9898,1,0,1110,400,202500,1954
2660,65340,2,0,2660,0,523000,1988
1740,10050,2,0,1740,0,225000,1989
2240,9542,1,1,1190,1050,418200,1980
1570,9670,1,0,1170,400,356500,1959
2500,5000,1.5,0,1460,1040,670000,1926
1750,12408,1,0,1150,600,456150,1962
3030,9687,2,0,2020,1010,471000,1998
1680,934,3,0,1680,0,558000,2008
5740,10312,2,2,3610,2130,1.38E+06,2000
1220,6000,1,0,1220,0,161500,1961
1310,8370,1.5,0,1310,0,311000,1962
2490,8732,1.5,0,2490,0,470000,1966
2220,8227,1.5,0,1770,450,569000,1929
2240,7350,2,0,2240,0,689000,1989
1890,11875,1,0,1230,660,271900,1979
1850,6037,2,0,1850,0,278000,1991
2210,4440,2,0,1440,770,820000,1931
1410,7700,1,0,1410,0,399500,1967
1890,2614,2,0,1890,0,462000,1979
1830,12036,1,0,1550,280,347500,1977
1440,3700,1,0,1200,240,562100,1914
950,7560,1,0,950,0,230000,1958
2370,10083,2,0,2370,0,687000,1966
3070,5762,2,0,3070,0,725786,2000
1300,12600,1,0,1300,0,315500,1969
1300,7054,1,0,1300,0,312000,1950
1210,1173,2,0,1000,210,343000,2002
710,6000,1.5,0,710,0,385195,2015
2240,12650,1,0,1730,510,415000,1981
3600,8666,2,0,2400,1200,461000,1948
1960,7133,2,0,1960,0,369990,2002
1820,3134,2,0,1820,0,349950,1999
1960,17126,1,0,1400,560,285750,1966
1750,10160,1,0,1320,430,542500,1972
3700,5400,2,0,2890,810,830000,2011
2910,20946,2,0,2350,560,705000,1976
1270,5000,1,0,1090,180,615000,1949
720,5880,1,0,720,0,184500,1940
1040,5120,1,0,1040,0,412000,1901
2210,11111,1.5,0,2210,0,250000,1934
2060,6000,2,0,2060,0,580000,1903
780,6000,1,0,780,0,220000,1923
2240,8937,1,0,1460,780,675000,1976
800,3330,1,0,800,0,373500,1918
2440,6900,2,0,1590,850,662700,1910
1460,6032,2,0,1460,0,239950,1941
1150,10196,1,0,1150,0,383000,1957
2650,12350,1,0,1470,1180,485000,1975
2600,36583,1,0,1580,1020,610000,1976
1820,6250,1,0,1130,690,545000,1954
2560,2500,2,0,1690,870,780000,1901
1714,3240,2,0,1714,0,305000,2005
1330,15678,1,0,900,430,405000,1984
7350,12231,2,4,4750,2600,1.11E+06,2001
2050,9045,2,0,2050,0,273000,1959
1810,12375,2,0,1810,0,326500,1970
1380,9134,1,0,880,500,365000,1981
3070,10739,2,0,2440,630,1.00E+06,1987
800,4046,1,0,800,0,422500,1940
2140,9920,2,0,2140,0,354450,1993
1330,9540,1,0,1330,0,320000,1971
1030,9120,1,0,1030,0,223000,1961
1740,4948,2,0,1740,0,410000,2008
1200,4000,1.5,0,1200,0,438000,1923
1490,2944,2,0,960,530,390000,1993
1890,5954,2,0,1890,0,298500,2004
3060,13630,2,0,3060,0,749999,1989
3250,12000,1,1,1800,1450,779000,1966
2730,11936,2,2,1530,1200,570000,1978
810,4600,1,0,810,0,385000,1918
2240,11040,1,0,1120,1120,649000,1961
1740,5247,1,0,1270,470,283000,1947
2380,16236,1,0,1540,840,699900,1961
1540,8400,1,0,770,770,278500,1971
2340,9100,1,0,1610,730,700000,1975
2710,45963,2,0,2710,0,535000,1995
1310,18400,1,0,870,440,234500,1954
1390,9585,1,0,1390,0,374150,1973
2201,9542,2,0,2201,0,397000,2006
1960,10385,1,0,1960,0,613000,1988
2850,10474,1,0,1730,1120,1.15E+06,1954
1880,4080,1,0,940,940,595000,1924
2440,6858,2,0,2440,0,340000,2003
2560,5800,2,0,2560,0,388000,2005
1410,15210,1,0,1410,0,404000,1950
2870,6360,1.5,1,1790,1080,810000,1946
2620,9359,2,0,2620,0,405000,1987
2970,10335,2,0,2970,0,726000,2000
1780,7214,1,0,1400,380,266000,1986
3700,7207,1,1,1850,1850,722500,1970
1252,25002,1,0,992,260,352000,1996
1240,8158,1,0,1110,130,265000,1961
2160,3920,2,0,2160,0,856000,2014
2040,4348,2,0,2040,0,346950,2006
3130,4797,2,0,2570,560,866059,2014
2350,4456,2,0,2350,0,410000,2004
1570,16817,2,0,1570,0,370000,1982
1530,389126,1.5,0,1530,0,230000,1919
1520,5010,1,0,1520,0,400000,1999
1350,9680,1,0,820,530,172000,1959
1950,8480,1,0,1250,700,615000,1962
3950,9600,2,0,3950,0,860000,1998
2040,6000,1,0,1120,920,555000,1958
1990,4040,1.5,0,1390,600,579000,1926
1300,7030,1,0,1300,0,385000,1968
2030,12000,2,0,2030,0,420000,1977
2340,6750,1.5,0,1620,720,645000,1914
2160,6288,2,0,2160,0,549950,1996
2770,10000,1,1,1640,1130,678000,1962
2030,8120,2,0,2030,0,199000,1950
1440,13824,1,0,1440,0,604000,1957
1730,10368,1,0,1010,720,268000,1963
4510,16305,2,0,2820,1690,960000,2003
2100,7600,1,0,1450,650,509250,1980
1800,5372,2,0,1800,0,416000,1987
1090,8520,1,0,1090,0,190000,1967
1010,10000,1,0,1010,0,212000,1973
2040,9765,2,0,2040,0,325900,1985
2270,4088,2,0,1880,390,560000,1996
1730,5799,2,0,1730,0,275000,1987
2480,15411,2,2,2480,0,665000,1994
3480,7232,2,0,2580,900,1.51E+06,1926
1720,2410,1,0,970,750,375000,1930
1570,6975,1,0,1040,530,359950,1979
3527,7200,2,0,3527,0,340000,2005
840,8100,1,0,840,0,401000,1948
1950,10766,1,3,1160,790,669000,1952
1980,6568,2,0,1980,0,638500,2004
1620,3760,2,0,1170,450,545000,1924
1980,7015,1,0,1260,720,524000,1973
3530,13260,2,0,3530,0,1.61E+06,2013
1260,4800,1,0,1100,160,280000,1947
2120,10841,1,0,1500,620,828000,1979
1360,10573,1,0,1360,0,223000,1984
3100,2261,2,2,2250,850,1.29E+06,1981
2370,155130,1,0,2370,0,750000,1970
1460,9207,1,0,1210,250,430000,1947
1980,10800,1,0,990,990,711000,1948
1930,7014,2,0,1930,0,310000,1994
3700,9140,1,0,1850,1850,415000,1957
1970,6600,2,0,1970,0,274900,1987
2470,36445,2,0,2470,0,525000,1980
1180,32214,1,0,1180,0,179500,1952
1280,2580,1.5,0,1280,0,478000,1910
1380,7350,1,0,990,390,195000,1981
2740,10925,1,0,1670,1070,385000,1980
2020,9505,1,0,1260,760,401000,1969
2835,6598,2,0,2835,0,522000,2002
1520,14417,1,0,1520,0,330000,1968
2190,4882,2,0,2190,0,503000,1999
1680,8400,1,0,1680,0,175000,1979
3915,6364,2,0,3915,0,963990,2014
1720,9972,1,0,1720,0,845000,1951
670,4500,1,0,670,0,157500,1905
1790,1709,2,0,1400,390,450000,2001
2440,11793,1,4,1420,1020,925000,1950
920,5029,1,0,920,0,600000,1938
1680,4087,1.5,0,1680,0,709000,1911
3290,6480,2,0,2190,1100,1.39E+06,1938
2120,6840,1,0,1220,900,248000,1984
910,6630,1,0,910,0,245000,1912
1000,4776,1,0,1000,0,332000,1942
2340,4273,2,0,2340,0,459950,2002
1180,1800,2,2,1180,0,425000,1994
2080,50965,1,0,1590,490,460000,1979
3760,12978,1,0,2360,1400,838300,1967
1480,7200,2,0,1480,0,256000,1995
3060,13554,2,0,3060,0,864000,1984
3070,4440,2,0,2030,1040,900000,1922
1170,7560,1,0,1170,0,145600,1958
2900,6730,1,0,1830,1070,865000,1977
2210,8000,2,0,2210,0,250250,1969
1440,7641,1,0,1440,0,162000,1943
1980,7350,1,0,1430,550,450000,1973
2060,21344,1,0,1460,600,675500,1978
2420,5304,1.5,0,1640,780,697000,1947
3440,4080,2,0,2560,880,1.32E+06,2005
1600,16510,1,0,1600,0,490000,1984
2210,5742,1,0,1460,750,590000,1951
2250,16000,1,0,1450,800,280000,1957
1680,6500,1,0,1140,540,515000,1941
1140,5395,1,0,1010,130,576000,1909
1430,10574,2,0,1430,0,375000,1981
1440,7107,1,0,1000,440,478000,1980
1670,5200,1,0,1030,640,282000,1977
3080,10550,2,3,1940,1140,1.40E+06,1976
4300,50405,2,0,3220,1080,593500,1972
3010,174240,2,0,3010,0,724950,2004
1560,7500,1,0,1560,0,306000,1966
1920,7665,1,0,1500,420,341000,1975
1400,4400,1,0,1400,0,399950,1930
2280,3600,2,0,2280,0,534000,1992
3880,5700,2,0,3880,0,635000,2003
1350,3880,1,0,950,400,350000,1927
1480,2700,1.5,0,1480,0,856000,1928
1670,1189,3,0,1427,243,582000,2000
3400,6742,2,0,3400,0,799000,2004
2070,3986,2,0,2070,0,423700,1999
4870,39190,2,0,4870,0,1.84E+06,1995
1760,43575,1,0,1160,600,322000,1988
4030,57499,2,0,4030,0,929000,2002
1130,5413,1,0,880,250,443000,1939
1510,7700,1,0,1510,0,441500,1968
3110,108464,2,2,3110,0,875000,1979
5020,12431,2,4,3420,1600,3.60E+06,1941
740,5100,1,0,740,0,450000,1947
1630,10500,1,0,1100,530,425000,1974
2780,9900,2,0,2780,0,660000,1978
1990,5560,1,0,1100,890,763101,1939
2250,14149,2,0,2250,0,499000,1992
1720,37363,1,0,1350,370,521000,1974
900,423838,1,2,900,0,302000,1925
2360,6260,2,0,2360,0,293000,1998
1530,4580,2,0,1530,0,335000,2011
1450,3090,2,0,1450,0,499000,1919
2040,5000,1.5,0,1780,260,600000,1924
2620,11041,1.5,0,2620,0,720000,1962
1180,2553,2,0,1180,0,195000,2005
1110,8423,1,0,1110,0,249000,1952
1840,9781,2,0,1840,0,334000,1989
2720,7810,1,0,1510,1210,599950,1952
1090,1950,1,0,1090,0,149900,1982
1730,6500,1,0,1250,480,700000,1945
1170,6240,1,0,1170,0,525000,1960
4740,126759,2,0,4740,0,1.05E+06,1991
1960,8000,1,0,1290,670,402000,1977
1430,3480,1,0,980,450,450000,1947
2510,43995,2,0,2510,0,520000,1981
1420,6980,1,0,820,600,205000,1980
2680,175982,1,0,2680,0,635000,2004
1220,9600,1,0,1220,0,210500,1958
1070,6100,1,0,1070,0,406650,1940
1580,19998,1,0,1580,0,350000,1968
1820,6000,1,0,930,890,425000,1942
3590,6402,2,0,3590,0,798000,1999
1960,9583,2,0,1960,0,180000,1908
3160,13238,2,0,3160,0,1.25E+06,1972
2030,4033,2,0,1630,400,435000,1925
1240,15867,1,0,1240,0,355000,1962
5370,14091,2,0,3850,1520,3.00E+06,1918
2670,14455,2,0,2670,0,685000,1958
1640,12060,1,0,1640,0,311000,1960
2130,9600,1,0,2130,0,305000,1966
2550,4954,1.5,0,1850,700,675000,1924
3630,15405,1,2,1850,1780,769000,1968
1690,9708,1.5,0,1690,0,430000,1954
2390,8660,1.5,0,2390,0,516250,1925
2350,10739,1,2,1340,1010,760000,1940
1420,1217,2,0,1180,240,579950,2003
1570,7187,1,0,1170,400,476000,1980
1600,19200,1,0,1600,0,510000,1967
720,5040,1,0,720,0,205000,1955
1470,7350,1,0,1470,0,240000,1969
2790,16952,2,2,1970,820,738000,1991
1720,8102,1,0,860,860,420000,1940
1300,9600,1,0,1300,0,455000,1969
2520,5500,1.5,0,1820,700,765000,1912
1780,7914,1.5,0,1780,0,372000,1962
1200,8360,1,0,1200,0,160000,1948
2990,9643,2,0,2990,0,772000,2003
1910,5640,2,0,1910,0,1.13E+06,1906
1370,3000,1.5,0,1370,0,479000,1924
1910,4941,2,0,1910,0,570000,1999
1170,8147,1.5,0,1170,0,350000,1959
1250,864,3,0,1250,0,353000,2004
3340,24755,2,0,3340,0,699000,2002
1380,8536,2,0,1380,0,265000,1955
780,10235,1.5,0,780,0,167000,1989
2080,8000,1,0,1390,690,500000,1964
1410,7200,2,0,1410,0,700000,1901
520,5600,1,0,520,0,295000,1918
3500,4080,2,2,2590,910,1.01E+06,2004
840,5265,1,0,840,0,209000,1969
2240,9200,1,0,1440,800,276000,1968
2100,5857,2,0,2100,0,380000,2002
1750,12500,1,0,1150,600,315000,1954
3130,60467,2,0,3130,0,685530,1996
1470,20000,1,0,1470,0,254600,1968
1440,5600,1,0,720,720,230000,1942
1430,1249,3,0,1430,0,335000,2003
2170,9600,1,0,1460,710,550000,1980
1150,8050,1.5,0,1150,0,123300,1956
2170,9658,1.5,0,2170,0,275436,1966
2630,3435,1.5,3,1640,990,325000,1984
2490,40608,2,0,2490,0,635000,1997
1710,5000,1,0,1110,600,513000,1944
2130,35752,1,0,1490,640,580000,1980
940,9272,1,0,940,0,225000,1954
1400,9460,1,0,1060,340,265000,1961
1630,3000,1,0,930,700,313000,1978
1370,8400,1,0,1370,0,296000,1948
2380,15800,1,0,1680,700,655500,1957
2140,12058,1,0,2140,0,250750,1951
1970,8545,2,0,1970,0,438000,2004
2550,54014,2,0,1980,570,590000,1967
1080,5250,1,0,1080,0,329500,1947
3070,9645,2,0,2110,960,1.20E+06,1987
1470,6000,1,0,900,570,415000,1944
3620,42580,2,0,3620,0,900000,1984
1050,57499,1,0,1050,0,378000,1975
1050,403365,1,3,1050,0,474000,1905
1320,3625,2,0,1320,0,464000,1900
1210,7649,1,0,1210,0,310000,1956
1860,7190,2,1,1860,0,580000,1952
2830,505166,1,3,1830,1000,999000,1962
810,6480,1,0,810,0,510000,1942
1630,7475,1,1,1160,470,650000,1940
880,19600,1,0,880,0,196000,1978
1660,11664,1,0,1010,650,220000,1952
3440,10628,2,2,3440,0,855000,1985
2110,10454,1,0,1440,670,483000,1978
1060,12000,1,0,1060,0,400000,1952
1900,7984,2,0,1900,0,435000,1993
820,1060,1,0,760,60,219500,2007
4860,23885,2,0,4860,0,2.95E+06,1996
2050,3218,3,0,2050,0,427000,2008
1090,4013,1.5,0,1090,0,430000,1900
1090,4013,1.5,0,1090,0,685000,1900
1920,6250,1,0,1060,860,495000,1937
1870,7942,2,0,1870,0,299950,1990
2690,46609,1.5,0,2690,0,390000,1940
2160,5863,1.5,0,1260,900,385000,1928
3000,10392,2,0,3000,0,740000,1995
2290,2350,2,1,1610,680,991700,1924
2250,9600,2.5,0,1830,420,765000,1909
2130,8734,2,2,2130,0,802000,1961
2500,20000,1,0,1700,800,950000,1969
2300,41167,2,0,2300,0,392000,1988
3360,218235,1,0,3360,0,590000,1989
1920,9000,2,0,1920,0,425000,1989
2440,15143,1.5,4,1740,700,765000,1944
1440,3488,2,0,1440,0,313500,1983
1780,6840,2,0,1780,0,320000,1947
1490,4485,1,0,1350,140,604000,1960
1400,1657,2,0,1060,340,570000,2004
2150,12028,2,0,2150,0,639000,1982
1910,10200,1,0,1910,0,335000,1963
2660,3520,2,0,2080,580,896000,1917
1650,12349,1,0,1650,0,259500,1957
1980,6000,1,0,1380,600,637000,1958
2690,8874,1,0,1370,1320,307450,1980
1380,3561,1,0,860,520,535000,1925
2500,4046,1.5,0,1520,980,669500,1940
1590,7148,1,0,1590,0,259000,1952
1100,3300,1,0,1100,0,441000,1919
1470,1612,2,0,980,490,228800,2003
1680,4950,1,0,1680,0,530000,2006
1450,2272,1,0,750,700,524000,1924
2020,4840,1.5,0,1200,820,430000,1925
2470,4760,1.5,0,1890,580,1.33E+06,1906
1230,12201,1,0,1230,0,210000,1969
1850,5040,1,0,1230,620,449000,1930
2540,7089,2,0,2540,0,945000,2004
970,9130,1,0,970,0,200450,1957
1070,6601,1,0,1070,0,219950,1985
2620,18362,1,0,1870,750,659500,1956
2110,8190,1.5,0,2110,0,746000,1966
2110,7129,1,0,1280,830,540000,1982
1910,5508,1,0,1020,890,485000,1968
670,7844,1,0,670,0,202000,1942
6930,45100,1,0,4310,2620,2.53E+06,1950
2010,11200,1,0,1360,650,502000,1979
1770,10534,1,0,1210,560,279000,2003
1340,4120,1,0,1040,300,409500,1921
1660,15050,1,0,1260,400,453000,1983
1820,5500,1.5,0,1820,0,367000,1947
2510,5400,2,0,2510,0,550000,1992
1560,8314,1,0,1560,0,273500,1962
2280,7400,1,0,1340,940,505000,1978
2650,40705,2,0,2650,0,770000,1994
2470,7447,2,0,2470,0,565000,1984
1270,10092,1,0,1270,0,316000,1971
1520,7298,1.5,0,1520,0,160000,1960
1310,9529,1,0,1310,0,170000,1956
1310,9529,1,0,1310,0,235000,1956
3930,39098,2,0,3930,0,1.80E+06,1999
990,7050,1,0,990,0,310000,1967
2080,13629,1,0,1040,1040,285000,1955
960,4920,1,0,960,0,280000,1942
4070,13860,2,3,4070,0,2.30E+06,2004
2750,16139,2,0,2750,0,763776,1989
3230,13572,1,2,1880,1350,530000,1965
890,211576,1.5,0,890,0,362000,1996
990,4920,1,0,990,0,430000,1931
1290,3880,1.5,0,1290,0,456500,1919
2170,5257,2,0,2170,0,445000,1989
1330,10500,1,0,960,370,386900,1963
1340,13750,1,0,1340,0,479000,1955
2200,4544,2,0,2200,0,525000,2000
2520,10890,1,0,1260,1260,272000,1979
1180,13500,1.5,0,1180,0,517000,1950
2660,7800,1,0,1330,1330,615000,1951
1250,7030,1,0,1250,0,439000,1965
2270,7866,1,0,2270,0,716000,1988
1080,6250,1,2,1080,0,308000,1942
1620,4500,2,0,1620,0,800000,1926
940,5000,1,0,880,60,575000,1941
1620,9310,1,0,1620,0,219950,1967
2350,8001,2,0,2350,0,770000,1987
2090,7505,1,0,2090,0,424950,1967
1760,45133,2,0,1760,0,387000,1984
2050,10920,1,3,1450,600,790000,1974
600,4000,1,0,600,0,156000,1933
2540,7000,1,0,1320,1220,580000,1942
2090,10869,2,0,2090,0,490000,1970
2700,3650,2,2,2070,630,950000,1926
1410,1281,2,0,1090,320,400000,2008
1170,1638,2,0,1170,0,325000,2008
2540,6688,2,0,2540,0,365000,2002
2190,6000,1.5,0,2190,0,255000,1920
3890,13261,2,1,2870,1020,985000,1984
2030,10722,1,0,1100,930,595000,1967
1350,7085,1,0,1350,0,427500,1944
1940,4000,1.5,0,1310,630,728000,1915
1260,4000,1,0,1000,260,549950,1940
2800,10501,1,0,1400,1400,650000,1954
3080,13394,1,2,2230,850,1.13E+06,1968
840,6500,1,0,840,0,203000,1969
860,3300,1,0,860,0,311000,1903
2400,7684,1,0,1200,1200,387500,1932
1640,7200,1,0,1640,0,370000,1963
1060,6100,1,0,1060,0,228000,1951
2080,4800,1,0,1080,1000,740000,1923
2090,6630,1,0,1070,1020,200000,1974
1240,3500,1,0,1240,0,660000,1927
2030,8426,2,0,2030,0,275000,1944
1120,5250,1,0,950,170,708000,1938
1270,9675,2,0,1270,0,280000,1993
2260,5702,2,0,2260,0,325000,2002
1780,47480,2,0,1780,0,495000,1995
1780,3810,1.5,0,980,800,691000,1922
4080,18362,2,2,4080,0,2.29E+06,1983
2120,22482,1,0,1360,760,329500,1979
2060,7458,2,0,2060,0,348000,1989
1670,6212,1,0,1670,0,425000,1947
1080,21043,1,0,1080,0,210000,1942
1210,4895,1,0,710,500,285000,1951
990,8840,1,0,990,0,222000,1966
1720,9600,1,0,1120,600,200000,1961
1530,8749,1,0,1530,0,247500,1995
6550,217374,1,0,5400,1150,1.50E+06,2006
1100,9452,1,0,1100,0,190000,1942
3020,4950,1.5,0,2020,1000,975000,1921
3180,4649,2,0,2070,1110,1.13E+06,1925
1830,12540,1,0,1130,700,283200,1958
2540,8073,1,0,1880,660,650000,1937
1770,6610,1,0,960,810,449500,1954
1470,6682,1,0,1470,0,400000,1987
570,4080,1,0,570,0,89950,1942
960,8291,1,0,960,0,158800,1950
2940,7108,2,1,2220,720,870000,2011
1000,18568,1,0,1000,0,196000,1989
2450,8603,1,0,1340,1110,850000,1940
3310,5101,2,0,3310,0,775000,2005
1670,4308,2,0,1670,0,483500,2001
1620,21929,2,0,1620,0,387000,1990
2990,30869,2,0,2990,0,900000,1951
1240,5000,1,2,1240,0,336000,1964
670,6000,1,0,670,0,415000,1949
1470,979,3,2,1470,0,380000,2006
1320,4400,1,0,1320,0,350000,1909
6110,10369,2,0,6110,0,1.32E+06,2005
2440,5800,1,3,1320,1120,765000,1945
2900,6736,2,0,2900,0,527000,2013
2310,5000,1.5,0,1480,830,524000,1908
1110,5413,1,0,890,220,448000,1937
4100,241322,2,0,2500,1600,775000,1981
930,9900,1.5,0,930,0,176500,1910
2420,11120,1,2,1620,800,750000,1952
2870,6000,1,0,1730,1140,1.27E+06,1951
1480,6750,1,0,1480,0,250000,1958
1960,6390,1.5,2,1960,0,759000,1900
1470,4640,1.5,0,1470,0,640000,1926
2460,4182,2,0,2100,360,990000,1910
1960,7945,1,0,980,980,395000,1946
1160,1103,2,0,890,270,275000,2006
1910,4755,2,0,1910,0,390000,1997
2720,4680,1.5,0,1710,1010,752500,1913
1020,5000,1.5,0,1020,0,450000,1906
900,5100,1,0,900,0,473000,1909
1120,10450,1,0,1120,0,178500,1973
2340,59058,1,0,2340,0,485000,1985
1410,8415,1,0,780,630,215000,1982
1920,4862,1,0,1060,860,589000,1919
1370,9993,1,0,1370,0,325000,1918
1590,1937,2.5,0,1590,0,580000,2004
1850,7500,1,0,1850,0,181100,1954
1430,4200,1,0,830,600,345000,1908
1940,8729,1,0,1460,480,781000,1960
1270,3630,1.5,0,1270,0,402500,1903
1380,7200,1,0,1080,300,426000,1948
1720,4515,2,0,1720,0,389000,2005
4050,36171,2,0,2620,1430,670000,1970
3660,5800,2.5,0,3360,300,1.51E+06,1909
1870,3230,2,0,1870,0,288400,1997
2230,4635,1.5,0,1510,720,700000,1908
2020,6000,1,0,1220,800,830000,1968
3690,32044,2,4,3690,0,1.90E+06,1989
1450,6380,1,0,1450,0,350500,1967
1630,9000,1,0,1630,0,431000,1956
1840,8250,1,1,1340,500,485000,1958
1620,7500,1,2,1620,0,780000,1949
1840,9000,1,2,1340,500,720000,1957
1360,73616,1,0,1360,0,415000,1971
2080,5500,1,0,1040,1040,480000,1941
2550,10000,1,0,1560,990,452250,1979
2550,8170,2,0,2550,0,316000,1985
1160,17635,1,4,1160,0,700000,1945
1760,5500,1,1,780,980,285000,1925
1720,4050,1,0,860,860,575000,1906
2300,12430,1,2,1580,720,590000,1960
2500,20868,1,2,1600,900,587500,1956
1750,10270,1.5,0,1750,0,364000,1968
1890,10190,2,0,1890,0,490000,1986
1800,36704,1,0,1360,440,410000,1978
2160,4297,2,0,2160,0,520000,1999
1380,6591,1,0,1380,0,389000,1947
1180,6000,1,0,1180,0,450000,1910
2550,4240,2,0,2550,0,325000,2006
1070,5000,1,0,1070,0,660000,1924
2870,8170,2,0,2250,620,850000,1995
1940,9874,2,0,1940,0,285000,1990
870,3121,1,0,870,0,395000,1923
1550,2401,2,0,1550,0,440000,1996
1400,5648,1.5,0,1400,0,249000,1917
1210,4400,1.5,0,1210,0,635000,1930
3430,48993,2,0,3430,0,515000,2001
3020,6073,2,0,3020,0,1.40E+06,1954
950,8100,1,0,950,0,200000,1955
3370,8103,1,3,1970,1400,1.14E+06,1970
1460,4600,1,2,780,680,445000,1946
1740,4200,1.5,0,1640,100,555000,1920
1720,6413,1,0,860,860,537000,1950
1480,7500,1,0,1480,0,315000,1968
3320,7266,2,0,3320,0,805000,2000
3490,9030,1.5,0,3490,0,414000,1969
1160,1648,2,0,1160,0,375000,2002
3010,12523,1,0,1780,1230,401000,1952
1030,4583,1,0,1030,0,210000,1967
980,5110,1,0,780,200,365000,1939
1990,18200,1,0,1990,0,178000,1960
1790,4000,1,0,1040,750,710000,1923
810,7980,1,0,810,0,255000,1928
2940,38009,1,0,1700,1240,528000,1977
4883,26040,2,3,3859,1024,537000,2006
1360,6110,1,0,1010,350,442000,1955
1370,19550,1,0,1370,0,375000,1978
2120,3220,2,0,2120,0,637250,2005
1240,7200,1,0,1240,0,427500,1942
2770,89298,2,0,2770,0,700000,2004
1660,5750,1,0,1080,580,680000,1909
1170,8251,1,0,1170,0,393820,1941
2470,7200,1,0,1350,1120,525000,1940
1310,3816,1,0,1110,200,505000,1929
1670,11337,1,1,1670,0,555565,1959
1660,10819,1,0,1240,420,650000,1942
3500,7254,2,0,2760,740,632500,2005
1440,3800,2,0,1440,0,269000,2005
2360,7716,1,0,1390,970,405000,1978
3460,15745,2,0,3460,0,845000,1986
1750,8820,1,0,1750,0,234000,1961
1470,4236,1.5,0,1470,0,638000,1946
1710,10950,1,0,1060,650,290000,1967
520,12981,1,0,520,0,262000,1920
2350,5835,2,0,2350,0,270000,2003
2380,4876,2,0,2240,140,875000,1948
1920,7840,2,0,1920,0,299000,1982
1580,6000,1,0,1580,0,551000,1947
3070,5280,2,1,2360,710,350000,1950
2660,13367,2,2,2660,0,1.90E+06,1992
1700,5000,1,0,850,850,511718,1915
5010,49222,2,0,3710,1300,965000,1978
2680,4673,2,0,2680,0,475000,1999
2720,4000,1.5,2,1840,880,1.06E+06,1928
940,15450,1,0,940,0,252000,1926
3596,13700,1,0,1798,1798,580000,1964
1240,1172,2,0,1000,240,374950,2008
4660,9900,2,2,2600,2060,739000,1979
1710,7200,1,0,910,800,271000,1975
930,7550,1,0,930,0,230000,1986
1430,9150,1,0,1070,360,210000,1984
1650,5700,2,0,1650,0,350000,1988
1560,12000,1,0,1110,450,491500,1968
1870,9825,1,0,1250,620,325000,1994
1320,7625,1,0,1320,0,190000,1987
1400,4690,1.5,0,1400,0,658600,1945
1940,8951,1,0,1300,640,299950,1958
2000,3000,1.5,0,1200,800,464000,1931
1640,18144,1.5,0,1640,0,308000,1942
1020,7650,1,0,1020,0,625000,1919
1630,9450,1,0,1080,550,240000,1977
2940,35996,2,0,2940,0,530000,1995
2120,8944,2,4,2120,0,1.00E+06,1939
790,2400,1,0,790,0,439000,1918
2020,6200,1,0,1010,1010,575000,1948
1530,7238,1,0,1530,0,418000,1959
3250,10949,2,0,2940,310,1.21E+06,1930
2930,3200,1.5,0,2130,800,1.10E+06,1925
3150,8550,2,0,3150,0,1.90E+06,2007
2180,40278,2,0,2180,0,580000,1985
1040,7372,1,0,840,200,380000,1939
880,5375,1,0,880,0,256000,1924
1400,7066,1,0,1400,0,349950,1957
2600,7200,2,0,2600,0,691500,1962
1590,2500,1.5,0,1190,400,556000,1908
1610,7084,1,0,1280,330,218000,1968
1390,4500,1.5,0,1390,0,425000,1908
3710,38509,2,0,3710,0,935000,1998
2360,11300,1,0,2360,0,732000,1974
1440,10330,1,0,1440,0,805500,1952
1400,5750,1,2,1100,300,507250,1915
4600,67369,2,0,4600,0,800000,1990
2100,8276,2,1,2100,0,600000,1979
2010,12044,1,0,2010,0,627800,1982
2550,6000,2,0,1860,690,660000,1902
1240,3649,2,0,1240,0,153503,1986
2090,9163,1,0,1460,630,456500,1975
2770,8100,2,0,2770,0,1.31E+06,2002
3560,11448,2,0,3560,0,843500,1997
1240,4080,1,0,1240,0,625000,1925
1640,4080,1,0,840,800,527000,1921
3940,13738,1.5,3,3940,0,1.97E+06,1951
3150,50094,2,0,3150,0,1.00E+06,1969
2550,5300,2,0,1720,830,855000,1908
3940,27591,2,3,3440,500,725000,2000
580,7200,1,0,580,0,315000,2000
1330,16000,1,0,1330,0,180000,1978
930,5000,1,3,930,0,700000,1926
1060,8625,2,0,1060,0,476500,1962
1180,9048,1,0,1180,0,193000,1960
1850,6663,2,0,1850,0,295000,1990
820,4880,1,0,820,0,363000,1925
3600,21794,2,0,3600,0,875000,1990
1850,8250,1,0,1150,700,257200,1952
2240,11250,1,0,2240,0,555000,1968
1860,15559,2,0,1860,0,380000,1963
2390,7330,2,0,2390,0,282000,1989
2040,6034,2,0,2040,0,545000,1990
1900,5000,1.5,0,1640,260,550000,1926
1900,5000,1.5,0,1640,260,921500,1926
2200,2880,2,0,1440,760,885000,1904
2280,6660,1.5,2,1960,320,820000,1940
1090,7315,1,0,1090,0,289000,1981
670,5750,1,0,670,0,334000,1942
1050,5233,1,0,1050,0,206000,1906
2090,10733,1,0,1440,650,491950,1958
2030,7770,2,0,2030,0,430000,2003
1250,7995,1,0,1250,0,208000,1980
2600,6390,1,0,1390,1210,245000,1978
640,2500,1,0,640,0,426000,1918
2120,3742,2,0,2120,0,400000,2006
1330,5100,1,0,900,430,553000,1942
750,4680,1,0,750,0,296000,1948
2230,32660,1,0,2230,0,428000,1977
1890,6156,1,0,980,910,325000,1980
820,6366,1,0,820,0,294000,1952
1880,8424,1,0,1380,500,410000,1977
2360,57514,2,0,2360,0,590000,1939
1850,4050,2,0,1850,0,445000,1985
2310,5362,2,4,2010,300,921000,1928
2520,37616,1,0,2520,0,496000,1955
800,8550,1,0,800,0,95000,1947
1580,6396,1,0,790,790,359000,1945
2430,88426,1,0,1570,860,452500,1985
2350,6200,1.5,0,1410,940,555000,1946
3800,42316,1.5,0,3800,0,549900,1984
3670,10583,1,0,2060,1610,569000,1952
1780,7350,1,0,900,880,318500,1974
1295,1093,2,0,1105,190,487028,2007
1350,7560,1,0,950,400,240000,1959
1440,9806,1,0,1440,0,253000,1965
1320,38125,1,0,1120,200,380000,1947
700,16828,1,0,700,0,250000,1958
2510,19141,2,0,2510,0,368500,1977
3180,27586,1,0,1400,1780,340000,1969
910,4000,1,0,910,0,400000,1918
1570,4625,1.5,0,1570,0,835000,1927
2450,7062,2,0,2450,0,299000,1993
4910,6600,2.5,0,3580,1330,1.68E+06,1910
1570,5706,1,0,1570,0,265000,1998
2680,7513,2,0,2680,0,437500,1998
2090,4725,2,0,1610,480,865000,1947
2150,7200,1,0,2150,0,626000,1988
1140,1118,2,0,1040,100,247300,2009
4230,20377,2,0,4230,0,2.08E+06,1997
1790,6000,1.5,0,1790,0,425000,1937
3100,10200,1,4,1660,1440,905000,1970
2220,2550,3,2,2220,0,641250,1990
2370,9679,2,0,2370,0,675000,1984
4070,115434,2,0,4070,0,845000,2002
1790,8400,1,0,1260,530,401500,1954
1610,3755,2,0,1610,0,395000,1987
2830,18050,1,0,1630,1200,1.10E+06,1958
1010,5490,1,0,1010,0,145000,1954
1560,3825,1.5,0,1390,170,900000,1930
1330,8636,1,0,1330,0,374500,1968
2330,10451,2,0,2330,0,850000,1965
960,5750,1,0,960,0,490000,1951
1710,6773,2,0,1710,0,304000,1993
2230,7200,1,0,1300,930,400000,1963
1700,10000,2,0,1700,0,454000,1992
1040,4750,1,0,850,190,160000,1950
1070,8030,1,0,1070,0,542000,1966
3600,17300,1,0,2410,1190,403500,1968
2750,8471,2,0,2750,0,418000,2003
1920,6000,2,1,1920,0,406000,1951
1770,10000,1,0,1340,430,242500,1978
2460,5440,2,0,2460,0,425000,2003
1550,4815,1.5,0,1550,0,613000,1909
1460,11481,1,0,1170,290,189000,1995
2440,9450,1.5,0,2440,0,700000,1947
1640,6516,1.5,0,1440,200,750000,1935
1290,4650,1,0,1290,0,494000,1906
3150,7778,2,0,3150,0,700000,2000
2305,5580,1,0,2305,0,705000,2007
1060,16470,1,0,1060,0,356000,1977
2060,12558,1,0,1350,710,625000,1984
900,7500,1,0,900,0,144975,1940
3890,5906,2,3,3060,830,970000,2004
1910,12596,1,0,1340,570,415000,1977
2340,7048,1,0,1340,1000,485000,1979
2900,11769,2,0,2900,0,799950,1997
3290,35001,2,0,3290,0,783350,1991
630,1362,1,0,630,0,430000,1943
5410,13431,2,0,5050,360,2.54E+06,1941
4270,43386,1,0,2680,1590,975000,1991
1700,8050,1,0,1130,570,950000,1950
1430,8157,1.5,0,1150,280,350000,1944
2850,7510,2,0,2850,0,637000,2008
2160,105415,1,0,2160,0,895000,1991
1760,7200,1,0,880,880,579000,1946
2700,27072,1,0,1380,1320,314900,1958
860,6000,1,0,860,0,122000,1945
880,3000,1,0,880,0,405000,1927
1360,1349,2,0,1050,310,553650,1997
1770,1853,3,0,1770,0,369900,2007
2030,24829,1,0,1220,810,225000,1979
1180,9350,1,0,1180,0,160000,1918
2430,199940,1,0,1310,1120,449500,1961
1300,8266,1,0,1300,0,650000,1953
2360,43088,2,0,2360,0,542126,1977
1200,15606,1,0,1200,0,309950,1985
1000,16524,1,0,1000,0,115000,1913
1556,20000,1,0,1556,0,221700,1957
1890,3880,1.5,0,1460,430,726000,1915
1810,5733,1,0,1010,800,515000,1926
2730,10753,2,0,2730,0,756000,1991
3070,5850,2,0,2400,670,1.57E+06,1927
2080,12007,1,0,1220,860,442000,1979
1620,7992,2,0,1620,0,260000,1975
1150,2723,1,0,770,380,390000,1923
1250,3825,1,0,850,400,459500,1929
1430,8000,1,0,1430,0,330000,1948
790,7128,1,0,790,0,189000,1944
1200,9322,1.5,0,1200,0,280000,1954
2110,9519,1,0,2110,0,400000,1948
3160,11193,1,0,2410,750,368000,1942
2700,7875,1.5,0,2700,0,390000,1968
820,7475,1,0,820,0,245000,1945
1800,8432,1,0,1200,600,375000,1960
1750,12491,1,0,1390,360,465000,1961
1540,67953,1,0,1540,0,445000,1997
1130,7800,1,0,1130,0,250000,1952
1500,9416,1,0,1500,0,475500,1952
1600,5795,1.5,0,1600,0,672324,1940
1200,5029,1,0,880,320,420000,1937
1690,5100,1.5,0,1690,0,515000,1907
2270,7665,2,0,2270,0,732350,1986
1910,5000,2,0,1910,0,297500,2005
1640,2720,1.5,0,1640,0,475000,1929
2120,6497,2,0,2120,0,414000,2003
1400,8840,1,0,1400,0,357250,1952
760,6000,1,0,760,0,289950,1950
1070,3713,1,0,1070,0,550000,1917
1460,9998,1,0,960,500,446000,1958
1280,16738,1.5,0,1280,0,279000,1932
1650,4859,2,0,1650,0,370000,1988
1260,4125,1,0,1260,0,216000,1998
2200,20000,1,1,1400,800,1.10E+06,1952
3560,15450,1,1,2060,1500,1.28E+06,1977
1140,2500,1,1,630,510,355000,1988
2550,7312,2,0,2550,0,699000,1988
1553,1991,3,0,1553,0,412000,2014
1140,7200,1,0,1140,0,276000,1923
790,6426,1,0,790,0,100000,1944
2130,5080,1.5,0,2130,0,955500,1914
1390,21262,1,0,1390,0,199000,1958
4000,15253,2,0,4000,0,762000,2007
1520,7983,1,0,1520,0,425000,1967
1657,5031,2,0,1657,0,546000,1910
1680,8460,1,0,1180,500,419600,1976
2270,5102,1,0,1340,930,735000,1954
2470,609,3,0,1910,560,1.23E+06,2011
1240,2500,2,0,1240,0,445000,1985
1740,41275,1,0,1740,0,665000,1974
4090,290980,1,0,2920,1170,1.29E+06,2002
2520,12500,2,0,1720,800,508500,1979
1340,11198,1.5,0,1340,0,345950,1934
1640,9750,1,0,1640,0,207500,1968
3000,10920,1,0,1550,1450,1.08E+06,1969
1210,3720,2,0,1210,0,640000,1930
1810,13068,1,0,1360,450,329500,1941
2200,9676,1,0,1500,700,460000,1979
2200,14630,1.5,1,2200,0,1.23E+06,1948
2350,6480,2,3,1650,700,805000,1924
1090,10454,1,0,1090,0,200000,1963
2280,77972,1,0,1460,820,749700,1977
1430,1650,3,0,1430,0,288000,1999
1520,3360,1,0,830,690,535000,1927
1620,7150,1,2,1280,340,330000,1950
1510,3750,1.5,0,1510,0,479200,1928
3001,5710,2,0,3001,0,373000,2006
2020,6000,1,0,1010,1010,355000,1953
1380,4500,1,0,1380,0,275000,2008
1520,4288,1,0,1020,500,380000,1949
1090,4590,1,0,790,300,417000,1915
4220,15959,2,0,4220,0,1.17E+06,2004
2520,12000,1,0,2520,0,598500,1978
1760,5000,1,0,960,800,629000,1920
930,6600,1,0,930,0,226950,1957
2600,11542,1.5,0,2200,400,1.23E+06,1939
2180,11100,1,0,1700,480,415000,1979
1910,3075,2,0,1910,0,595000,2001
1100,5525,1,0,1100,0,209950,1968
1760,235224,1,0,1760,0,568000,1973
700,3180,1,0,480,220,119900,1951
1080,10200,1,0,1080,0,207000,1962
1070,22489,1,0,1070,0,195000,1967
1460,8710,1,0,1460,0,324950,1955
1050,7583,1,0,1050,0,210000,1947
3160,42733,2,0,3160,0,1.08E+06,1995
1400,6739,1,0,1000,400,325088,1954
3120,157875,2,0,3120,0,790000,1977
720,212137,1,0,720,0,150000,1982
2840,206910,2,0,2840,0,790000,1999
1220,2500,1,0,770,450,255000,1910
2820,2850,1.5,0,1860,960,697000,1928
840,5000,1,0,840,0,457500,1908
1610,5100,1.5,0,1610,0,690000,1940
1860,4356,2,0,1860,0,967000,1917
2260,17711,1,1,2260,0,980000,1968
2450,14803,2,0,2450,0,619420,1988
850,3276,1,0,850,0,389000,1910
1800,7200,1,0,1020,780,500000,1964
1230,7890,1,1,1090,140,569000,1950
2060,8540,1,0,1540,520,425000,1967
2750,6180,1,0,1500,1250,635000,1948
1120,9912,1,0,1120,0,256500,1980
3010,11393,2,0,3010,0,695000,2005
1580,5000,1.5,0,1390,190,535000,1945
2630,5379,2,0,2630,0,454200,2004
790,5800,1,0,790,0,418500,1943
3110,35235,2,0,3110,0,749950,1983
2130,5489,1,0,1370,760,338500,1999
4520,9240,1.5,2,3270,1250,1.25E+06,1992
1600,9830,2,0,1600,0,299950,1993
1950,12500,1,0,1330,620,325000,1963
2010,8171,2,0,2010,0,434000,1973
2550,8976,1,0,1300,1250,328950,1978
5340,10655,2.5,3,3740,1600,2.10E+06,1912
2000,46902,2,0,2000,0,570000,1978
2170,5001,2,0,2170,0,802000,2014
1550,6840,1.5,0,1550,0,525000,1918
2790,4550,2.5,0,2790,0,700000,1907
1980,273556,1,0,1040,940,350000,1956
1190,1236,3,0,1190,0,277500,2005
3650,20150,1,0,2360,1290,1.58E+06,1975
1510,4350,1.5,0,1510,0,195000,1913
1200,6074,1,0,1200,0,222000,1968
2830,8854,1,0,1500,1330,865000,1979
1650,6000,1,0,1000,650,445000,1959
1710,4600,1.5,0,1710,0,495800,1924
1740,4400,1.5,0,1740,0,548500,1924
1840,10723,1,0,1220,620,310000,1974
1820,8585,1,0,1820,0,205000,1962
3860,6901,2,0,3860,0,470000,2003
1810,349351,1.5,0,1810,0,430000,2002
1030,2271,3,0,1030,0,310000,1999
1410,7693,1.5,0,1410,0,355000,1953
2140,15950,1,2,1370,770,621500,1968
1930,8400,1,0,1030,900,175000,1971
1930,8400,1,0,1030,900,326000,1971
1930,5400,1.5,2,1930,0,690000,1920
2210,7214,2,0,2210,0,335000,2003
1360,11175,1,0,1360,0,197000,1961
1830,7969,1,0,930,900,312500,1950
2120,6710,1,0,1420,700,436000,1959
2700,4590,2,0,2700,0,1.02E+06,2002
3160,35225,2,1,2250,910,805000,1992
2770,13129,2,0,2770,0,652427,1979
2240,41339,1,0,2240,0,1.01E+06,1945
2570,6466,2,0,2570,0,355000,1999
880,12000,1,0,880,0,334550,1939
1820,9670,2,0,1820,0,557500,1984
1660,7184,1,0,1110,550,277500,1963
2200,10800,1,0,2200,0,300000,1960
1640,3844,1.5,0,1460,180,325000,1928
1650,3504,1,0,760,890,402500,1951
1420,5170,1,0,1420,0,461000,1963
1270,3840,1.5,0,1270,0,540000,1926
1070,4000,1,0,1070,0,385000,1971
1060,3040,1,0,860,200,480000,1924
2190,7149,1,1,1240,950,539950,1963
1940,217800,2,0,1940,0,529000,1990
1300,877,2,0,1060,240,417000,2008
1330,12500,1,0,1330,0,405000,1966
1940,9100,1,0,1630,310,299000,1966
2100,15480,1,0,2100,0,299000,1983
1290,5500,1,0,980,310,372220,1951
1560,1750,1,0,780,780,494400,1904
2630,6500,1,0,1330,1300,280000,1958
2100,6021,2,0,2100,0,277950,1992
2070,54557,2,0,2070,0,770000,1996
2960,28005,2,0,2960,0,760000,1989
1300,3608,1,0,1300,0,230000,2004
2520,7731,2,0,2520,0,525000,1994
1150,6000,1.5,0,1150,0,307000,1927
2030,9600,1.5,0,1430,600,253779,1947
1880,7400,1,0,1480,400,405000,1968
2320,11250,2,0,2320,0,360000,1942
1050,7500,1.5,3,1050,0,521000,1910
3030,13068,2,0,3030,0,680000,1978
530,33278,1,2,530,0,355000,1950
1090,9600,1,0,1090,0,200000,1968
2220,4060,1,0,1330,890,330000,1993
1430,5999,2,0,1430,0,221000,1987
3780,6000,2,4,2770,1010,1.60E+06,1910
1560,4920,1,0,780,780,310000,1947
2220,4200,1.5,0,1310,910,862000,1932
1140,8340,1,0,1140,0,200000,1960
2540,11100,1,0,2540,0,630000,1957
1440,6232,2,0,1440,0,432250,1985
1570,9500,1,0,1070,500,478000,1977
1860,9576,1,0,1400,460,249000,1962
2440,4750,1,0,1450,990,495000,2006
2100,8800,1,2,1240,860,630000,1960
2150,27540,2,0,2150,0,550000,1997
2440,18674,2,0,2440,0,350000,1994
1930,7480,2,0,1930,0,270000,1966
1830,9610,1,0,1830,0,488250,1963
1850,6519,2,0,1130,720,248000,1986
3210,5000,3,0,3210,0,889000,2014
1090,5250,1,0,980,110,375000,1927
1870,3300,2,2,1870,0,933000,1906
1920,8412,1,2,1460,460,625000,1977
700,4350,1,0,700,0,328000,1943
3380,9900,1,2,1690,1690,470000,1969
2430,6168,2,0,2430,0,502500,2007
1950,17400,1,0,1210,740,484000,1976
900,7500,1,0,900,0,252500,1961
2060,8893,2,0,2060,0,610000,1987
2180,10447,1,0,1280,900,419000,1969
2140,9377,2,0,2140,0,322500,1986
1730,2760,1.5,0,1250,480,563000,1918
3140,12591,2,0,3140,0,464000,1993
3010,4887,2,3,1940,1070,870000,1951
800,1196,2,0,800,0,280000,2003
3300,11570,2,0,3300,0,850000,1994
1530,4370,1,0,1130,400,458950,1946
760,5280,1,0,760,0,122000,1946
2450,4591,2,0,2450,0,525000,1994
1000,31838,1,0,1000,0,286300,1962
840,7425,1,0,840,0,218450,1952
1380,4290,1,0,1080,300,525000,1955
1380,4290,1,0,1080,300,650000,1955
2020,48693,1.5,0,2020,0,356000,1949
1260,5000,1,0,1040,220,436500,1951
1440,7112,1,0,1180,260,410000,1979
1540,8311,1,0,1540,0,512500,1950
1060,7200,1,1,880,180,510000,1925
1900,10297,1,0,1900,0,566000,1966
2870,26500,1.5,1,2870,0,525000,1948
1050,5500,1,0,930,120,435000,1920
1840,68479,1,2,1340,500,406500,1989
3000,9473,1,0,1500,1500,550000,1966
1200,10212,1.5,0,1200,0,251000,1949
1840,10125,1,0,1220,620,830000,1959
2790,7673,2,0,2790,0,803000,1989
970,9360,1,0,970,0,206000,1942
1070,7467,1.5,0,1070,0,200000,1944
900,5160,1,0,900,0,219000,1952
2680,6000,1,0,1380,1300,777000,1962
2000,22000,2,0,2000,0,593700,1979
1660,8797,1,0,1660,0,712500,1956
1770,6014,1.5,0,1240,530,600000,1946
1230,6802,1.5,0,1230,0,554663,1940
1740,10875,1,0,1020,720,267000,1962
1710,8910,1,0,1710,0,390000,1953
2020,7071,1,0,1010,1010,335000,1979
2410,9886,1,0,1990,420,938000,1975
2310,14745,1,0,1410,900,370000,1993
2400,4548,2,0,2400,0,335000,2003
3160,3990,1.5,0,1870,1290,695000,1923
1560,14333,1,0,1560,0,387500,1953
1770,6187,2,0,1770,0,245000,1992
1600,13200,1,0,1600,0,308550,1990
1330,13102,1,0,1330,0,225000,1968
2970,29163,2,0,2970,0,715000,1993
1020,10200,1,0,1020,0,335000,1954
2490,4904,2,0,2490,0,634000,2003
1700,7314,1,0,1000,700,337500,1956
850,6567,1,0,850,0,440000,1940
1250,13775,1,2,1250,0,350000,1990
610,4560,1,0,610,0,400000,1918
3700,13175,2,0,3700,0,1.29E+06,1989
950,10080,1,0,950,0,435000,1954
3860,5130,2,0,2930,930,681000,2004
1360,1275,2,0,1240,120,397000,2007
3890,34513,2,0,3890,0,775000,1996
1680,9090,1,0,1130,550,480000,1959
1520,7200,2,0,1520,0,158000,1985
2420,208652,1.5,0,2420,0,590000,2005
3890,9130,2,0,3890,0,772500,2004
2940,13425,1,0,1470,1470,464500,1955
1350,8737,1,0,1350,0,281000,1966
2190,45738,1,0,2190,0,620000,1990
2280,5750,1,1,1150,1130,475000,1985
1070,4500,1,0,910,160,245000,1932
2540,3750,1.5,0,1510,1030,660000,1925
2270,8480,1,0,1310,960,527500,1973
1220,7250,1,0,1220,0,135000,1914
1890,5000,1,0,1890,0,275000,2003
1990,4740,1,0,1080,910,430000,1926
1220,6000,1,0,1220,0,213500,1968
2640,5978,2,0,2640,0,535000,2012
1480,9603,1,0,1480,0,641000,1952
2320,9420,1,0,2320,0,436300,1952
2410,6000,1.5,0,2410,0,1.44E+06,1911
2090,13500,1,0,2090,0,830000,1949
920,3532,1,0,920,0,380000,1910
850,8573,1,0,600,250,132500,1945
1130,9907,1,0,1130,0,179950,1954
1260,7265,1,0,1260,0,188200,1954
2090,10800,1,0,2090,0,659000,1951
2020,7260,1.5,0,1180,840,317000,1926
1970,4564,1,0,1470,500,625000,1959
1820,9545,1,0,1230,590,350000,1976
1840,5000,1.5,0,1340,500,750000,1915
2100,10358,1,0,1280,820,457000,1959
1770,5000,2,0,1770,0,632500,1906
1110,7231,1,0,1110,0,223000,1991
2090,8400,1,0,1240,850,610000,1976
2080,8215,2,0,2080,0,385000,1948
1400,1343,2,0,1160,240,367500,2005
1060,8040,1,0,1060,0,385100,1949
720,5913,1,0,720,0,230000,1920
1100,750,2,0,780,320,286000,2008
1010,9576,1,0,1010,0,201700,1967
5230,89298,2.5,0,5230,0,1.35E+06,2002
2420,7672,1,0,1480,940,525000,1979
1200,7236,1,0,1200,0,361000,1975
1950,1963,3,0,1950,0,530000,2002
1870,7403,1,0,1870,0,455000,1950
1310,8400,1,0,1310,0,421000,1966
1520,6200,1.5,0,1520,0,640000,1945
1270,12733,1,0,1270,0,240000,1955
840,7414,1,0,840,0,360000,1928
900,23000,1,0,900,0,157340,1953
3010,6139,2,4,2560,450,1.24E+06,1950
1050,6874,1,0,1050,0,250000,1954
3360,84506,1,0,2040,1320,735000,1962
5370,10800,1.5,0,5370,0,884900,1967
2690,104544,2,0,2690,0,775000,1948
1710,7320,1,0,1710,0,463000,1948
1640,1269,3,0,1640,0,579000,2009
4000,6015,2,2,3080,920,570000,2004
4140,7924,2,0,4140,0,1.06E+06,2005
3140,24800,1,0,2080,1060,375000,1971
1320,2609,1,0,920,400,422000,1938
3080,4945,2,0,2010,1070,866500,2014
2500,10359,2,0,2500,0,705000,1986
2520,9684,2,0,2520,0,470000,1994
2350,6200,1,0,1320,1030,360000,1966
2570,13450,1,4,1510,1060,795000,1948
3100,7807,2,0,3100,0,800000,2003
4730,13586,1.5,0,4270,460,2.45E+06,1935
1030,4800,1,0,930,100,277284,1927
1020,4002,1,0,1020,0,460000,1953
2080,3729,2,0,2080,0,898888,1996
1410,47916,1,0,1410,0,211000,1981
1360,3300,2,0,1360,0,222000,2004
2620,21587,2,0,2620,0,672000,1992
2260,33080,1,0,1690,570,778000,1974
1490,9493,1,0,1490,0,312500,1976
2530,6500,1.5,0,1720,810,650000,1975
3140,10250,1,0,1570,1570,740000,1959
1820,17600,1,0,1820,0,320000,1972
1770,13168,2,0,1770,0,455000,1990
4430,9000,2,0,4430,0,2.45E+06,2013
1490,902,3,0,1220,270,500000,2001
1790,27427,1,0,1130,660,325000,1978
1710,1296,3,0,1510,200,416000,2004
2070,20280,2,0,2070,0,495000,1968
1140,5400,1,0,1140,0,549000,1908
3930,10150,1.5,0,3070,860,589000,1968
1100,32700,1,0,1100,0,194820,1967
2260,5500,1.5,0,1280,980,405000,1910
2260,5500,1.5,0,1280,980,625000,1910
1130,7014,1,0,1130,0,205000,1954
1950,8625,1,0,1360,590,345100,1959
960,7500,1,0,960,0,200000,1953
4210,18564,2,0,4210,0,1.91E+06,2001
3430,264844,1,2,2230,1200,524500,1988
3470,212639,2,0,2070,1400,598600,1993
2140,5937,1,0,1280,860,367777,1978
2520,5401,1,0,1360,1160,750000,1946
3550,7992,2,0,3550,0,575000,1968
700,20130,1,0,700,0,84000,1949
740,5000,1,0,740,0,255000,1926
3300,4545,1.5,4,2600,700,1.74E+06,1926
1640,5880,1,0,1240,400,415000,1977
2780,8225,2,1,2780,0,449900,1990
1830,94960,1.5,0,1830,0,220000,1929
3540,9349,2,0,3540,0,899000,2003
1440,7320,1,0,1440,0,430000,1954
2960,223462,2,0,2960,0,472500,2001
3180,9375,1,0,1590,1590,680000,1967
3310,8400,2,0,3310,0,1.65E+06,2000
2390,8025,2,0,2390,0,810000,1921
2460,138085,2,0,2460,0,605000,1977
1630,15600,1,0,1630,0,522000,1958
3490,8230,2,0,3490,0,759000,2005
2500,5257,2,0,2500,0,411000,1966
2080,9846,1,0,1240,840,286950,1984
1290,1286,3,0,1290,0,440000,2000
1700,8645,1,0,1700,0,149000,1955
1700,8645,1,0,1700,0,284700,1955
2540,11562,1,1,1290,1250,374950,1964
1180,8545,1,0,1180,0,816000,1952
1520,15398,1,0,1370,150,533250,1960
2390,9313,1,0,1390,1000,689800,1942
2740,6200,1.5,3,1820,920,775000,1947
2190,8528,1,0,1760,430,702000,1991
1350,8700,1.5,0,1350,0,160000,1942
1350,8700,1.5,0,1350,0,255500,1942
2980,42253,1,0,1860,1120,949000,1973
790,7450,1,0,790,0,169500,1944
2130,9000,2,0,2130,0,586000,1965
2700,37431,1,0,1600,1100,680000,1978
3200,18184,1,0,2000,1200,851500,1977
1159,4800,1,0,1159,0,582500,1948
3080,118918,2,0,3080,0,637000,2008
1000,9295,1,0,1000,0,225000,1955
2260,3727,2,0,1880,380,795000,2003
2270,9600,1,0,1290,980,304999,1976
760,5746,1,0,760,0,95000,1915
1420,5382,1,0,1040,380,240000,1942
2500,8680,1,0,1250,1250,772000,1958
1450,6258,1,0,1450,0,245000,1983
2500,5750,1,0,1430,1070,430000,1999
2210,6300,1.5,0,2210,0,799000,1916
3020,9187,2,0,3020,0,880000,2007
3290,7538,2,0,3290,0,750000,2004
5780,7173,2,0,4130,1650,2.89E+06,2008
1820,4910,2,0,1820,0,532000,1993
2500,10330,1,0,1380,1120,525000,1978
1210,9375,1,1,1210,0,239000,1952
1090,4000,1,0,970,120,460000,1951
1330,8400,1.5,0,1330,0,540000,1962
890,4590,1,0,890,0,475000,1923
1360,4998,1,0,1360,0,445000,1968
4220,9240,2,2,3420,800,1.58E+06,1991
3780,6800,2,0,3780,0,549950,2004
2610,14321,1.5,0,1690,920,294950,1940
1980,2975,3,2,1980,0,736000,1993
1290,8688,1,0,1290,0,214946,1980
3620,5500,2,2,3620,0,856000,2003
2680,7392,1,0,2680,0,775000,2004
1200,8631,1,0,1200,0,205000,1959
1992,10946,1.5,4,1288,704,429592,1903
1640,13566,1,0,1120,520,414250,1977
1920,4400,1,0,960,960,399950,1906
1840,7326,1,0,1370,470,319990,1979
1310,9471,1,0,1310,0,524000,1970
1050,6317,1.5,0,1050,0,349950,1913
2570,4480,1.5,0,1580,990,889000,1927
930,5160,1.5,0,930,0,300000,1919
730,3000,1,0,730,0,395000,1911
1270,1242,3,0,1270,0,348000,2008
1150,6000,1,1,710,440,830000,1921
820,10450,1,0,820,0,173000,1965
3000,42200,1,3,1500,1500,585000,1950
2220,5000,1,0,1110,1110,576750,1966
2500,7620,1,3,1250,1250,495000,1962
1540,1427,2,0,1360,180,216650,2007
2750,15450,1,0,1800,950,615000,1978
3130,12463,1,0,1620,1510,675000,1978
1430,9250,1,0,990,440,510000,1983
2680,327135,2,0,2680,0,630000,1995
3010,5701,2,0,3010,0,359950,2003
1530,7500,1.5,0,1530,0,265000,1986
1240,4842,1,0,1240,0,210000,1916
2260,93218,1,2,2260,0,367000,1998
2820,5000,1.5,2,1800,1020,1.08E+06,1926
3560,8297,1,2,1650,1910,756000,1948
1630,9145,1,0,1630,0,203000,1960
2880,23994,2,3,2880,0,535000,2002
2200,7440,2,0,1710,490,525000,1947
1620,7500,1,0,1220,400,347500,1981
1480,2185,2.5,0,1480,0,620000,2005
2250,10696,2,0,2250,0,645000,1996
3540,11098,2,0,3000,540,2.20E+06,1940
1790,42399,1,0,1790,0,280000,1990
1400,6380,1,0,700,700,432000,1924
2390,4452,2,1,1790,600,790000,1929
2400,10050,1,0,2400,0,635000,1957
2050,6384,1,0,1350,700,442000,1958
2640,5267,2,0,2640,0,490000,2001
2320,7700,1,0,1290,1030,250000,1962
2440,3600,2.5,0,2440,0,1.33E+06,1902
1260,7500,1,0,1260,0,120000,1954
6240,47480,1,3,4610,1630,2.95E+06,2003
1930,8458,2,0,1930,0,325000,1993
1200,7680,1,0,1200,0,210000,1968
970,7639,1,0,570,400,215000,1920
1810,10800,1,0,1210,600,387000,1968
1380,7015,1.5,0,1380,0,408000,1925
1470,6500,1,0,1470,0,410000,1953
1010,7920,1,0,1010,0,216000,1925
1010,7920,1,0,1010,0,390000,1925
1340,11744,1,0,1340,0,357000,1950
970,7275,1,0,970,0,215000,1970
1122,6554,1.5,0,1122,0,265000,1900
1670,1350,3,0,1350,320,589950,2014
2840,16851,1,3,1600,1240,440000,1950
770,8600,1,0,770,0,248000,1914
2040,130680,2,0,2040,0,730000,1977
3052,12145,2,0,3052,0,425000,2004
2620,14248,2,0,1830,790,680000,1977
3120,10400,2,0,3120,0,341500,1980
1100,3975,1,0,900,200,395000,1950
3410,95396,1.5,0,3410,0,1.23E+06,1962
2510,9180,1,1,1600,910,695500,1975
1680,8629,1,0,1200,480,308000,1977
1960,6450,1,0,1000,960,422500,1977
1040,6900,1,0,1040,0,418000,1915
1750,9780,1.5,0,1750,0,385000,1961
2170,12508,1.5,0,1650,520,876650,1928
1639,2710,2,0,1479,160,450000,2003
2100,9984,1,0,1290,810,418800,1973
880,1753,2,0,880,0,330000,1945
1940,8376,1,0,1290,650,550000,1963
2490,11650,1,0,1390,1100,270000,1990
2060,7080,2,0,1800,260,978500,1940
2720,10455,2,2,2500,220,975000,1981
2180,6850,1,0,1750,430,455000,1973
3600,38016,2,2,3310,290,1.42E+06,1991
840,9000,1,0,840,0,220000,1951
2370,12196,2,0,2370,0,490000,1970
2270,9100,2,0,2270,0,420000,1978
2720,7043,2,0,2720,0,408500,2003
1140,4800,1.5,0,1140,0,716000,1915
2460,5000,2,0,1620,840,965000,1938
1240,9196,1,0,1240,0,357823,1968
10040,37325,2,2,7680,2360,7.06E+06,1940
1670,9500,1,0,1170,500,425000,1977
2220,6731,1,0,1110,1110,711777,1953
980,9903,1,0,980,0,335000,1966
1890,6938,1.5,0,1890,0,825000,1919
1100,6000,1.5,0,1100,0,210000,1900
2770,19700,2,0,1780,990,575000,1983
4250,10925,2,0,4250,0,1.21E+06,2003
1370,4866,1,0,1370,0,431500,2005
1480,13457,1,0,1480,0,475000,1959
3770,4000,2.5,0,2890,880,1.50E+06,1916
2870,206474,2,0,2330,540,540000,1960
3820,35016,2,0,3820,0,775000,1987
1530,2978,1,0,1210,320,635000,1997
4120,16365,1,2,4120,0,1.30E+06,1999
1590,7267,1,0,1100,490,405000,1976
1520,8600,1,0,1040,480,210000,1951
2350,4675,2,0,2150,200,880000,1923
1370,8837,1.5,0,1370,0,239000,1955
1540,6100,1,0,770,770,515000,1944
3786,38038,1,4,1934,1852,1.38E+06,1978
1500,5393,2,0,1500,0,215000,1999
1750,17685,1,0,1750,0,315000,1943
1800,8303,1,0,1200,600,442500,1957
1180,55321,1,0,1180,0,311000,1941
830,6030,1,0,830,0,425000,1925
1540,9450,1,0,1040,500,433500,1919
1610,8296,2,0,1610,0,450000,1978
1990,10260,2,0,1990,0,675000,1987
2070,4132,2,0,2070,0,535000,1999
1760,12874,1,0,1230,530,577000,1967
1740,8528,1,0,1290,450,480000,1939
1950,4473,1,0,1530,420,400000,1914
1280,8184,1.5,0,1280,0,304000,1947
1460,7203,1,0,1460,0,355000,1990
3770,982998,2,0,3770,0,998000,1992
2410,8447,2,3,2060,350,550000,1936
2410,8447,2,3,2060,350,550000,1936
1400,7300,2,0,1400,0,210000,1948
2100,7587,2,0,2100,0,317000,1990
5360,25800,1,0,3270,2090,700000,1971
1000,9150,1,0,1000,0,265000,1969
3150,6175,2,0,3150,0,700000,2001
4180,17841,2,2,3160,1020,1.02E+06,1990
2840,20242,1,0,2240,600,1.15E+06,1972
2110,35091,1,0,1290,820,460000,1985
1660,4000,1,0,1000,660,410000,1950
2160,4400,1,0,1320,840,665000,1921
2420,7744,2,0,2420,0,600000,1994
1920,3844,1,0,1170,750,502000,1967
2310,8030,2,0,2310,0,364950,1978
2330,4000,1.5,2,1520,810,680000,1927
2340,13713,1,0,1670,670,235500,1967
2590,5756,2,0,2590,0,576000,2001
1410,1240,2,0,1140,270,405000,2006
2850,8039,1,0,1540,1310,335000,1989
730,6728,1,0,730,0,122000,1953
1470,6250,1,3,1070,400,432000,1939
2330,11400,1,0,2330,0,375000,1974
2460,11250,1,0,2460,0,276000,1959
2080,111513,1.5,0,1680,400,450000,1977
990,8140,1,0,990,0,210000,1910
1450,4106,2,0,1450,0,279000,2011
1340,3900,2,0,1340,0,635000,1900
2730,7372,2,0,2730,0,350000,1998
1140,7560,1,0,1140,0,218000,1958
1950,6300,1.5,1,1650,300,750000,1944
2000,25700,1,0,1150,850,310597,1958
900,37800,1,0,700,200,355000,1923
3390,5211,2,0,3390,0,735000,2004
720,6000,1,0,720,0,155000,1940
940,10368,1,0,940,0,354000,1965
1770,10513,1,0,1400,370,415000,1982
590,833,1,0,590,0,202000,1926
1980,1873,2,0,1470,510,580000,1996
3070,10375,2,0,2180,890,1.50E+06,1962
3500,7519,2,0,3500,0,790000,2004
2100,5112,2,0,2100,0,499900,1999
2620,98881,1,0,1820,800,525000,1952
2810,10613,2,0,2810,0,810000,1989
2290,8773,1,0,1330,960,425000,1947
1350,7588,1,0,1350,0,241250,1993
2770,19116,1,0,1600,1170,318700,1961
2530,5000,1.5,2,2070,460,720000,1917
1280,10500,1.5,0,1280,0,291000,1941
1060,38644,1,0,1060,0,420000,1983
1000,3554,1,0,1000,0,210000,1975
3870,11000,2,2,2970,900,645000,1991
3370,5000,1.5,0,2140,1230,762000,1907
2290,7765,1,0,2290,0,247500,1936
1670,7150,2,0,1670,0,282500,1990
1460,22651,1,0,1460,0,395000,1961
1770,8235,1,0,1030,740,295000,1960
820,5100,1,0,820,0,235000,1954
1900,6334,1,2,1450,450,770000,1948
1870,4950,1,0,1870,0,559950,2006
1840,5419,1,0,920,920,639000,1942
1590,8470,1,0,1140,450,314950,1967
1640,6180,1,0,1640,0,525000,1946
3000,11665,1.5,4,3000,0,2.40E+06,2001
2160,6272,1,0,1390,770,820000,1960
2490,3600,2,3,1790,700,1.39E+06,1911
1290,5700,1,0,1290,0,521450,1950
3190,49137,2,0,3190,0,760750,1988
1540,115434,1.5,0,1540,0,759600,1923
2140,7200,1,0,1480,660,346150,1966
980,3800,1,0,980,0,390000,1926
2450,9432,2,0,2450,0,359950,1973
1360,5120,1.5,0,910,450,430000,1924
4610,11676,2,0,4610,0,960000,2000
7480,41664,2,2,5080,2400,800000,1953
2860,5805,2,0,2860,0,1.01E+06,1999
1810,11456,1,0,1810,0,290000,1970
2240,10296,1,0,2240,0,1.35E+06,1948
3610,59677,2,0,2440,1170,777000,2003
1450,4500,1.5,0,1450,0,526000,1921
1450,1091,2,0,1200,250,550000,2007
1820,8750,1,0,1200,620,276000,1958
5620,12672,2,0,4140,1480,2.50E+06,1916
2080,6554,1,0,1040,1040,325000,1950
1780,1754,3,0,1780,0,365000,2007
4340,9415,2,0,4340,0,2.15E+06,1967
2860,3680,2,0,1980,880,825050,1925
2540,9520,1,0,1500,1040,690000,1959
1140,6250,1.5,0,1140,0,390000,1958
1320,1297,3,0,1320,0,385000,1995
2040,7503,2,0,2040,0,619000,1987
1790,42000,1,0,1170,620,494000,1983
1910,13505,1,0,1910,0,412450,1955
1460,2800,2,0,1460,0,580000,1928
1420,22100,1,0,1420,0,269900,1957
1790,4080,1.5,0,1790,0,704300,1928
1390,6005,2,0,1390,0,267000,2005
1880,12150,1,0,1280,600,310000,1976
1570,10824,2,0,1570,0,227064,1908
2690,7000,2,0,1840,850,925000,1943
1670,11452,1,2,1670,0,245000,1992
1040,7490,1,0,1040,0,339888,1969
1560,7500,1,0,1560,0,439000,1968
1470,6120,1,0,1470,0,400000,1940
2070,15002,1.5,0,2070,0,560000,1955
1370,5922,1,2,1130,240,703011,1941
1120,4800,1,0,770,350,363000,1926
2640,6240,2,0,2640,0,650000,2001
1030,9916,1,0,1030,0,299950,1972
1120,6625,1,0,1120,0,228950,1942
1730,11700,1,0,880,850,465000,1956
2090,9847,2,2,2090,0,725000,1983
920,14400,1,0,920,0,212500,1977
2970,54450,2,0,2970,0,526000,1983
1720,10031,2,0,1720,0,383000,1993
1460,4692,1,0,1460,0,244000,1988
1540,3570,1.5,0,1490,50,565000,1930
2850,12714,1,0,2850,0,373000,1959
1310,9855,1,0,1310,0,300000,1962
2430,4781,2,0,2430,0,405000,2001
1700,14133,1,1,1700,0,979000,1954
2160,28750,2,0,2160,0,324888,1978
860,3200,1,0,860,0,445000,1929
2050,2020,2,0,1520,530,761000,2006
1650,4745,1,0,1130,520,435000,1972
1570,8410,1,0,1180,390,252000,1991
1660,10150,1.5,0,1660,0,350000,1957
1220,8119,1,0,1220,0,875000,1955
1220,8119,1,0,1220,0,940000,1955
1780,11342,1,0,1780,0,280000,1964
2180,4226,2,0,2180,0,450000,2004
3520,237402,2.5,0,3520,0,905000,2004
2220,20531,2,0,2220,0,382450,1998
1610,13309,1,0,1610,0,246700,1967
1070,9331,1,0,1070,0,220000,1956
1060,4880,1,0,910,150,555750,1913
1160,8906,1,0,1160,0,262500,1962
910,4725,1,0,910,0,515000,1949
2970,21907,2,0,2970,0,499500,1998
790,13062,1,0,790,0,135000,1942
1540,7290,2,0,1540,0,462500,1948
3130,21100,1,4,2530,600,937500,1956
1470,9570,1,0,1280,190,458000,1941
3160,7143,1.5,0,2100,1060,845000,1933
2675,40910,2,0,2675,0,660000,1984
1340,6783,1,0,1340,0,265000,1987
3830,6988,2.5,0,2450,1380,599999,1938
1800,8697,2,0,1800,0,280000,1987
2990,189852,2,0,2990,0,1.06E+06,1974
3720,14125,1,0,1930,1790,875000,1960
920,7276,1,0,920,0,125000,1961
3280,4904,2,0,3280,0,634800,2005
1440,9600,1,0,1440,0,269950,1964
1940,11612,1,0,1100,840,359950,1981
1590,11454,1,0,1590,0,417000,1979
1340,4122,1,0,1340,0,389000,2007
3770,10893,2,2,3770,0,1.04E+06,1997
2680,11250,1,0,1340,1340,698000,1967
2820,10125,2,0,2820,0,685000,2008
1520,7137,1,0,1520,0,198500,1932
2560,5428,2,0,2560,0,350000,2012
3310,387684,1,0,2160,1150,649950,1919
1540,7200,1,0,1540,0,441000,1968
1430,11761,1,0,1430,0,462600,1964
2506,6232,2,0,2506,0,365070,2006
2250,7500,1,0,1200,1050,550000,1956
2740,9600,1,0,1370,1370,470000,1945
1540,10400,1,0,1540,0,340000,1977
4190,38912,1,0,2040,2150,910000,1965
1690,8392,1,0,1190,500,405000,1979
1990,4600,1.5,2,1420,570,661000,1932
2410,7069,2,0,2410,0,635000,1993
1150,6098,1,0,950,200,282000,1948
1720,10137,2,0,1720,0,235000,1956
1260,22100,2,0,1260,0,277500,1981
2020,8250,1,0,1430,590,346500,1978
2240,5500,1,0,1490,750,480000,1959
1930,6508,2,0,1930,0,360000,1996
1820,6785,1,0,1420,400,245000,1994
1560,1490,2,0,1240,320,625000,1995
2170,2440,1.5,0,1450,720,750500,1911
1600,9579,1,0,1180,420,525000,1977
3760,57063,2,0,2950,810,740000,1998
1240,7735,1,0,1240,0,523000,1957
1090,4500,1.5,0,1090,0,292000,1929
2740,9599,1,2,1820,920,625000,1961
3110,11727,2,2,3110,0,700000,2002
1610,1320,2,0,1280,330,399950,2007
1880,1341,3,0,1650,230,545000,2007
1740,6369,1,0,870,870,339999,1954
3270,6000,2,0,2180,1090,1.21E+06,1909
1990,5149,2,0,1990,0,545000,2003
1960,8400,1,0,1960,0,260000,1967
1680,3420,1,0,960,720,526000,1992
2910,8540,2,0,2910,0,701000,2003
1500,7482,1,0,1210,290,290000,1968
580,1799,1,0,580,0,330600,1908
2540,8280,1,0,1270,1270,550500,1949
950,6426,1,0,950,0,430000,1949
7080,16573,2,0,5760,1320,4.00E+06,2008
810,4560,1,0,810,0,260600,1928
4080,7500,2,2,2720,1360,825000,1961
1820,8400,1,0,1300,520,378950,1956
2650,9065,2,0,2650,0,435000,2000
1670,1396,2,0,1250,420,631000,2015
2480,8342,2,0,2480,0,415000,1986
1240,7560,1,0,1070,170,222000,1967
1390,8250,1,0,1390,0,245000,1987
2880,10126,2,0,2880,0,720000,1985
1060,9954,1,0,1060,0,215000,1960
1070,2754,1,0,830,240,579100,1924
1640,9299,1.5,0,870,770,522500,1943
1510,3000,1,0,910,600,489000,1972
1230,2353,1.5,0,1230,0,240000,1925
1510,3657,1,0,1510,0,420250,2007
3180,20870,2,0,2120,1060,523000,1967
2260,6000,1,0,1430,830,628000,1958
1920,7277,2,0,1920,0,320000,1990
1980,7800,2,0,1980,0,359950,1999
1200,8063,1,0,1200,0,232000,1958
2020,5600,1,2,1210,810,810000,1961
2010,7561,1.5,0,1890,120,245000,1921
1930,8192,1,0,1470,460,273000,1984
2710,14989,1,0,1720,990,1.19E+06,1959
1950,6250,1.5,0,1450,500,438000,1917
2110,19600,1,0,2110,0,400000,1959
1250,4800,1,0,1250,0,340000,1951
1380,951,3,0,1380,0,552000,2006
2050,4080,2,0,2050,0,790000,1991
1800,22000,2,0,1800,0,360000,1931
1310,15022,1,0,1310,0,235000,1934
1010,3600,1,0,1010,0,775000,1913
1850,9600,1.5,0,1850,0,489200,1965
1750,8900,2,0,1750,0,341000,1977
2154,6050,2,0,2154,0,335000,2012
1230,1441,2,0,1010,220,393500,2004
1960,8846,1,3,980,980,360000,1940
1070,5750,1,0,870,200,400800,1923
1450,5378,1,0,1190,260,585000,1939
3680,5000,2,3,2480,1200,1.60E+06,1936
5760,32033,2,4,4390,1370,2.88E+06,1994
1220,13000,1,0,1220,0,300000,1955
2950,4560,2,0,1810,1140,1.05E+06,1912
1340,1110,2,0,1040,300,360000,1999
2870,5453,2,1,2220,650,665900,1926
2590,18224,1.5,0,2000,590,470000,1911
2090,8164,1,0,1070,1020,581000,1963
3000,8401,1,0,1500,1500,527000,1979
1730,7245,1,0,880,850,423000,1955
2850,4416,1.5,0,2040,810,875000,1926
1020,6903,1,0,1020,0,410000,1951
2200,6005,2,0,2200,0,606000,1997
3240,60840,2,0,3240,0,654000,1997
490,38500,1.5,0,490,0,150000,1959
2990,6771,1,0,1550,1440,373000,2003
2450,9488,1,0,1240,1210,550000,1900
1900,7604,2,0,1900,0,512500,1990
2640,7388,2,0,2640,0,360000,2003
1340,1480,3,0,1340,0,369000,1997
3220,5262,2,0,3220,0,825000,2003
930,11475,1,0,930,0,255000,1978
3240,10800,1,0,2260,980,1.29E+06,1946
2630,8470,1.5,0,2630,0,270000,1968
1730,4924,2,0,1730,0,480680,1996
2120,7725,1,0,1220,900,525000,1965
880,9238,1.5,0,880,0,291500,1946
1800,13551,1,0,1800,0,305000,1974
1600,7500,1,0,1600,0,285000,1998
3280,29111,2,3,3280,0,1.88E+06,1925
3290,8000,1,0,1790,1500,329500,1968
2890,18226,3,4,2890,0,1.57E+06,1984
1730,7202,1,0,1330,400,379260,1991
1590,3411,2,0,1590,0,356000,2000
1710,8947,1,0,1710,0,571900,1956
1995,18360,2,0,1995,0,271500,1957
1300,10030,1,0,1300,0,390000,1967
2720,62310,1,0,2040,680,550000,1985
1360,2070,2,0,1360,0,755000,1999
1590,1485,2,0,1300,290,509500,1994
1200,6278,1,0,1080,120,486700,1942
1170,3000,1.5,0,1170,0,527500,1910
2010,3600,1.5,0,1510,500,475000,1912
1880,1793,2,0,1810,70,268000,2001
3250,50529,2,0,3250,0,562000,1978
2270,13449,1,0,1310,960,780000,1975
3680,4400,2,0,2830,850,700000,1908
1880,3000,1,0,1040,840,710000,1931
1050,5664,1,0,910,140,445000,1947
2250,60548,1,0,2250,0,729000,2005
1689,1388,3,0,1689,0,384400,2008
2860,17853,1,0,1430,1430,815000,1962
2710,4069,3,0,2710,0,865000,1990
1770,7200,1,0,1770,0,514000,1967
2820,13193,1,0,1860,960,615000,1965
3400,99170,1,0,2000,1400,865000,1980
3110,6930,2,0,3110,0,755000,2004
1480,8321,1,0,1080,400,425000,1953
940,9839,1,0,940,0,375000,1910
2680,4548,2,0,2680,0,750000,2009
3190,5408,2,0,3190,0,722000,2005
1920,4480,2,1,1920,0,1.01E+06,1949
2610,7510,2,0,2610,0,725000,1996
1040,42180,1,0,1040,0,170000,1947
2880,35315,1,0,2270,610,845000,1982
1450,8771,2,0,1450,0,271900,1991
3902,3880,3,4,2782,1120,1.30E+06,1977
2460,7800,1,0,1500,960,261500,1977
2170,5000,2,0,2170,0,619500,2003
1970,15247,1,0,1450,520,435000,1986
1000,5454,1,0,1000,0,210000,1954
1580,4010,1,0,790,790,489950,1909
2130,8800,1,0,1100,1030,260000,1962
1370,8499,1,0,1370,0,300000,1949
2150,14161,1,2,1330,820,530000,1966
1370,14030,1,0,1370,0,235000,1977
1370,4000,2,0,1370,0,593500,1918
3290,80471,2,2,2330,960,562000,1975
3190,207346,2,0,3190,0,585000,1994
4140,20734,1,1,3300,840,2.40E+06,1977
1690,8901,1,0,1690,0,199500,1986
1690,3240,1.5,0,1690,0,544500,1914
1430,13370,1,0,1430,0,394900,1962
1980,4095,2,0,1980,0,912000,2009
1490,8102,2,0,1490,0,260000,1990
3620,12778,1,2,1900,1720,858000,1964
2720,16454,1,1,1870,850,1.28E+06,1963
1490,8544,1,0,1490,0,242150,1970
1230,7200,1,0,1230,0,220000,1986
1900,7980,1,0,1340,560,235000,1977
1530,10300,1,0,1530,0,370000,1978
2290,44866,1,0,1390,900,450000,1981
2240,6337,1,0,1280,960,534950,1956
3470,14271,2,0,3470,0,730000,2005
3050,32450,1,0,1550,1500,465000,1983
1100,5734,1,0,1100,0,178000,1955
1610,7140,1,0,1080,530,215000,1976
1910,15508,1,0,1210,700,300000,1984
1510,7066,1,2,1230,280,430000,1973
1280,4366,2,0,1280,0,183000,1985
1910,1501,2.5,0,1530,380,585000,2007
1170,3330,2,0,1170,0,192950,1969
1550,7713,1,0,1550,0,599000,1930
1060,7920,1,0,1060,0,326500,1968
1040,5765,1,0,1040,0,358803,1944
1550,12920,2,0,1550,0,537000,1999
2490,24691,1,4,1580,910,1.16E+06,1961
920,5889,1,0,920,0,156000,1950
1250,8276,1.5,0,1250,0,219000,1939
2540,2700,2,0,1630,910,1.19E+06,1922
2190,16788,1,2,1380,810,248000,1978
1340,196020,1,0,1340,0,340000,1987
2410,15300,1,0,1400,1010,899100,1975
1830,10954,1,0,1830,0,346950,1963
1850,5775,2,0,1740,110,330000,1928
1410,8250,1,0,1410,0,325000,1954
1460,7884,1,0,1460,0,315000,1975
1500,1375,2,0,1200,300,649950,2014
1130,7200,1.5,0,1130,0,316000,1942
1620,3196,2,0,1620,0,386000,2008
2330,7280,1,0,1450,880,535000,1982
1520,1800,3,0,1520,0,600000,2003
2840,8746,2,0,2840,0,339000,2001
1520,7456,1,0,1520,0,167000,1949
1740,4800,1,0,1740,0,430000,1952
4000,9309,2,0,4000,0,688000,2007
2780,6000,1,3,1670,1110,834500,1948
3500,8750,1,4,2140,1360,1.08E+06,1951
1060,52272,1,0,1060,0,250000,1960
1290,4000,1.5,0,1290,0,402500,1926
2390,6435,1,0,1600,790,432500,1978
2460,14100,1,0,1380,1080,485000,1972
2930,22000,1,3,1580,1350,560000,1978
2200,8292,2,0,2200,0,410000,1990
1870,7344,1,0,1470,400,455000,1980
2060,8968,1,0,1190,870,459500,1975
1610,11305,1,0,1610,0,371000,1968
2120,3400,2,0,2120,0,289500,2002
1450,1263,2,0,1160,290,395000,2007
1980,5000,1,0,1090,890,496752,1923
860,6800,1,0,860,0,227000,1943
1460,9261,1,0,1460,0,330000,1985
2590,8610,1,0,1340,1250,480000,1958
1120,217800,1,0,1120,0,290000,1976
1340,21336,1.5,0,1340,0,281000,1945
1780,3120,1.5,3,1780,0,705000,1926
2920,4000,1.5,0,1910,1010,1.40E+06,1909
2820,6611,1,0,1410,1410,485000,1958
1550,1919,3,0,1550,0,622000,2003
1600,39848,1,3,1600,0,380000,1958
3190,19513,2,4,3190,0,2.13E+06,1982
1960,6380,1,0,980,980,561500,1939
970,9600,1,0,970,0,242000,1972
1360,10726,1,0,1360,0,348500,1966
1360,10726,1,0,1360,0,370000,1966
3810,6663,2,0,3810,0,752000,1977
1340,8250,1,0,1100,240,230000,1985
1990,4977,3,0,1990,0,715000,2012
1120,10187,1,0,1120,0,240415,1968
2060,4080,1.5,0,1460,600,562000,1922
1170,4080,1,0,1170,0,360000,1917
1610,1246,2,1,1080,530,659950,2014
1890,1599,2,0,1430,460,458500,2012
1070,649,2,0,720,350,259950,2008
1680,6108,1,0,1680,0,366000,1989
2890,7821,2,0,2890,0,978000,2014
1360,6120,1,0,1060,300,525000,1947
1660,4800,2,0,1660,0,926300,1907
1620,6120,1,0,1620,0,750000,1951
960,6263,1,1,960,0,660000,1942
1000,7200,1.5,0,1000,0,305000,1947
2395,6143,1,0,2395,0,800000,2003
3050,9440,1,0,1800,1250,600000,1966
1120,88327,1.5,0,1120,0,435000,1972
2960,4296,2,0,2190,770,1.14E+06,2007
1250,1017,3,0,1250,0,318000,2008
1940,5000,1,0,980,960,639000,1910
1750,3900,2,0,1750,0,453000,1977
2150,9148,1,0,2150,0,800000,1955
1500,6800,1,0,910,590,437000,1942
3230,75889,2,4,3230,0,1.15E+06,1925
3000,8645,2,0,3000,0,490000,1985
1520,7700,1,0,1520,0,499950,1967
1190,10116,1,0,1190,0,160134,1968
990,8255,1,0,990,0,191000,1953
1250,7280,1,0,1250,0,221000,1965
2080,6360,1,0,1330,750,352800,1960
1640,10424,2,0,1640,0,350000,1988
1550,3000,1.5,0,1350,200,458000,1918
1290,189486,1,0,1290,0,359950,1960
3250,5093,2,3,3250,0,1.05E+06,2004
1260,11775,1,0,1260,0,353000,1942
2840,4468,3,0,2840,0,717550,2006
1960,6500,2,0,1960,0,450000,1977
760,3090,1,0,760,0,167500,1903
2240,78225,2,0,2240,0,550000,1976
2240,9684,2,0,2240,0,939000,1970
1820,15570,1,2,1820,0,700000,1948
3370,435600,2,3,3370,0,480000,2005
1160,4360,1,0,1160,0,501000,1929
1640,8625,1,0,1320,320,580000,1987
820,59677,1,0,820,0,527550,1999
2800,4687,2,0,2800,0,399000,2005
1780,5000,1.5,0,1080,700,240000,1957
2200,268329,1,0,1410,790,353000,1989
1480,3132,1,0,740,740,335000,1910
2010,2554,2,0,1860,150,475000,2001
2880,5100,1.5,0,2080,800,660000,1926
940,1948,1,0,940,0,551000,1900
1620,10530,1,0,1620,0,249950,1968
4400,262666,2,0,4400,0,1.15E+06,1988
1530,6743,1,0,1410,120,575000,1955
3460,11350,1,4,1780,1680,1.09E+06,1974
2890,7306,2,0,2890,0,515000,2006
1980,11214,1,0,1980,0,235000,1959
1980,3243,1.5,0,1980,0,796000,1912
1450,2550,1,0,820,630,450000,1984
4280,18834,1,4,2180,2100,2.05E+06,1971
1810,6509,2,0,1810,0,270000,1994
2490,27702,2,4,2490,0,1.71E+06,2000
1610,4108,1.5,0,1610,0,565000,1928
1820,3008,2,0,1090,730,680000,1910
9200,35069,2,0,6200,3000,5.57E+06,2001
3520,35991,2,0,3520,0,864500,1992
3740,18000,1,0,1870,1870,1.15E+06,1951
2150,30476,2,0,2150,0,335000,1991
3526,15958,2,0,3526,0,911000,1997
1070,6625,1,0,830,240,425000,1950
1410,81021,1,0,1410,0,299950,1949
3190,49658,2,0,3190,0,864000,1999
1270,6000,1,0,1270,0,425000,1939
1970,14490,1.5,0,1970,0,374950,1963
1640,7630,1,0,1180,460,247000,1968
1600,7161,1,0,1600,0,475000,1953
3020,5868,2,0,3020,0,275000,2003
1350,368517,1,0,1350,0,355000,1947
1870,22072,1,0,1070,800,285000,1959
2730,38869,1.5,4,1940,790,1.34E+06,1963
1100,17817,1,0,620,480,325000,1980
4320,40816,2,0,4320,0,1.67E+06,1997
2700,9994,1,3,1350,1350,402000,1959
3700,16857,1,0,2170,1530,1.10E+06,2000
2190,9225,1,0,1250,940,375000,1959
2840,12253,1,0,1420,1420,396000,1960
2610,9077,1,0,1310,1300,320000,1987
2630,5827,2,0,2630,0,610000,2001
1090,7698,1,0,1090,0,249950,1966
3090,100835,2,0,3090,0,675000,1999
1670,7772,1,0,860,810,448000,1919
1300,3600,2,0,1300,0,819000,1900
3670,18505,1,4,2530,1140,1.25E+06,1983
1700,6031,2,0,1700,0,225000,1994
2560,982278,1,0,2560,0,790000,2004
2770,6000,2,0,2400,370,685000,1993
3240,8338,2,0,3240,0,812000,2001
2300,6400,1,0,2300,0,705000,2007
2483,6870,2,0,2483,0,360000,2005
760,779,3,0,760,0,344000,2006
2040,6900,2,0,2040,0,825000,1903
1200,6120,1,0,950,250,476500,1945
960,5096,1,0,960,0,379500,1949
2410,35236,1,0,2410,0,620000,1980
2260,7701,2,0,1760,500,477590,2000
1910,8190,1,0,1010,900,490000,1946
1500,5000,1.5,0,1140,360,470000,1927
1360,1236,2,0,1140,220,500000,2006
1320,7341,1,0,1320,0,370000,1982
1940,4400,1,0,970,970,790000,1923
2650,18295,2,0,2650,0,725000,1986
3040,2800,2,0,2100,940,840000,1906
1240,11108,1,0,1240,0,390000,1952
2210,11585,1,0,1510,700,507000,1958
1540,6273,1,0,770,770,263500,1951
1320,1683,2,0,1270,50,369000,2004
3040,5326,2,0,3040,0,500000,2008
910,4301,1,0,910,0,570000,1923
2040,7145,1,0,1490,550,284000,1994
980,4108,1,0,980,0,415000,1947
980,3090,1.5,0,980,0,197500,1903
4420,9492,2,1,3420,1000,925000,1962
1570,6300,1,0,820,750,468000,1953
1600,5001,1.5,0,1080,520,355000,1930
1830,6000,1,0,930,900,639000,1939
2820,14250,2,0,2820,0,720000,1991
1800,6000,1,0,900,900,381000,1950
4380,42769,2,0,4380,0,1.05E+06,1983
2980,3730,2,0,2980,0,670000,2005
1690,6658,1,0,1690,0,400000,1942
4040,50479,2,0,4040,0,910000,1987
1250,9427,1,0,1250,0,294000,1931
1500,10230,1,0,1500,0,315001,1968
1630,10723,1,0,1630,0,360000,1959
1410,2700,2,0,1410,0,520000,1902
1140,4560,1,0,770,370,474000,1944
3280,5876,2,0,3280,0,702000,2004
3490,87497,2,0,3490,0,728000,2001
2020,7277,2,0,2020,0,308000,1993
4580,4443,3,4,4580,0,2.00E+06,2004
2270,7917,2,0,2270,0,340000,1986
1310,10200,1,0,1310,0,306500,1947
1420,3600,1.5,0,1420,0,716000,1904
2980,44431,2,0,2640,340,950000,1981
4180,8561,2,0,4180,0,673200,2003
1950,6000,1,0,1350,600,564500,1961
1790,11801,1,0,1790,0,393000,1974
1400,5071,1,0,1400,0,425000,1916
1320,24684,1,0,1320,0,150000,1979
1620,106722,1,0,1200,420,327000,1980
3120,7448,2,0,3120,0,444900,1998
2100,14773,2,0,2100,0,305000,1998
1370,1194,3,0,1370,0,469000,2004
1520,7875,1,0,1520,0,525000,1969
2410,17424,1,0,1630,780,330000,1978
1260,4080,1,0,1260,0,618000,1911
2830,7350,1,0,1690,1140,295500,1982
2064,46173,2,0,2064,0,567035,1903
2640,34870,1,0,1770,870,518000,1977
1020,9200,1,0,1020,0,303000,1978
2200,8065,2,0,2200,0,300000,1998
1420,7520,1,0,1420,0,413107,1956
1350,3090,1.5,0,1350,0,400000,1914
1290,6859,1,0,1290,0,535000,1941
1680,2600,1,0,840,840,555000,1915
2280,6386,2,0,2280,0,312000,2008
1840,3500,1.5,0,1540,300,785200,1910
2040,11850,1,2,1020,1020,749000,1959
1490,10367,1,0,1010,480,285000,1957
2440,5088,2,0,2440,0,425000,2007
1930,15540,1,0,1260,670,360000,1958
1200,6615,1,0,1200,0,260000,1954
1550,8509,1,0,1150,400,369000,1959
2180,11132,1,0,1620,560,275000,1978
1430,1448,3,0,1430,0,407000,2005
1230,5418,1,0,990,240,575000,1949
1670,3852,2,3,1670,0,1.24E+06,1928
2720,4913,1,1,1700,1020,875000,1936
2220,6811,1,0,1270,950,320000,1961
1520,9041,1,0,1520,0,810000,1954
1590,7620,1,0,1090,500,274000,1984
1480,9523,1,0,1120,360,239900,1959
1860,7808,1,0,1080,780,450000,1953
1360,60548,1,0,960,400,263400,1960
1360,5967,1,0,1360,0,265000,1954
2360,6250,1,2,1460,900,418000,1960
2360,5737,2,0,2360,0,390000,2003
1860,7500,1,0,930,930,430000,1909
2630,9705,2.5,2,2630,0,1.44E+06,1987
1280,37373,1,0,1280,0,297000,1996
2330,7220,2,1,1600,730,650000,1988
720,18000,1,0,720,0,195000,1950
3380,108900,2,0,2700,680,554000,1999
3650,843309,2,0,3650,0,550000,1991
1640,4590,1.5,0,1640,0,700000,1951
1730,177657,1.5,0,1730,0,300000,1948
1030,8576,1.5,0,1030,0,315000,1952
1790,5250,1,0,1400,390,603000,1943
840,3400,1,2,840,0,530000,1924
1300,8480,1,0,1300,0,397500,1969
1240,5250,1.5,0,1240,0,221000,1904
2170,8050,1,0,1220,950,466000,1976
1330,5412,2,0,1330,0,197500,1905
1390,1080,2,0,1140,250,280000,2006
1240,3873,1,0,860,380,412000,1909
880,6731,1,0,880,0,454000,1950
2540,228254,1,0,1450,1090,540000,1990
2520,5753,1.5,0,1510,1010,250000,1928
2510,35691,1,0,2510,0,900000,1967
2020,7902,1,0,1220,800,245000,1962
2060,7251,1,0,1350,710,290000,1987
930,7742,1,0,930,0,160000,1933
2700,7225,1.5,4,1660,1040,1.26E+06,1910
1060,6050,1,0,940,120,325000,1939
670,6750,1,0,670,0,185000,1947
1750,4990,1,0,950,800,477000,1916
930,7623,1,0,930,0,100000,1942
2420,11481,1,0,1370,1050,345000,1985
2410,14985,1,1,1950,460,530000,1965
1150,7156,1,0,1150,0,203000,1953
2480,5000,2,0,2480,0,599000,2004
1310,6000,1.5,0,1310,0,370000,1940
1240,8000,1,0,1040,200,140000,1954
1150,5100,2,0,1150,0,500000,1911
1460,4000,1,2,730,730,527200,1929
3060,7015,1,0,1600,1460,549900,1979
3520,8095,2,0,3520,0,760000,2006
960,4400,1,0,960,0,319000,1951
2430,15264,2,0,2430,0,362300,1997
1930,4505,1,3,1440,490,421000,1973
1090,4000,1.5,0,1090,0,690000,1945
2790,31798,1,0,1650,1140,640000,1953
1650,6900,1,0,910,740,238000,1978
3740,39640,2,2,3740,0,789000,1991
5310,12741,2,2,3600,1710,1.05E+06,1967
1690,4476,2,0,1690,0,302500,2008
1400,7920,1,0,1400,0,259950,1963
1440,28516,1,0,1440,0,456000,1975
1360,3718,2,0,1360,0,369950,1987
1726,197326,2,0,1726,0,363750,1982
2220,216493,1,2,2220,0,585000,1989
1850,6676,2,0,1850,0,268000,1986
2860,4000,2,0,2160,700,1.20E+06,1910
1120,10176,1,0,920,200,345000,1905
2340,19850,2,0,2340,0,539000,1993
3760,9792,2,0,2550,1210,851000,1984
1920,7200,2,2,1780,140,900000,1997
3230,5000,2,2,2430,800,850000,1945
1260,6500,1,0,1260,0,390000,1966
1540,6909,1,0,920,620,345000,1955
1700,3150,2,0,1700,0,534500,2005
3600,3960,2,0,2400,1200,643500,1971
3150,5520,1.5,0,2130,1020,1.21E+06,1925
1280,4000,1,0,730,550,495000,1929
980,4120,1,0,830,150,535000,1950
2190,6578,2,0,2190,0,435000,2004
2470,1831,2,0,1970,500,305000,2009
2590,7910,2,0,2590,0,799000,2001
2580,15031,2,0,2580,0,700000,1999
1270,1213,2,0,1040,230,467000,2005
1250,7560,1,0,1250,0,263000,1959
4660,7157,2,0,3020,1640,760000,2003
2019,4435,2,3,2019,0,293000,2008
1490,7929,1,0,1490,0,245000,1989
1560,10807,1,0,1560,0,181000,1949
1030,15264,1,0,1030,0,240000,1962
2560,7961,1,2,1450,1110,880000,1975
1460,6377,1,0,1460,0,285000,1995
770,6017,1,0,770,0,407500,1950
1960,3543,2,0,1960,0,325000,2004
1900,10454,1,0,1390,510,405000,1978
1970,4120,1.5,0,1230,740,291700,1927
2490,18525,2,3,2490,0,370000,1995
1430,8960,1,0,1430,0,270000,1953
2680,7200,1,0,1380,1300,800000,1952
1610,3210,1,0,910,700,626500,1928
4300,8406,2,1,3580,720,1.13E+06,1987
3200,7545,2,0,3200,0,399950,2003
2140,15030,1,0,1570,570,419000,1958
4240,43995,2,0,4240,0,1.16E+06,1989
3410,10769,2,0,3410,0,1.41E+06,2008
2090,8064,2,0,2090,0,710000,1967
1410,4840,1,2,1230,180,650000,1942
2820,33750,2,0,2820,0,369900,1984
2770,63118,2,0,2770,0,641000,1997
1400,6879,1,0,1400,0,403000,1951
3620,4000,2,0,2730,890,1.02E+06,2005
2260,13600,1,0,1770,490,865000,1974
3440,23954,1.5,3,2260,1180,2.49E+06,1931
2150,3588,2,3,1850,300,810000,1926
1256,1154,3,0,1256,0,316750,2005
2220,130244,2,0,2220,0,652500,1989
2850,15240,1,0,1850,1000,360000,1962
700,5100,1,0,700,0,208000,1953
3700,63991,2,0,3700,0,898000,1992
1400,11934,1,0,1050,350,295000,1961
3130,18253,2,0,3130,0,652500,1978
2170,5764,2,0,2170,0,560000,1992
1020,8400,1,0,1020,0,280000,1957
1760,8584,1.5,0,1760,0,289950,1937
1860,44093,1,0,1860,0,397500,1978
1140,75132,1,0,1140,0,380000,1956
1670,22703,1,0,1310,360,415900,1988
1710,8645,1,0,1510,200,475000,1923
500,7440,1,0,500,0,125000,1928
1470,32670,1,0,1020,450,238000,1958
1370,9750,1,0,1070,300,296000,1953
3470,117612,1.5,0,3470,0,475000,1924
1650,6250,1.5,0,1650,0,390000,1910
1180,3750,1,0,1030,150,425000,1940
3110,5000,1.5,0,1810,1300,725000,1921
2080,12134,1,0,1530,550,605000,1973
1600,1950,2,0,1600,0,302000,1906
2380,6000,2,0,1650,730,886000,1931
1630,6120,1,0,980,650,540000,1918
1910,8400,2,0,1910,0,435000,1975
3140,10752,2,0,2300,840,409000,1992
1250,7280,1,0,1250,0,405000,1975
1990,3984,2,0,1990,0,560200,2004
2110,7208,1,0,1170,940,324000,1975
2490,8290,2,0,2490,0,390000,1999
800,5000,1,0,800,0,414000,1938
2360,4670,2,0,2360,0,441500,1998
1770,5146,2,0,1770,0,375000,1992
2710,5500,2,0,2710,0,668500,1999
1940,10202,1.5,0,1940,0,540000,1940
3450,11240,2,3,2430,1020,1.04E+06,1960
3440,4920,2,4,2520,920,1.35E+06,2014
2410,9549,1,0,1780,630,758000,1956
2290,10687,2,0,2290,0,949880,1978
1030,4089,1.5,0,1030,0,570000,1927
2290,12047,2,0,2290,0,736000,1988
1490,4400,1.5,0,1490,0,670000,1906
2370,8400,1,0,1270,1100,1.13E+06,1949
1930,3976,1.5,0,1930,0,650000,1914
1600,4000,1,0,850,750,690000,1918
2240,45738,2,0,2240,0,610000,1988
770,4000,1,0,770,0,413500,1924
2300,9752,2,2,2300,0,765000,1968
3400,7081,2,0,3400,0,828200,2001
900,4397,1,0,900,0,205000,1918
1450,5175,1,0,1030,420,465000,1995
2240,5402,2,0,2240,0,556000,2005
1780,4169,2,0,1780,0,540000,1994
2320,4254,2,0,2320,0,423000,2004
1590,14766,1,0,1590,0,375000,1963
990,12696,1.5,0,990,0,173250,1936
2605,12030,1,0,1355,1250,599900,2003
2870,4461,1,0,1650,1220,646000,1976
5180,17811,2,2,4070,1110,1.08E+06,2001
2180,3870,1,0,1020,1160,558000,1900
850,5225,1,0,850,0,354000,1949
4050,9517,2,0,3360,690,1.20E+06,1990
2250,4200,1.5,0,1650,600,670000,1909
3100,9378,3,2,3100,0,1.13E+06,1978
1747,12250,2.5,0,1747,0,267500,1948
2410,4708,2,0,2410,0,299800,2002
2070,9120,1,0,1250,820,430000,1958
1860,3040,1.5,0,1530,330,775000,1921
950,5214,1,0,830,120,333000,1944
1060,11765,1,0,1060,0,336000,1951
880,1712,2,0,880,0,323000,1945
2550,56628,2,0,2550,0,575000,2001
1550,2079,2,0,1550,0,328000,2008
1590,4600,1.5,0,1290,300,572500,1926
1650,5100,1,0,1040,610,600000,1908
2430,7242,2,0,2430,0,412000,2003
1810,7200,1,0,1310,500,827500,1960
2890,17349,2,0,2890,0,300000,1994
1280,5040,2,0,1280,0,415000,1985
3410,4056,1.5,0,2130,1280,750000,1906
2220,4000,2,0,1700,520,800000,1914
1060,6000,1,0,1060,0,420000,1954
1120,8250,1,0,1120,0,266000,1957
2680,10590,2,0,2680,0,499000,2004
1770,5750,2,0,1770,0,440000,1947
2950,12196,2,0,2310,640,495000,1918
1260,5300,1,0,840,420,630000,1951
1430,6818,1,0,1430,0,424000,1972
2730,36183,2,0,2730,0,760000,1986
3270,15704,2,0,2110,1160,650000,1990
1720,10018,1,0,1720,0,248500,1960
1270,12420,1,0,1270,0,379600,1962
3260,10032,1,0,1960,1300,538000,1978
2050,6360,2,0,2050,0,530000,1988
2050,9720,2,0,2050,0,545000,1967
3580,35261,1.5,0,3580,0,925000,1985
1960,48787,1.5,0,1960,0,565000,1983
840,3522,1,0,840,0,405100,1947
1300,8800,1,0,1300,0,502000,1963
1260,3000,2,0,1260,0,425000,2003
1650,2958,2,0,1650,0,233500,1985
1710,10341,2,2,1710,0,287000,1986
1180,8775,1,0,1180,0,190000,1966
2780,31510,2,0,2780,0,666000,1979
950,3090,1,0,950,0,330000,1909
3620,7821,2,2,2790,830,1.49E+06,1958
2140,10256,2,0,2140,0,393000,1987
1920,4627,1,0,1010,910,353000,1998
750,6720,1,0,750,0,260000,1916
2060,2551,2,0,1900,160,680000,2001
2380,11200,1,0,2380,0,921000,1963
750,6380,1,0,750,0,319000,1949
1160,10881,1,0,920,240,280000,1983
1050,6300,1,0,1050,0,220000,1942
1740,5200,1,0,1060,680,219000,1977
2050,7171,1,0,1540,510,528000,1988
1980,8100,1,0,1310,670,405000,1949
1690,1618,2,0,1150,540,372977,2014
2320,5900,1.5,2,2320,0,934550,1910
2480,9900,2,3,2130,350,1.47E+06,1940
2290,5350,2,0,2120,170,975000,1958
3180,13806,2,0,3180,0,800866,1990
3470,16264,2,0,3470,0,950000,1980
1540,4140,1.5,0,1540,0,624000,1902
2800,8442,2,4,2800,0,1.85E+06,1963
1050,9876,1,0,1050,0,310000,1953
1480,6800,1,0,1480,0,315000,1968
1010,5973,1,0,1010,0,675000,1942
1660,8208,1,0,1660,0,490000,1965
2760,6350,1,0,1380,1380,600000,1958
1040,20524,1,3,1040,0,154000,1949
2220,6500,2,3,2220,0,480000,1964
1270,7500,1,0,1270,0,196900,1954
2960,39370,2,0,2960,0,735000,1989
1330,8748,1,0,1330,0,205500,1986
1210,1040,2,0,1210,0,357186,2014
2120,6754,2,0,2120,0,275000,1998
2090,12026,1,0,2090,0,248500,1948
2680,7836,2,0,2680,0,350000,1990
1790,47250,1,0,1220,570,390000,1987
1950,12240,1,0,1250,700,390000,1956
3740,14913,1.5,0,3740,0,660000,1979
1140,8263,1,0,1140,0,310000,1950
2480,5137,2,0,2480,0,717000,2000
2580,11250,1,0,1410,1170,260000,1964
2290,5001,1,0,1490,800,745000,1960
2320,12042,1,0,1320,1000,470000,1975
2530,8820,2,0,2530,0,429000,1997
1400,7140,1,0,1400,0,220000,1969
2060,1850,2,0,1400,660,497000,2007
1640,4000,1.5,0,1640,0,716100,1909
1960,94525,1.5,0,1960,0,371000,1979
3000,25175,1,0,1500,1500,379000,1961
1320,8500,1,0,1320,0,937500,1954
1760,4500,1.5,0,1760,0,720000,1906
2130,2306,2,1,1420,710,616000,1924
1390,7120,1,0,1390,0,259000,1988
1400,3825,1.5,0,1100,300,538000,1904
3230,9576,1.5,0,3230,0,605000,1966
1110,7603,1,0,1110,0,369950,1967
1670,4220,2,0,1670,0,310000,2002
1540,9450,1,0,1540,0,227500,1960
2090,7400,1,0,1670,420,274000,1973
1410,8088,1,0,1410,0,410000,1987
1370,78408,1,0,1370,0,354800,1964
1910,5120,1,0,1300,610,650000,1954
1678,13862,1,0,1678,0,353000,1994
960,12745,1,0,960,0,224975,1977
2080,13054,1,1,2080,0,600000,1951
1790,7700,1,0,1340,450,437500,1976
2540,6093,2,0,2540,0,567000,1999
1790,11656,2,0,1790,0,225000,1963
940,9330,1,0,940,0,255000,1941
6810,7500,2.5,0,6110,700,2.48E+06,1922
900,4600,1,0,900,0,370000,1951
1900,8800,1,0,1140,760,675000,1975
1440,4268,1,0,1040,400,285000,1953
2070,37904,1,0,1420,650,310000,1973
2240,7245,1,0,1140,1100,475000,1972
3320,5034,2,0,3320,0,410000,2006
1950,5950,1,0,1330,620,895000,1947
1240,7733,1,0,790,450,375000,1941
1830,4694,2,0,1830,0,349000,2003
1740,4400,1.5,0,1740,0,650500,1903
1410,15120,1,0,1410,0,760000,1950
2050,3960,1,0,1180,870,480000,1986
3220,16145,2,0,3220,0,689000,1993
1960,5000,1,0,980,980,415000,1911
1070,6110,1,0,1070,0,195000,1968
2820,9956,1,0,1410,1410,318000,1967
4060,35621,1,0,2030,2030,404000,1989
800,3090,1,0,800,0,339950,1925
1260,7897,1,0,1260,0,215000,1979
2420,7423,2,0,2420,0,339900,1990
810,3211,2,0,810,0,285000,1982
1600,5000,1.5,0,1110,490,550000,1947
1350,9000,1.5,0,1350,0,430000,1964
970,7790,1,0,970,0,219000,1967
1780,4750,1,0,1080,700,555000,1947
1350,7686,1,0,1350,0,233000,1989
1840,19501,1,0,1270,570,248000,1972
2550,9200,1,0,1580,970,454000,1975
1700,4418,2,0,1700,0,950000,1931
2430,7857,2,0,1730,700,359000,1980
2740,8230,1.5,0,2210,530,407500,1962
1560,7300,1,0,1040,520,224000,1964
1040,4590,1,0,1040,0,210000,1954
1820,9824,1,0,1820,0,261000,1968
1833,1706,3,0,1833,0,719000,1998
2160,3738,2,0,2160,0,440000,1994
2100,10362,2,0,1510,590,525000,1998
1370,9720,2,0,1370,0,375000,1968
1414,1960,2,0,1414,0,428000,1986
4115,7910,2,0,4115,0,988830,2014
1550,6225,1,0,1550,0,199950,1949
2100,3671,1.5,0,1750,350,840000,1929
1160,7006,1,0,1160,0,285000,1992
3597,4972,2,0,3597,0,330000,2006
1230,10125,1,0,1230,0,147500,1960
2190,7125,2,0,2190,0,320000,1978
1040,9000,1,0,1040,0,382500,1967
4690,8208,2,0,3040,1650,2.05E+06,1926
2270,10000,1,0,1720,550,596000,1974
1950,7280,2,0,1950,0,220000,1979
1880,6818,2,0,1880,0,325000,1993
2850,5664,2,0,2850,0,679950,2001
1160,6911,1,0,1160,0,175000,1947
1370,10050,1,1,1370,0,268000,1966
3260,110579,2,0,3260,0,715000,1997
3170,36384,2,0,3170,0,600000,1969
390,5900,1,0,390,0,228000,1953
3450,35880,2,0,3450,0,950000,1992
1490,224334,1,2,1490,0,475000,1983
1460,78408,1,0,1460,0,700000,1963
1300,20700,1,0,1300,0,275000,1962
1300,20700,1,0,1300,0,369500,1962
1540,7575,1,0,1040,500,215000,1978
2130,7172,2,0,2130,0,593450,1964
1350,4614,1,0,1350,0,498800,2008
2450,6534,2,0,1770,680,849000,1951
1940,4875,2,0,1940,0,1.15E+06,1925
2890,5110,2,2,2890,0,825000,2003
1680,9769,1,0,1340,340,265000,1989
1960,10400,1,0,1220,740,285000,1985
1590,7931,1,0,1190,400,240000,1979
1390,17739,1,0,1390,0,261000,1958
2440,7350,1,0,1610,830,330000,1978
1850,7560,1,0,1540,310,250000,1978
2800,9538,2,0,2800,0,350000,1993
3780,35273,1.5,0,3780,0,930000,1986
1910,8050,1,0,1000,910,275000,1980
2460,7620,1,0,1230,1230,325000,1969
810,5000,1,1,590,220,255000,1936
1900,5250,1,0,1500,400,562200,1943
3490,88909,1,3,2320,1170,952000,1980
2200,7350,1,0,1570,630,365000,1988
1190,11996,1,0,1190,0,332900,1969
2040,18360,2,0,2040,0,721000,1983
2400,3986,2,0,2400,0,487275,1999
1670,5791,2,0,1670,0,310000,1995
990,4800,1,0,990,0,245000,1908
2920,10573,1,0,2920,0,325000,1964
1840,9401,1,0,1840,0,550000,1971
910,4500,1.5,0,910,0,350000,1906
2950,72309,2,0,2950,0,599000,2006
1240,9500,1,0,1240,0,259950,1955
1980,7264,2,0,1980,0,240000,1996
1200,10080,1,0,1200,0,186000,1969
1280,15028,1,0,1280,0,395000,1982
3150,5757,2,0,3150,0,475000,2004
3500,10794,2,0,3500,0,815000,1996
1680,13751,1,0,1680,0,572000,1951
1360,3188,2,0,1360,0,419500,1986
2110,7350,1,0,1530,580,298700,1980
2034,13392,1,4,1159,875,549000,1947
1900,9994,1,0,1120,780,278000,1960
2380,4500,1.5,0,1470,910,455000,1926
4050,13495,1,2,2230,1820,925000,1988
1120,1201,3,0,1120,0,465000,1999
2850,2970,2,0,2120,730,620000,1999
2360,7650,1,0,1640,720,499900,1963
2540,11422,1,0,1270,1270,620000,1962
1160,6120,1,0,1040,120,450000,1941
2710,2147,2,0,2220,490,690000,2007
3120,16672,2,0,3120,0,1.90E+06,1969
3120,16672,2,0,3120,0,1.94E+06,1969
1870,9527,1,0,1870,0,832500,1951
1010,9678,1,0,1010,0,245000,1955
2980,18935,1.5,0,2980,0,820000,1990
2420,6495,2,0,2420,0,369000,2005
3830,8331,2,0,3830,0,1.05E+06,2014
3040,5067,3,2,3040,0,653000,1993
1460,10500,1,0,1460,0,220650,1980
1940,6355,1,0,1200,740,300000,2007
3780,20023,2,2,3780,0,970000,2001
1950,5451,2,0,1950,0,360000,2004
2450,5760,2,0,2450,0,672500,2000
1730,7020,1.5,0,1730,0,268000,1953
1690,3245,1.5,0,1690,0,440000,1929
2550,7200,2,2,2550,0,1.40E+06,1981
2290,11072,2,0,2290,0,590000,1986
2710,22860,1,0,1850,860,359000,1962
1880,7632,1,0,1180,700,266500,1978
2930,8679,2,0,2930,0,635000,2014
3110,217800,2,0,3110,0,559000,2001
3480,38985,2,0,3480,0,895000,1989
1110,118047,1,0,1110,0,625000,1961
2440,9320,1,0,1880,560,650000,1957
2280,7840,1,0,1280,1000,312500,1957
900,6099,1,0,790,110,225000,1944
1980,8400,1,0,1330,650,425000,1968
3360,41250,1,0,1820,1540,329999,1988
2340,9225,2,0,2340,0,572000,1973
3110,5048,2,0,3110,0,386500,2002
980,5000,1,0,980,0,452000,1904
1480,6324,1,0,1480,0,278000,1943
1800,43647,1,0,1800,0,474900,1976
2130,6574,1,0,1500,630,450000,1946
1270,5100,1,0,1100,170,611000,1900
1150,2064,2,0,1150,0,214100,2004
1840,5011,2,0,1840,0,317000,2012
3180,12528,2,1,2060,1120,1.00E+06,1979
1510,5700,2,1,1510,0,1.00E+06,1946
3070,7200,2,0,3070,0,525000,2005
1800,6680,2,0,1800,0,436000,1983
1540,9154,1,0,1540,0,450000,1983
2330,14892,1,0,1970,360,588500,1980
1400,8374,1,0,1400,0,340000,1953
2846,85377,1.5,0,1976,870,482000,2000
5830,131116,2,0,5830,0,1.58E+06,2005
3380,7126,2,0,3380,0,749000,1965
1440,7875,1,0,1440,0,330000,1968
1740,1279,3,0,1740,0,568000,2008
1470,8925,1,0,1470,0,239000,1957
2810,4932,2,0,2810,0,528000,2003
2090,5102,1,0,1350,740,385000,1994
4110,14219,2,2,2570,1540,825000,1979
3230,5000,2,1,2350,880,815000,2002
2601,34335,2,0,2601,0,625000,1995
2070,6000,1,3,1340,730,690000,1955
1660,7440,1,0,1270,390,210000,1957
1590,4280,1.5,0,1590,0,599000,1924
1860,5584,1,0,1310,550,860000,1951
1420,9600,1,0,1420,0,147200,1954
1240,5758,1.5,0,960,280,476900,1910
2500,36254,1,0,1590,910,450000,1978
2640,11816,2,0,2640,0,570000,1999
1440,3060,1.5,0,1440,0,567500,1910
3030,20446,2,2,2130,900,790000,1976
1820,12686,1,0,1820,0,875000,1952
2220,10275,2,0,1640,580,490000,1980
2430,9133,1,0,1410,1020,335000,1978
1670,10798,1,0,1670,0,550000,1962
1180,10541,1,0,940,240,385000,1981
1620,8085,1,0,1210,410,395000,1976
1030,5750,1,0,1030,0,650000,1928
2900,5803,2,0,2900,0,637000,2007
3420,9900,1,0,1710,1710,692500,1963
1710,15844,1,0,1710,0,322400,1964
1580,10517,1,0,1580,0,233500,1957
1230,11413,1,0,990,240,400000,1984
2200,4080,1.5,0,1420,780,547000,1916
2570,13054,1,1,1470,1100,519000,1950
3320,19850,1,2,2040,1280,1.03E+06,1977
1090,6435,1,0,1090,0,365000,1955
2970,36817,2,0,2970,0,699000,1978
1970,8000,1,0,1970,0,525000,1968
3220,8936,2,0,2450,770,430000,1990
1600,7500,1,0,1600,0,325000,1966
670,6300,1,0,670,0,279000,1942
2360,4750,2,0,1660,700,805000,1911
2150,3962,1.5,0,1540,610,419950,1949
620,4455,1,0,620,0,425000,1927
1730,5922,2,0,1730,0,446000,1949
2500,7860,1,0,1040,1460,455000,1963
990,4440,1,0,990,0,226550,1943
1420,4080,1.5,0,1420,0,764000,1904
2170,15000,2,0,2170,0,439950,1978
1880,5100,1,0,1880,0,453000,1952
1300,9620,1,0,1300,0,219950,1971
2360,6750,2,0,1930,430,702500,1926
1780,12231,1,0,1780,0,285000,1956
2160,2578,3,0,2160,0,798750,2005
950,5316,1,2,950,0,320000,1948
1680,14630,1.5,0,1680,0,425000,1985
2290,4450,2,0,2290,0,540000,2004
4140,14757,2,2,4140,0,1.06E+06,2005
3920,4500,3,0,3920,0,1.17E+06,2013
1500,13891,1,0,1500,0,576000,1951
1720,7200,1,0,1140,580,525000,1977
2641,8615,2,0,2641,0,324950,1998
4930,77536,2,0,3930,1000,600000,1981
2460,5400,1,0,1520,940,464000,2001
1995,7102,2,0,1995,0,266000,1981
3010,74390,2,0,3010,0,775000,1998
1270,4800,1,0,1270,0,415000,1952
3080,6731,2,3,3080,0,550000,2003
1670,7606,2,0,1670,0,235000,1990
1470,8089,1,0,1470,0,280000,1987
1730,7807,1,0,1260,470,459000,1976
1070,7615,1,0,1070,0,195000,1969
1660,8738,1,0,1080,580,235000,1959
2410,16650,1,0,2410,0,711800,1965
1040,1032,3,0,1040,0,440000,2007
970,3300,1,0,970,0,515000,1916
2910,9480,1.5,0,2910,0,1.20E+06,1939
2340,12443,1.5,0,2340,0,560000,1965
1880,11249,1,0,1330,550,340000,1985
1110,3500,1.5,0,970,140,600000,1912
2790,7938,2,0,2790,0,764000,1997
1590,8779,1,0,1590,0,337000,2001
5700,20000,1,4,2850,2850,1.39E+06,1977
1200,7552,1,0,1060,140,249000,1919
3200,35782,1,0,2360,840,350000,1978
1510,6000,1,0,1150,360,269950,1993
1880,108900,1,0,1880,0,735000,1978
3070,4000,2,0,2070,1000,1.30E+06,1940
2110,7560,2,0,2110,0,475000,1974
2350,8459,1.5,0,2350,0,339000,1989
3270,15160,1,2,1660,1610,600000,1997
2220,4760,1,0,1320,900,397500,1918
5990,111078,2,0,5990,0,1.53E+06,2004
1760,9055,2,0,1760,0,460000,1985
2200,5207,1,0,1120,1080,370000,1951
1550,7296,1.5,0,1550,0,250000,1957
5070,60123,2,0,5070,0,1.10E+06,2000
1040,1516,2,0,1040,0,430000,2008
2560,4000,1.5,0,1660,900,1.09E+06,1927
1850,8160,1,0,1850,0,670000,1952
2090,11895,1,0,1790,300,461550,1954
2010,2386,2,0,1390,620,479990,2014
2518,4663,2,0,2518,0,643000,2005
2810,12813,2,0,2040,770,607000,1988
2600,10092,1,0,2600,0,625000,1984
2060,8778,1,0,1160,900,731100,1953
2920,434728,2,3,2920,0,859000,1999
2130,10375,2,0,2130,0,435000,1986
2290,15600,1,0,1420,870,465000,1948
1230,6380,1.5,0,1230,0,740000,1927
2020,9478,1,0,2020,0,740000,1961
1430,7280,1,0,990,440,250000,1980
2270,1763,3,0,1820,450,656000,2009
1910,8058,2,0,1910,0,300000,1992
1780,214315,1,0,1780,0,643000,1954
2690,6124,2,0,2690,0,311000,2007
1330,7482,1,0,1330,0,360000,1975
3060,10043,1,0,1700,1360,475000,1968
1760,1778,3,0,1760,0,469950,2008
1570,8750,1,0,1570,0,240000,1960
960,8100,1,0,810,150,232000,1936
1680,81893,1,0,1680,0,350000,1991
1440,33747,1.5,0,1440,0,803000,1928
1960,7000,1,0,1600,360,355000,1980
1790,2250,1,2,840,950,475000,1909
2560,9825,2,0,2560,0,823000,1988
1010,3060,1,0,1010,0,395000,1918
2560,5250,2,0,1900,660,499000,1963
1200,3136,1,0,800,400,420000,1904
3910,14000,2,0,3910,0,961500,1999
2260,12238,1,0,2260,0,833000,1967
2110,11319,2,0,2110,0,479000,1978
3340,10422,2,0,3340,0,1.15E+06,1996
1400,8100,1.5,0,1400,0,267000,1944
1760,94525,1.5,0,1760,0,555000,1988
2010,9725,2,0,2010,0,490000,1987
2300,3400,1.5,0,1550,750,619000,1915
2510,28185,1,0,1600,910,569950,1963
1340,3000,2,0,1340,0,549000,1905
1560,7245,1.5,0,1560,0,422500,1962
3350,9681,1,1,2140,1210,400000,1980
3710,7984,2,0,3710,0,692500,1999
2430,5499,2,0,2430,0,310000,2002
2430,8820,1,2,1630,800,499900,1977
2100,7335,2,0,2100,0,492000,1983
1880,40575,1,0,1880,0,460000,1987
1630,2640,2,0,1630,0,800000,1919
1640,4200,1.5,0,1640,0,832600,1925
2310,7350,1,0,1670,640,470000,1989
1930,4500,1,0,1930,0,542000,2003
4750,13912,2,2,3600,1150,1.31E+06,2005
2300,7500,1,3,1650,650,308130,1959
1050,2699,1,0,1050,0,310000,2005
1500,8015,1,0,1500,0,235000,1947
1150,7560,1,0,1150,0,215000,1958
1920,10403,1,0,1370,550,210000,1959
3660,150282,2,0,3660,0,730000,1990
1720,9342,1,0,1140,580,245000,1981
2100,20018,1,4,1470,630,540000,1948
2400,6078,2,0,2400,0,299000,2001
2540,40106,2,0,2540,0,510000,1991
2080,7200,1,0,1050,1030,198000,1966
3400,7452,2,0,3400,0,950000,1999
2200,7600,2,0,2200,0,300000,1978
2140,8580,1,0,1200,940,528000,1962
3850,16249,2,2,3030,820,507000,2002
4270,6384,2,0,3060,1210,770000,2001
1340,7210,1,0,1340,0,255000,1975
1100,3451,1.5,0,1100,0,220000,1978
2870,5349,2,0,2870,0,690700,2005
1320,8380,1,0,1320,0,447000,1953
2150,4505,1,0,1270,880,755000,1952
2470,6000,1.5,0,1480,990,700000,1940
1910,7700,1,0,1000,910,250000,1980
2130,6969,2,0,2130,0,320000,2003
2240,14667,2,0,2240,0,565000,1989
1800,4500,2,0,1680,120,754300,1939
2160,9000,1,2,1400,760,650000,1949
3140,8455,2,0,3140,0,529888,2003
1920,9812,2,0,1920,0,432000,2000
1050,7670,1.5,0,1050,0,235000,1955
3695,6556,2,0,3695,0,994900,2014
3910,8442,2,0,2710,1200,489000,2000
3010,7427,2,0,3010,0,800000,2010
1370,9957,1,0,900,470,370000,1972
2080,9600,1,0,1240,840,436000,1979
2250,3757,2,0,2250,0,395000,2006
2120,8399,1,0,1320,800,377691,1942
2220,5185,2,3,2220,0,370000,2003
1440,4394,1,0,1440,0,515000,1987
910,7686,1,0,910,0,169000,1969
1270,4268,1,0,1270,0,475000,1921
2480,6180,2,0,2480,0,420000,1999
2630,9420,2,0,2510,120,1.30E+06,1900
2410,13300,2,0,1840,570,822000,1985
2930,25697,1,0,2310,620,1.50E+06,1964
1570,6810,1,0,1180,390,485000,1988
1900,8505,1,0,1200,700,270000,1956
2590,11250,1,0,1390,1200,300000,1978
3810,7728,2,0,3810,0,878000,2007
2290,4203,2,0,2290,0,590000,2001
1220,2100,2,2,1220,0,611900,1946
1100,7373,1,0,1100,0,240000,1968
2810,10951,2,0,2810,0,395000,2003
890,7110,1,0,890,0,169000,1957
1280,14972,1,0,1280,0,200500,1963
2320,7140,2,0,2320,0,308000,1990
1720,7885,2,0,1720,0,290256,1983
1530,8800,1,0,1040,490,279950,1967
1580,7875,1,0,1580,0,195000,1979
1360,13000,1,0,1360,0,630000,1945
2680,15438,2,2,2680,0,1.16E+06,1902
1640,3896,2,0,1640,0,478000,1994
2520,6690,2,2,1700,820,835000,1944
1400,2421,2,0,1400,0,639000,2005
2300,12633,2,0,2300,0,623000,1984
1900,7680,1,0,1260,640,220000,1959
2000,18099,1,0,1250,750,526000,1978
900,5016,1,0,900,0,243500,1948
2980,4930,2,0,2890,90,750000,2000
1850,9126,1,0,1850,0,329000,1963
1570,4000,1.5,0,1570,0,525000,1920
670,3101,1,0,670,0,190000,1948
2660,10800,1,0,2660,0,772650,1955
2110,4038,2,0,2110,0,355000,1989
1970,54450,1,0,1570,400,650000,1980
1210,3600,1.5,2,1210,0,678500,1910
2670,11877,2,0,2670,0,669950,1996
3000,18450,1,0,3000,0,850000,1983
2200,3885,2,0,2200,0,572000,2002
1540,13002,1,0,1200,340,492450,1984
2080,11866,1,0,2080,0,813000,1960
1780,9732,1,0,1780,0,710000,1967
1960,2400,2,0,1330,630,792500,1911
1690,7725,1.5,0,1690,0,285900,1961
2080,12972,1,0,1250,830,389000,1981
2070,2833,2,2,1490,580,675000,1966
760,33801,1,0,760,0,352000,1931
4020,11588,2,0,4020,0,1.05E+06,2000
3620,10400,1,0,1820,1800,768500,1965
2330,7778,1,0,1230,1100,500000,1961
1460,8800,1,0,1460,0,685000,1956
2250,5700,1,0,1200,1050,648475,1951
2850,6600,2,0,2850,0,655000,1994
2640,4000,2,0,1730,910,895000,1925
1310,9554,1,0,960,350,195000,1962
2720,7350,2,0,2720,0,368000,1989
3430,13609,2,0,3430,0,997000,2001
1990,19991,1,0,1340,650,335000,1977
1170,7258,1,0,1170,0,250000,1984
1390,8980,1,0,1390,0,278500,1985
1540,7300,2,0,1540,0,260000,1973
760,6141,1,0,760,0,162500,1920
1280,8316,1,0,1280,0,239000,1950
2990,5122,2,0,2990,0,600000,2004
1770,7778,2,0,1770,0,350000,1998
3830,8131,2,0,3830,0,852500,2005
2870,5490,2,0,2870,0,485000,2008
1520,8320,1,0,1520,0,299000,1953
660,6509,1,0,660,0,227450,1952
1800,5612,1,0,1200,600,383000,1942
3570,392475,1,0,2370,1200,835000,1998
3050,2992,1.5,0,1920,1130,760000,1931
820,3000,1,0,820,0,532500,1924
3610,26359,1,0,1950,1660,635000,1998
1490,3072,1,0,770,720,438500,1912
1560,9361,1.5,0,1360,200,545500,1936
1660,9549,1,0,1660,0,675000,1956
1180,4080,1,0,760,420,450000,1928
960,10815,1,0,960,0,199999,1900
1630,16170,1,0,1630,0,375000,1988
2260,43847,2,0,2260,0,600000,1982
1520,7123,1,0,1520,0,292600,1959
3050,8904,1,0,1650,1400,1.04E+06,1956
1000,4959,1,0,1000,0,610000,1945
2650,9451,2,0,2650,0,397450,1993
1750,15528,1,0,1270,480,382000,1963
1770,7667,1,0,1270,500,370000,1966
1770,7667,1,0,1270,500,520000,1966
770,7906,1,0,770,0,260000,1948
3370,7200,2,0,3370,0,890000,2014
2130,8412,1,0,1440,690,344000,1946
1050,8498,1,0,1050,0,205000,1958
2803,8550,1,0,2803,0,379000,1963
2080,12094,2,0,2080,0,424240,1982
2080,12094,2,0,2080,0,589950,1982
2120,4650,1,1,1190,930,582000,1951
2550,7709,2,0,2550,0,349000,1989
1290,12005,1,0,1290,0,658000,1966
1790,5000,1.5,0,1060,730,294000,1915
2720,7598,2,0,1860,860,690000,1993
1040,5000,1.5,2,1040,0,600000,1912
840,5200,1,0,840,0,199990,1969
1650,8850,1,0,1650,0,220000,1959
2080,15750,1,0,1460,620,440000,1976
1540,1994,2,0,1540,0,439990,2014
3880,7208,2,0,3880,0,815000,2006
1860,3766,2,0,1860,0,535000,1995
1280,10016,1,0,1280,0,215000,1975
3200,35012,1.5,0,2100,1100,605000,1965
2200,7278,2,0,2200,0,349900,1990
1570,5510,1,0,1070,500,495000,1940
2074,4900,2,0,2074,0,515100,1997
2450,55387,2,0,2450,0,620000,1994
2520,10370,2,0,2520,0,657500,1980
2190,8250,1,2,1190,1000,250000,1963
2190,8250,1,2,1190,1000,385000,1963
2320,7500,1,0,2320,0,307000,1976
1370,9253,1,0,1090,280,288000,1994
1730,7200,1.5,0,1730,0,226450,1944
1640,6991,1,0,1110,530,390000,1967
1300,10236,1,0,1300,0,350000,1971
1560,7884,1,0,1060,500,368000,1969
1120,4284,1,0,730,390,469000,1921
2670,150270,2,0,2670,0,865000,1985
3810,15916,1.5,0,3810,0,515000,1967
1440,8560,1,0,1440,0,410000,1979
1200,43560,1,0,1200,0,210000,1968
1520,7700,1,0,820,700,460000,1969
2500,9654,1,0,1830,670,241500,1979
2010,19000,2,0,2010,0,322200,1975
1210,6000,1.5,2,1210,0,279000,1943
1100,27007,1,0,1100,0,303000,1943
1050,6615,1,0,800,250,420000,1950
2120,18335,1,0,1380,740,249000,1961
1240,8840,1,0,1240,0,294950,1952
3460,3997,2,0,2560,900,1.32E+06,2004
1270,4800,1,0,1270,0,335000,1953
2980,8051,1.5,2,2020,960,1.16E+06,1935
1250,3708,1.5,0,1250,0,520000,1926
1740,8800,1,0,1740,0,560000,1965
1730,7464,2,0,1730,0,243400,1959
1240,14404,1,0,1240,0,405000,1988
1670,14695,1.5,0,1670,0,495000,1930
2140,7095,2,0,2140,0,350000,1992
2530,7601,1,0,1520,1010,368500,1992
960,8236,1,0,960,0,99000,1948
4130,12320,2,0,4130,0,1.07E+06,2001
1710,7724,1,0,1710,0,430000,1983
1490,8475,1,0,1490,0,412500,1963
4750,62365,2,0,4750,0,1.12E+06,1988
3400,35062,2,0,3400,0,915000,1988
2210,7620,2,0,2210,0,535000,1994
1650,8676,1,0,1130,520,390000,1979
1260,3135,1,0,780,480,499000,1944
1960,7955,1,0,1260,700,375000,1963
1800,7620,2,0,1800,0,349000,1995
1940,7482,1,0,1240,700,635000,1964
2820,8009,2,0,2820,0,682000,2001
2820,16770,1,0,1920,900,321027,1966
720,4120,1,0,720,0,150000,1915
1640,17583,1,0,1110,530,410000,1969
1560,4080,2,0,1560,0,449950,1923
1560,7144,1,0,1060,500,194990,1913
1910,8775,1,0,1210,700,475000,1956
1570,3000,2,0,1570,0,530000,1908
2038,7643,2,0,2038,0,319950,2011
1720,9435,1,0,1220,500,210000,1978
1670,3330,1.5,0,1670,0,485000,1925
2830,10240,2,0,2830,0,774000,1998
1690,8208,1,0,1210,480,478000,1958
1620,5280,2,0,1620,0,385000,1924
2360,43017,2,0,2360,0,595000,1989
1480,7117,1,0,1170,310,285000,1960
2700,4004,2,0,2700,0,723000,2004
1780,16000,1,0,1240,540,279000,1960
1430,7560,1,0,1430,0,195000,1958
2160,2192,1,0,1170,990,625000,1925
1800,9314,2,0,1800,0,270000,1979
1930,5520,1,0,1930,0,559000,2006
1960,14834,1,0,1330,630,474000,1976
1920,7345,2,0,1920,0,303500,1992
1470,8645,1,0,1470,0,350000,1949
2980,10064,1,0,1680,1300,367500,1940
2980,10064,1,0,1680,1300,595000,1940
2360,118483,1,0,2360,0,589000,1981
1790,87213,1,0,1790,0,585000,1974
2130,8801,1,0,1370,760,482975,1976
2030,4499,2,0,2030,0,365500,2003
1790,7800,1,0,1790,0,570000,1972
2260,8040,2,0,2260,0,335000,1990
2350,4815,1.5,0,1450,900,767500,1914
1690,1613,2,0,1150,540,386591,2014
1320,5750,1.5,0,1320,0,279000,1913
2690,32780,2,0,2690,0,620000,1998
2810,23400,1,1,1710,1100,407000,1958
2280,213879,2,0,2280,0,364250,1994
2870,9292,2,0,2540,330,399000,1979
3030,30007,1.5,0,3030,0,766950,1992
2940,4232,2,0,2940,0,710000,2004
1190,4120,1,0,1190,0,320000,1929
1800,3253,2,0,1800,0,300000,2001
1580,9187,1,0,1180,400,263000,1993
1730,4408,2,0,1730,0,445000,1996
1910,9001,1,0,1910,0,554000,1957
1000,5100,1,0,940,60,335000,1906
2520,6964,1,0,1260,1260,307000,1987
1420,8160,1,0,970,450,404000,1947
3080,5250,2,0,3080,0,775000,2003
1060,9126,1,2,1060,0,220000,1956
2160,9750,2,0,2160,0,518000,1983
4060,9486,2,0,4060,0,1.60E+06,2005
1940,2550,2,0,1100,840,315000,1979
2250,11349,2,0,2250,0,572650,1991
1620,9205,1,0,850,770,350000,1921
920,5850,1,0,920,0,285000,1900
1370,7247,2,0,1370,0,231000,1995
920,5200,1,0,920,0,179000,1969
1360,9625,1,0,1360,0,244000,1963
1630,11662,1,0,1630,0,185850,1943
3610,12033,2,0,3210,400,610000,1970
3010,9155,2,0,3010,0,419000,2005
2320,6400,1,2,1420,900,779000,1957
3290,14134,1,0,1870,1420,695000,2004
2040,7580,2,2,2040,0,319900,1998
1920,7700,1,0,1320,600,329000,1978
2120,4512,2,0,2120,0,475226,1988
2170,5000,2,0,2170,0,638000,2003
1330,15873,1,0,900,430,440000,1984
1580,5080,1,0,800,780,214000,1942
3580,14217,2,3,2210,1370,600000,1989
2580,4500,2,0,1850,730,935000,1905
1930,10210,1.5,2,1670,260,630000,1941
2120,4780,2,0,2120,0,575000,2004
1990,20466,1.5,0,1410,580,345000,1987
1310,9690,1,0,1310,0,323000,1967
2670,13218,1,0,2670,0,425000,1988
1910,108900,1,0,1010,900,411000,1972
1530,9000,1,0,1530,0,299800,1976
2920,5000,2.5,0,2780,140,823000,1908
1010,8108,1,0,1010,0,200000,1955
2450,13300,1,2,1630,820,760000,1987
1820,3899,2,0,1820,0,359950,1999
2090,8325,1,0,1470,620,375000,1983
2200,89298,1,0,1100,1100,295000,1973
2250,7882,2,0,1570,680,250000,1986
1450,1387,3,0,1450,0,497000,2000
2280,8798,2,0,2280,0,520000,1987
2720,6781,2,0,2100,620,365000,1999
2250,8000,1,0,1460,790,459900,1976
1090,6090,1,0,940,150,158000,1940
1970,9600,1,0,1300,670,294700,1967
2780,15075,2,0,2780,0,439950,1985
2290,40946,1,3,1550,740,899000,1960
2330,12141,1,0,1390,940,535000,1983
4060,10800,2,0,4060,0,530000,2007
1470,7000,1,0,1470,0,215000,1967
1620,5400,1,0,920,700,290000,1926
3220,5934,2,0,3220,0,798000,2006
3270,9578,2,0,3270,0,785000,1993
2160,8565,1,0,1730,430,433000,1971
1150,6835,1,1,1010,140,425000,1922
2240,7540,1,0,1540,700,654000,1962
1280,5065,2,0,1280,0,215000,1983
840,6540,1,0,840,0,232000,1970
1680,10500,1,0,1680,0,675000,1959
2330,8000,1,0,1550,780,665000,1972
3030,29163,2,0,3030,0,835000,1998
2880,7560,2,0,2880,0,525000,1980
2910,3094,2,2,2010,900,780000,1939
3090,67518,2,0,3090,0,844000,1988
2720,54048,2,0,2720,0,680000,1985
1310,8100,1,0,1310,0,290000,1965
1790,15783,1,0,1360,430,560000,1959
2830,6536,2,0,2830,0,605500,1989
3150,5979,2,0,3150,0,762500,2005
3930,5500,2,0,2910,1020,1.74E+06,2014
2840,8346,1,0,1420,1420,665000,1961
2480,4400,1.5,0,1640,840,540000,1919
1930,6180,1,0,1330,600,375000,1961
1260,6826,1,0,720,540,342000,1944
670,23522,1,0,670,0,340000,1968
3930,12719,2,2,2540,1390,1.25E+06,1974
3160,13063,2,0,3160,0,693000,1999
1770,12462,1,2,1770,0,638500,1962
2240,18265,2,0,2240,0,805000,1963
990,8062,1,0,990,0,250000,1960
1580,4698,2,0,1580,0,325000,1998
1560,4290,2,0,1560,0,270000,1994
2640,3680,2,0,1760,880,880000,1922
2120,6350,1,0,1440,680,300000,1924
1200,8750,1,0,1200,0,290000,1948
5040,17208,1,0,2870,2170,2.85E+06,1976
1460,5825,1,0,1260,200,259950,1942
4890,13402,2,0,4890,0,1.78E+06,2004
1580,5250,1,0,1580,0,299950,1954
2100,43560,1,0,1330,770,483000,1977
2060,8640,1,0,2060,0,890000,1966
1690,4500,1.5,1,1690,0,719000,1928
3370,100681,1,0,1920,1450,785000,1977
2330,3995,2,0,2330,0,660000,2006
1820,8118,1,0,1080,740,264000,1980
1890,11141,1,0,1890,0,575000,1968
3820,53574,1,0,3820,0,1.22E+06,1994
2770,98881,2,0,2770,0,475000,1991
3020,12750,2,0,3020,0,845800,1990
1170,8182,1,0,1170,0,352500,1962
1270,8400,1,0,1270,0,347000,1955
1950,6192,2,0,1950,0,560000,1992
2230,50094,1,2,1330,900,323000,1977
2220,22081,1.5,0,2220,0,595000,1922
2060,6400,1,0,1170,890,257500,1977
1100,4600,1,0,1100,0,450000,1917
1140,7208,1,0,900,240,410000,1970
1980,13503,1,2,1320,660,810000,1952
2480,10090,1,0,1300,1180,372500,2004
1050,9083,1,0,1050,0,325000,1951
1260,7660,1,0,1260,0,280000,1947
1680,19978,1,0,880,800,258000,1948
1360,5900,1.5,0,1360,0,329950,1949
2450,12987,1,0,2030,420,836000,1980
2260,7040,2,0,2260,0,365000,1999
1060,6000,1,0,1060,0,111300,1908
3720,105850,2,0,3720,0,864000,1984
1610,8613,1,0,1610,0,725000,1962
3350,6605,2,0,2670,680,550000,1990
790,7500,1,0,790,0,130000,1951
1660,4000,1,0,990,670,765000,1940
1420,7480,1,0,1420,0,255000,1963
2050,40003,1,0,1570,480,439500,1977
1250,5546,1,0,1250,0,268000,1987
1700,8534,1,0,1700,0,985000,1953
2660,8469,2,0,2660,0,751305,1994
1350,7553,1.5,0,1350,0,280000,1914
1810,8750,1,0,1110,700,304000,1967
2210,13235,2,0,1730,480,200000,1988
2120,41325,1,0,1420,700,325000,1973
2470,11603,2,2,1540,930,736000,1988
2700,6515,2,0,2700,0,426500,1998
1760,4400,1,0,880,880,640000,1930
1930,6120,1.5,0,1930,0,230000,1941
1680,5043,1.5,0,1680,0,366350,1911
1390,8336,1,0,910,480,365000,1946
2240,8322,2,0,2240,0,482000,1979
1980,7991,1.5,0,1980,0,345000,1962
1830,5120,1.5,2,1830,0,682000,1903
980,6002,1,0,980,0,657500,1942
3550,6533,2,0,3550,0,895000,1925
1660,5665,1,0,920,740,425000,1918
2490,8750,2,0,2040,450,532500,1976
2329,9436,2,0,2329,0,540000,1995
1790,9580,2,0,1790,0,578000,1984
2830,6041,2,3,1840,990,1.09E+06,1915
1160,9750,1,0,1160,0,322500,1968
1000,10560,1,0,1000,0,140000,1955
2540,51836,1,0,1820,720,485000,1976
1750,19709,1.5,0,1440,310,575000,1978
2890,21780,2,0,2890,0,421000,2000
1870,3497,1,0,1200,670,355000,1954
2200,6967,2,0,2200,0,515000,1986
1300,7200,1,0,1300,0,309000,1952
3410,35536,2,0,2530,880,815000,1974
1160,7875,1,0,1160,0,285000,1953
2100,5000,1.5,0,2100,0,700000,1916
1490,8628,2,0,1490,0,289000,1994
3280,62726,1.5,0,3280,0,458000,1979
1450,8378,1,0,1450,0,230000,1978
1930,7120,1,0,1420,510,432500,1961
1660,10440,1,0,1040,620,288000,1978
1260,12330,1,0,1260,0,354000,1968
1170,11000,1,0,1170,0,119500,1980
3350,23781,1,0,2020,1330,805000,1979
1420,2581,3,0,1420,0,435000,2004
2170,10018,1,0,1630,540,260000,1978
1800,8385,1,0,900,900,377000,1950
2000,7376,2,0,2000,0,602000,1990
1660,4800,1,0,960,700,530000,1941
1540,3740,1,0,770,770,525000,1946
1160,1086,2,0,890,270,250000,2006
1700,6356,1.5,0,1700,0,681000,1907
1580,20588,1,0,1580,0,625000,1970
2080,3920,2,0,2080,0,448500,2010
1030,7260,1,0,1030,0,260000,1947
1770,8050,1,0,1020,750,538000,1963
1540,7947,1,0,1120,420,385500,1961
2650,6000,2,0,2650,0,428400,2000
2690,9240,2,0,2690,0,346290,1998
2210,8430,2,0,2210,0,587000,1999
2390,6775,2,0,2390,0,355000,2003
2580,7865,1,0,1480,1100,650000,1964
2160,5455,2,0,2160,0,340000,2003
2230,8624,1,0,1430,800,565000,1969
2000,5000,1.5,0,2000,0,630000,1925
1280,7198,1,0,1280,0,227000,1916
2810,17674,1,0,1640,1170,600000,1978
1680,6758,1,0,1680,0,540400,1974
2150,8060,2,0,2150,0,569000,1995
2820,8159,2,0,2820,0,735000,2004
1750,9353,1,0,1210,540,434000,1987
1060,4000,1,0,1000,60,578888,1914
2430,20720,1,0,2430,0,465425,1967
2660,7754,1.5,0,1590,1070,280500,1986
1670,3507,1,0,1670,0,539950,2007
1380,15426,1,0,1380,0,406430,1968
4160,35000,2,0,4160,0,1.15E+06,1991
1790,6191,2,0,1790,0,250000,1992
1940,8547,1,0,1460,480,266000,1989
1390,7200,1,0,1390,0,258000,1996
2200,21890,1,2,1200,1000,472000,1961
1264,1536,2,0,1264,0,530000,2003
1095,5120,1.5,0,1095,0,302282,1901
850,6213,1,0,750,100,370000,1916
1760,5307,1.5,0,1170,590,625000,1948
690,6825,1,0,690,0,142500,1917
1400,7405,1,0,1400,0,334000,1961
1810,3000,2,0,1810,0,362000,1998
1310,4000,1,0,950,360,181000,1942
1400,10425,1,0,1400,0,241500,1968
2350,12720,1,0,1180,1170,245000,1964
1150,8848,1,0,1150,0,227500,1968
1710,8100,1.5,0,1710,0,158550,1961
1660,10247,1,0,1130,530,450000,1968
1950,10080,1,0,1950,0,485000,1967
1780,9794,1,0,1780,0,353000,1967
2450,4668,2,0,2450,0,500000,2004
2060,10600,1.5,0,1560,500,360000,1927
1540,11858,1,0,1540,0,357500,1966
1650,13816,2,0,1650,0,272000,1998
1160,7854,1,0,1160,0,422000,1960
1440,15000,1,0,1440,0,365000,1985
2150,13789,1,0,1610,540,450000,1966
1060,6504,1,0,1060,0,275053,1950
2620,17919,1,1,2620,0,1.88E+06,1949
1630,9000,1,0,960,670,725000,1955
1840,9697,1,0,1500,340,235000,1985
820,4206,1,0,820,0,510000,1949
820,4206,1,0,820,0,489950,1949
2010,4195,2,0,2010,0,463000,1998
1990,5948,2,0,1990,0,536000,1991
2990,6145,2,0,2990,0,375000,2003
2540,4727,2,0,2540,0,630000,1999
1640,14374,1,0,1140,500,362000,1963
2500,11659,1,2,1490,1010,350000,1979
4020,13515,2,0,4020,0,1.69E+06,2001
1500,8775,1,0,1390,110,255000,1943
1594,7665,1,0,1088,506,269000,1975
2130,4838,1.5,0,2130,0,370000,1930
1130,7920,1,0,1130,0,270000,1961
1690,9516,1,0,1690,0,265000,1997
1440,4046,1,0,960,480,487000,1946
3270,6027,2,0,3270,0,835000,2001
4350,112750,1,0,2200,2150,850000,2006
1610,11201,1,0,1020,590,575000,1982
950,8000,1,0,950,0,335000,1968
1010,7200,1,0,1010,0,318000,1948
1420,11325,1,0,1420,0,510000,1980
1200,9720,1,0,1200,0,242500,1965
2020,8400,1,0,1010,1010,750000,1963
3390,7950,2,2,3390,0,439900,2003
1700,3040,1.5,0,1460,240,710000,1914
3410,9088,2,3,2760,650,2.40E+06,1912
2030,13700,1,0,1630,400,435000,1976
2860,6867,1,1,1560,1300,874000,1946
1690,4080,1,0,870,820,385000,1984
760,4746,1,0,760,0,110000,1930
1780,8085,1,0,1210,570,477000,1976
1550,6394,1.5,0,1550,0,500000,1918
4090,11225,2,0,4090,0,885000,2005
880,5600,1,0,880,0,235000,1955
1320,15236,1,0,880,440,210000,1995
950,4000,1,0,950,0,320000,1910
1390,7904,1,0,1390,0,406000,1985
1900,10225,1,0,1220,680,350000,1963
1392,43710,1.5,0,1392,0,350000,1978
3340,8930,2,2,3340,0,720000,1999
2750,14982,1,3,1720,1030,604700,1981
1400,5662,1.5,0,1400,0,343000,1920
2220,15757,1,0,1280,940,558000,1982
1210,7740,1.5,0,1210,0,364000,1922
2390,11242,1,0,1290,1100,420000,1959
1870,7344,1.5,0,1870,0,450000,1960
940,5000,1,0,810,130,392000,1925
1120,2685,1,0,860,260,100000,1939
1250,1103,3,2,1250,0,480000,2005
1060,9225,1,0,1060,0,212000,1955
2410,8960,1,0,1600,810,560000,1978
2844,3990,2,0,2844,0,359950,2013
2200,110642,1,0,1330,870,535000,1979
3460,5400,2,0,2830,630,980000,2012
1580,2199,2,2,1580,0,720000,1921
1520,5400,1,0,920,600,619950,1951
2260,19821,2,0,2260,0,489000,1994
1800,2970,1,0,1000,800,415000,1923
2650,11108,2,0,2650,0,672500,1987
1000,4171,1,0,1000,0,352500,1985
2300,8400,1,0,1150,1150,258750,1962
1080,7000,1,0,1080,0,350000,1916
902,10464,1,0,902,0,152000,1965
730,7528,1,0,730,0,378500,1946
2600,41041,1.5,0,2600,0,1.02E+06,1965
1570,6700,1,0,1570,0,419000,1956
2876,13927,1,2,1970,906,895000,1973
2290,9546,1,0,1780,510,668500,1976
1470,2533,2,0,1470,0,487000,2005
2620,10137,2,0,1970,650,538000,1992
2680,28014,1,0,1450,1230,898000,1963
2020,7767,1,0,2020,0,315000,1995
2100,4440,2,4,2100,0,800000,1945
1510,8250,1,0,1510,0,516130,1962
2850,19593,1.5,4,1790,1060,1.60E+06,1978
4280,12796,2,0,3400,880,1.20E+06,1999
3238,9112,1,2,1678,1560,355425,1979
2740,5925,2,2,2740,0,1.16E+06,1913
2020,9600,2,0,2020,0,689000,1954
1520,1500,3,0,1520,0,500000,2000
3860,42733,1,3,2300,1560,430000,1955
1600,15312,1,0,1080,520,299500,1979
2090,5289,2,0,2090,0,349950,1989
4020,4500,2,0,3120,900,1.42E+06,2010
2910,10189,2,0,2910,0,998000,1988
900,9600,1,0,900,0,329000,1970
1720,5956,2,0,1720,0,575000,1981
3030,9430,2,0,2600,430,529900,1961
3030,10189,1,0,2380,650,1.47E+06,2003
2190,9400,1,0,1450,740,725000,1962
1680,5000,2,0,1680,0,286000,1987
1210,9926,1,0,1210,0,335000,1954
1120,7000,1,0,1120,0,395300,1955
3180,13348,2,0,3020,160,510000,2004
920,7500,1,0,920,0,203000,1970
700,8301,1,0,700,0,248000,1953
2540,7216,2,0,2540,0,265000,1991
2100,4560,1.5,0,2100,0,1.00E+06,1912
1540,24500,1.5,0,1540,0,1.00E+06,1949
1420,9828,1,0,1420,0,241400,1990
1450,10074,1,0,1450,0,309950,1966
1550,4057,1,0,830,720,294010,1945
1920,9672,2,0,1920,0,345000,1984
1920,9672,2,0,1920,0,625000,1984
2510,4543,2,0,2510,0,660000,2002
1660,4500,1,0,1660,0,559000,2003
3990,9786,2,0,3990,0,866000,2004
2350,5700,1.5,0,1810,540,770000,1939
1350,7827,1,0,1350,0,259950,1968
2980,9838,1,0,1710,1270,352000,1968
6390,13180,2,0,4560,1830,2.47E+06,1940
1590,10229,1,0,1590,0,395000,1966
1400,6650,1.5,0,1400,0,276500,1942
1880,100623,1.5,0,1880,0,530000,1987
3500,10260,2,0,3500,0,798000,1987
1370,5756,1,0,1370,0,380000,1986
2810,10433,2,0,2810,0,350000,2001
2220,6049,2,0,2220,0,325000,1990
2110,4549,2,0,2110,0,336000,1989
1720,17235,1,0,1440,280,286900,1974
1780,7245,1,0,1330,450,472000,1976
1410,8100,2,0,1410,0,263000,1985
2110,4000,1,2,1110,1000,565000,1965
2700,8444,2,0,2700,0,765000,1992
2610,9409,1,4,2610,0,1.52E+06,1963
1660,8174,1,0,830,830,405000,1981
4570,16219,2,0,4570,0,1.10E+06,2002
3760,188760,1,0,2640,1120,555000,1979
1610,3516,2,0,1610,0,305000,2006
1740,9370,1,0,1390,350,289950,1992
3530,218472,2,0,2380,1150,487500,1999
840,12091,1,0,840,0,96500,1959
840,12091,1,0,840,0,185000,1959
1470,6061,1.5,0,1470,0,150550,1945
2470,5080,1.5,0,1970,500,339000,1948
2220,7230,1,1,1280,940,675000,1950
1720,4080,1,0,960,760,615000,1924
2700,9320,2,0,2700,0,837500,1994
950,11835,1,0,950,0,250000,1932
1790,8144,2,0,1790,0,583000,1989
1610,1728,3,0,1610,0,499000,2000
2290,6328,2,0,2290,0,550000,2001
2170,204296,1,0,2170,0,400000,1980
2100,4097,2,0,2100,0,990400,2008
2320,52272,1.5,0,2320,0,600000,1974
1120,6236,1,0,1120,0,325000,1954
1530,6000,2,0,1530,0,265000,1991
3490,9362,1,3,1770,1720,1.62E+06,1960
1180,8353,1,0,1180,0,347500,1960
2050,3000,1.5,0,1470,580,629000,1912
2360,11340,1.5,0,2360,0,1.09E+06,1997
2570,7859,2,0,2570,0,397500,1992
1270,3700,1.5,0,1270,0,404500,1909
1250,7500,1,0,1250,0,225000,1967
2510,9900,1,0,1610,900,267000,1978
2690,4000,2,3,2120,570,800000,1909
2900,6918,2,0,2900,0,339000,2001
3830,11972,1,4,2370,1460,1.85E+06,1981
1280,3876,1.5,0,1280,0,525000,1923
4350,6218,2,2,3520,830,1.15E+06,2007
1370,6250,1.5,0,1370,0,565000,1921
1230,1280,2,0,960,270,387000,2012
2440,34290,2,0,2440,0,720000,1987
4410,12426,2,2,3420,990,1.50E+06,1996
910,7617,1,0,910,0,235000,1936
910,7617,1,0,910,0,365000,1936
2150,7484,2,0,2150,0,368250,1988
2150,7484,2,0,2150,0,580000,1988
3190,11774,2,4,2610,580,1.10E+06,1956
2130,4496,2,0,2130,0,215000,2004
2740,9959,2,0,2740,0,648000,1989
3150,9318,2,0,3150,0,705000,2001
1450,1540,2,0,1180,270,465000,2005
2400,3500,1.5,0,1900,500,650000,1911
2280,7500,1,0,1140,1140,335000,1963
2310,31850,1.5,0,2310,0,640000,1984
2460,8029,2,0,2460,0,638250,1989
4200,14353,2,2,3640,560,1.46E+06,1996
1620,4600,2,0,1620,0,375000,1909
2170,9525,1,0,2170,0,842000,1960
2880,7200,1,0,1710,1170,499950,1970
3280,25211,2,3,3280,0,810000,1985
2900,11970,2,0,2900,0,310000,1969
2160,8809,1,0,1540,620,730000,2014
2250,4750,1.5,0,1420,830,637800,1924
1340,4800,1.5,0,1340,0,225000,1903
1390,10800,1.5,0,1390,0,417500,1941
1600,10160,1,0,1600,0,265000,1972
2050,8683,2,0,2050,0,550000,1987
2570,159865,1,0,2570,0,625700,1968
2660,10637,2,0,2660,0,595000,1991
1540,13475,1,0,1540,0,270000,1972
2640,3200,2,0,2140,500,739375,1906
1210,1032,2,0,1210,0,357562,2014
3760,29224,2,0,3760,0,1.01E+06,1987
1350,4286,1,0,1350,0,455000,2004
2600,9600,1,2,1810,790,310000,1969
3900,111514,2,0,3460,440,415000,1967
1340,8100,1,2,1340,0,452000,1950
1760,16928,1,0,1760,0,810000,1953
1840,4750,1,0,1010,830,730001,1951
2980,86636,1,0,2230,750,825000,1989
1730,3000,2,0,1730,0,665000,1996
1650,7800,1,0,1650,0,327500,1968
3370,36218,2,0,3370,0,699950,1988
2200,34680,2,0,2200,0,424000,1985
2180,3375,1.5,0,1420,760,657000,1926
1490,10844,1,0,1210,280,445000,1974
1530,762,2,0,1050,480,450000,2007
1180,7455,1,0,1180,0,350000,1964
2080,17532,2,0,2080,0,460000,1996
3200,22651,1,0,1610,1590,385000,1970
1880,6160,2,0,1880,0,272000,1993
2510,5544,2,0,2510,0,535000,2001
1060,5200,1,0,1060,0,216500,1969
2130,12245,2,0,2130,0,325000,1989
1320,7280,1,0,1320,0,420200,1968
1040,5650,1,0,1040,0,258000,1951
1150,4500,1.5,0,1150,0,450000,1917
2120,3794,2,0,1420,700,720168,1926
2130,5000,1.5,0,1330,800,652000,1925
2340,8248,2,0,2340,0,569500,1989
2250,292288,1,0,2250,0,411000,1963
1890,3825,1,0,1290,600,524950,1974
1140,10152,1,0,760,380,153000,1942
2780,5467,2,2,2780,0,775000,2000
2390,6111,2,0,2390,0,338500,1997
2390,9000,1,0,1500,890,570000,1975
2680,8429,1,0,1880,800,653000,1950
1560,1222,2,0,1080,480,435000,2008
1130,8160,1,0,1130,0,207000,1952
1120,7500,1,2,1120,0,540000,1971
2050,9583,2,2,1770,280,386000,1965
2600,8075,1.5,0,2600,0,265000,1969
1050,572,2,0,740,310,250000,2006
2600,6600,2,4,1930,670,1.70E+06,1970
2811,7251,2,0,2811,0,455000,2009
4060,13000,2,3,4060,0,1.80E+06,2000
2260,7200,1,3,1130,1130,759000,1941
4430,74358,2,0,4430,0,970000,1990
600,24501,1,0,600,0,280000,1950
2430,8327,1,0,1430,1000,690000,1978
3420,25150,1,0,1750,1670,789900,1987
1180,5100,1.5,0,1180,0,447500,1926
2010,7575,1,0,1220,790,440000,1974
1230,7789,1,0,1230,0,278000,1994
2750,6000,1.5,0,1750,1000,980000,1904
1300,14197,1,0,860,440,245000,1996
1150,11475,1,0,1150,0,287000,1971
2220,132858,1,0,1110,1110,435000,1988
2050,11690,2,0,2050,0,585000,1989
1700,5846,1,0,1700,0,616000,1957
1610,9000,1,0,1100,510,203000,1978
2720,3840,2,0,1790,930,860000,1920
2190,12690,1,2,1170,1020,833000,1973
2730,6856,2,0,2730,0,565000,2003
2490,7589,2,0,2490,0,572500,1991
1510,4235,1,0,1510,0,254000,1955
4720,21000,3,4,4720,0,1.53E+06,1971
3810,217800,2,0,3810,0,900000,2003
1950,3730,2,0,1950,0,899000,1996
1300,6000,1,0,1300,0,560000,1943
1610,7200,1,0,1180,430,512500,1976
2040,5000,1.5,0,1180,860,775000,1924
700,4700,1,0,700,0,200000,1953
970,4700,1,0,720,250,172000,1943
910,6000,1,0,910,0,219900,1956
1060,9123,1,0,1060,0,641200,1952
2180,7200,2,0,2180,0,473000,1982
2050,9580,1,0,1400,650,540000,1984
750,4500,1,0,750,0,295000,1945
800,2296,1,0,800,0,370000,1908
3470,8000,1.5,1,2360,1110,1.73E+06,1906
1390,48257,1,0,1390,0,275000,1922
900,4750,1,0,900,0,89000,1969
1050,9800,1.5,0,1050,0,175000,1975
2410,11900,1,2,1600,810,490000,1989
1180,9630,2,0,1180,0,342400,1986
1140,4200,2,0,1140,0,345000,1904
700,3400,1,0,700,0,399000,1946
2060,9719,1,0,1320,740,550000,1960
2230,11835,1,0,1630,600,652450,1974
1950,29347,1,0,1350,600,438000,1953
2100,5058,1,2,1340,760,605000,1941
2130,11733,1,0,1330,800,395000,1969
1880,3048,2,0,1880,0,449950,1902
2310,5526,2,0,2310,0,651100,2003
880,6050,1,0,880,0,241000,1945
5450,20412,2,0,5450,0,3.42E+06,2014
1290,1749,1,0,660,630,268500,1969
1010,7200,1,0,1010,0,200000,1956
1690,7680,1,0,890,800,400375,1946
1350,6315,1,0,1350,0,429000,2005
680,2400,1,0,680,0,230000,1903
2860,10702,2,0,2860,0,1.20E+06,1982
610,6000,1,0,610,0,314200,1918
2660,8887,1,0,1880,780,513000,1967
1390,5346,1,0,960,430,535000,1908
2290,6344,2,0,2290,0,420000,1980
2110,4118,2,0,2110,0,345950,1989
1200,2016,1,1,600,600,483500,1931
2360,2500,2,3,1520,840,695000,2001
2350,8906,2,0,2350,0,295000,1993
1590,9960,1,0,1060,530,434975,1976
1810,4592,2,0,1810,0,513000,1992
1900,11407,1,0,1900,0,360000,1963
1250,8000,1,0,1250,0,234900,1956
3280,6603,2,0,3280,0,963000,2007
870,4800,1,0,870,0,595000,1924
3570,14408,2,2,3570,0,942500,2006
3780,11200,2,0,3780,0,1.03E+06,2002
1190,3600,1.5,0,1190,0,350000,1904
2280,39848,2,0,2280,0,416500,1991
1030,60720,1.5,0,1030,0,209900,1912
2870,5000,1.5,0,1840,1030,802000,1907
1520,8800,1,0,1520,0,230000,1960
3700,10375,2,0,3700,0,489000,1982
2240,28750,1,0,1620,620,497000,1956
1920,7738,1,0,1520,400,250000,1965
2560,3600,2,0,2110,450,925000,1994
1840,15496,2,0,1840,0,390000,1991
2080,9600,1,0,2080,0,415000,1988
1600,9638,1,0,1600,0,785000,1952
2168,4000,1.5,0,2168,0,575000,1907
860,8636,1,0,860,0,170000,1924
2100,3400,1,0,1100,1000,750000,1915
1140,9639,1,0,1140,0,230000,1967
3090,35074,2,0,3090,0,855000,1978
1330,45738,2,0,1330,0,235000,1967
1360,69260,1,0,1360,0,335000,1937
3420,18129,2,0,2540,880,1.20E+06,1952
2180,6000,1.5,0,2060,120,677000,1927
1800,5000,2,0,1600,200,575000,1925
1120,4590,1,0,1120,0,450000,1924
2980,7202,2,0,2980,0,817250,1999
2600,28600,1,0,1810,790,440000,1968
1550,2400,1.5,0,1550,0,526000,1900
3330,15258,2,0,3330,0,762500,1986
2200,7719,2,0,2200,0,325000,2000
3840,85728,2,0,3840,0,840000,1998
840,4500,1,0,840,0,377500,1939
1270,7128,1,0,1270,0,212500,1954
3240,20301,2,0,3240,0,749400,1985
2480,37843,1.5,3,2480,0,663000,1974
4470,22518,2,2,3240,1230,1.48E+06,1953
1780,7800,1,0,1060,720,261000,1957
1850,9248,2,0,1850,0,515000,1997
2200,16921,2,0,2200,0,410000,1987
2760,10160,1,0,2760,0,336000,1969
1090,4128,1,0,1090,0,440000,1948
3090,6200,2,0,3090,0,908950,2014
820,3700,1,0,820,0,554000,1968
1445,1606,2,0,1300,145,387000,2003
1810,9240,2,0,1810,0,268643,1961
1620,5000,1,0,920,700,514000,1954
1060,4182,2,0,1060,0,420000,1977
1050,9871,1,0,1050,0,199000,1968
1010,15701,1,0,1010,0,225000,1949
2050,8424,2,0,2050,0,320000,1993
970,8185,1,0,970,0,204995,1904
1540,1827,2,0,1540,0,376000,2005
3000,6222,2,0,3000,0,705000,2004
3190,7869,2,2,3190,0,725995,2001
1870,8190,1,0,1100,770,285000,1977
2200,9397,2,0,2200,0,285000,1987
3070,5936,2,0,3070,0,731000,2005
3730,17000,2,3,2820,910,1.56E+06,1986
2440,10423,1,0,2440,0,510000,1955
990,4332,1,0,990,0,620000,1909
4160,31796,2,0,4160,0,1.11E+06,1989
3670,4960,2,0,2870,800,796000,2005
910,25500,1,0,910,0,255000,1943
1940,4000,2,0,1940,0,807000,2000
1780,6000,2,0,1780,0,315000,2000
2200,7355,2,0,2200,0,637000,1986
6410,43838,2.5,2,5610,800,2.73E+06,1906
2070,10023,1,0,1220,850,490000,1981
2040,7281,1,0,1020,1020,253000,1962
2320,6270,2,0,2320,0,325900,2004
1440,6677,1,0,870,570,425000,1952
1700,6675,2,0,1700,0,215000,1997
1700,6675,2,0,1700,0,315000,1997
2050,3933,1,0,1180,870,724800,1926
800,6500,1,0,800,0,295000,1953
1800,7620,1,0,1350,450,509007,1951
1460,169448,1.5,0,1460,0,306000,1910
1290,7210,1,0,1290,0,205000,1984
1900,9737,1,0,1200,700,275000,1968
1480,7000,1,2,1480,0,685000,1963
2090,12833,1,0,1220,870,465000,1969
1950,9800,1,0,1330,620,560000,1968
1250,9605,1,0,1250,0,458500,1964
990,7590,1,0,990,0,354000,1959
2740,7923,2,0,2740,0,441000,1998
1260,10488,1,0,1110,150,194000,1952
2150,6807,2,0,2150,0,316500,1991
1750,3250,1.5,0,1230,520,524950,1929
2880,6092,2,4,1920,960,1.05E+06,1983
2590,13894,2,0,2590,0,925000,1975
2430,4524,1.5,0,1830,600,780000,1924
1470,3128,2,0,1470,0,241000,2005
2020,10744,1,0,1270,750,519000,1954
610,4000,1,0,610,0,286000,1918
3000,17800,1,0,1500,1500,400000,1962
920,43560,1,0,920,0,255000,1923
1070,7754,1,0,1070,0,152000,1953
3410,15143,2,0,3410,0,599000,1972
1820,3905,2,0,1820,0,330000,2001
1060,7193,1,0,1060,0,461000,1926
3070,34991,2,0,3070,0,620000,1995
2300,219106,1,0,1840,460,352500,1958
1610,6911,1,0,1260,350,435000,1988
2830,5310,2,0,2830,0,725000,2006
970,12300,1,0,970,0,300000,1982
1680,8284,2,0,1680,0,252000,1989
2040,8996,1,0,1260,780,464625,1974
1450,9586,2,0,1450,0,340000,1950
2870,6280,1.5,0,1980,890,1.33E+06,1905
1870,13970,1,0,1120,750,455000,1969
2490,18042,2,0,2490,0,495000,2003
3350,4501,2,0,2640,710,925000,2002
3190,8737,2,0,3190,0,587000,2006
1560,5520,1,0,780,780,524000,1944
2750,4800,2,0,1960,790,1.03E+06,1905
920,2332,1,0,920,0,176000,1980
1140,5500,1,0,1140,0,249900,1947
2520,53143,1.5,0,2520,0,499500,1988
3150,10542,1,0,1620,1530,600000,1974
2040,7800,2,0,2040,0,294000,2003
1780,19843,1,0,1780,0,272000,1963
2240,10800,2,0,2240,0,390000,1996
3270,9650,1,3,2320,950,700000,1971
3110,6621,2,0,3110,0,635000,2006
1850,3600,2,0,1660,190,920000,1929
1570,8530,1,0,1190,380,500000,1983
750,4515,1,0,750,0,263500,1942
2240,9990,2,0,2240,0,975000,1967
1870,3485,2,0,1870,0,575000,2001
2683,40386,2,0,2683,0,822000,1987
1490,7200,1,0,1490,0,300000,1954
2340,12080,2,0,2340,0,487600,1999
1700,8640,1,0,850,850,500000,1955
1450,989,3,0,1450,0,680000,2014
3310,21096,2,2,3310,0,419000,2004
1520,5250,1,0,1520,0,450000,1949
1260,4500,1.5,0,1260,0,650000,1926
1840,8086,1,0,1840,0,550000,1964
1750,5202,1,1,1070,680,330000,1942
1450,32234,1.5,0,1450,0,282510,1932
6330,13296,2,2,4900,1430,2.39E+06,2000
1260,10200,1,0,1020,240,230000,1983
2100,6613,2,0,2100,0,750000,1909
2430,5366,2,0,2430,0,321000,2002
4250,18000,2,3,3350,900,2.20E+06,1980
1830,10416,1,0,1370,460,245000,1958
1310,4000,1,0,1310,0,510000,1913
3090,9571,2,0,2370,720,751000,2004
2560,36601,2,0,2560,0,675000,1987
1930,13350,1,0,1930,0,295000,1967
1460,6000,1,0,1260,200,312000,1925
3460,13129,2,0,2560,900,730000,1988
3290,5880,2,0,2670,620,762500,2005
820,7680,1.5,0,820,0,150000,1910
1480,7374,1,0,760,720,270000,1954
1420,9301,1,0,1420,0,400000,1963
2790,6720,2,0,2790,0,650000,2002
1390,5000,1,0,970,420,530000,1954
950,9400,1,0,950,0,248000,1954
3000,5300,1,0,1780,1220,760000,1949
1280,10521,1.5,0,1280,0,199000,1960
870,8400,1,0,870,0,240000,1960
1360,1795,2,0,1360,0,415000,1945
1000,16376,1,0,1000,0,228000,1959
2740,12106,1,0,1980,760,525000,1992
1560,5223,1,0,810,750,399950,1940
2590,8571,2,0,2590,0,781000,1988
1850,1330,2.5,0,1560,290,827000,2004
2500,8621,1.5,0,2500,0,525000,1968
3280,5232,2,0,3280,0,671300,2004
670,2378,1,0,670,0,175000,1919
2890,22547,1,0,2150,740,1.10E+06,1963
3000,10560,1,0,1500,1500,800000,1966
1920,4600,2,0,1920,0,329950,2002
1960,7200,2,0,1960,0,445000,1979
2000,12208,1,0,1140,860,237000,1979
3600,6224,2,0,2610,990,1.11E+06,1945
2740,5700,2,0,2740,0,438900,2006
3650,5000,2,0,2530,1120,1.28E+06,1915
2310,3866,2,0,2310,0,600000,2005
2095,4569,2,0,2095,0,670000,2002
1560,4823,1,0,1560,0,519000,2004
1880,7350,1,0,1390,490,320000,1984
840,867,2,0,840,0,270000,2005
2730,5832,2,0,2730,0,1.00E+06,1998
860,4800,1,0,860,0,330000,1907
2320,10960,1,0,1510,810,657500,1956
1540,61419,1,0,1540,0,450000,1967
890,6488,1.5,0,890,0,150000,1928
4290,175421,2,0,4290,0,792500,2004
1950,13227,2,0,1950,0,540000,1978
1010,8848,1,0,1010,0,229900,1968
2830,6536,2,0,2830,0,533000,2003
1500,12560,1,0,1000,500,239000,1977
3370,167706,1,0,3370,0,713900,2000
3160,8726,2,0,3160,0,427500,1999
1110,7000,1.5,0,1110,0,302000,1955
3830,48743,2,0,3830,0,1.15E+06,1991
3160,4270,2,0,2650,510,555000,2006
2100,3000,2,0,2100,0,495000,1996
2240,13288,1,0,2240,0,495000,1953
1060,48292,1,2,560,500,340000,1947
2350,36116,1,0,2350,0,464950,1983
1940,7040,2,0,1940,0,320000,1998
1160,64469,1,0,1160,0,440000,2009
1840,9990,2,0,1840,0,686000,1961
2260,11000,1,0,1620,640,555000,1976
840,3860,1,0,840,0,361500,1909
2830,7500,2,0,2460,370,1.24E+06,1923
1600,10183,1,0,1600,0,154950,1966
1370,8719,1,0,1370,0,247200,1982
1960,7414,1,0,1490,470,250000,1984
1470,7200,2,0,1470,0,590300,1907
2740,8426,1,0,1370,1370,541125,1960
1090,923,2,0,1090,0,310000,2004
2460,9520,1,1,1680,780,704111,1976
1820,19602,1,0,1820,0,277500,1964
1960,8937,1,0,980,980,325000,1954
1760,7023,2,0,1760,0,289200,1995
720,5000,1,0,720,0,185000,1908
3470,8580,2,0,2500,970,1.45E+06,2007
1370,8100,1,0,1370,0,420550,1947
2370,11310,1,0,1550,820,603000,1968
1390,2640,1.5,0,1230,160,345000,1903
1840,3075,1,0,920,920,650000,1928
2790,19439,1,3,1500,1290,589950,1973
1460,1607,2,0,1460,0,309950,2007
2620,241200,1.5,0,2620,0,775000,1998
2230,5109,1.5,0,1330,900,590000,1918
3250,2760,2.5,0,2420,830,863500,1905
1190,7000,1,0,1190,0,517500,1943
2090,7440,1.5,0,1290,800,700000,1922
2580,8154,1,0,2090,490,699000,1956
2100,3574,2,0,1690,410,350000,2005
3160,16564,2,0,3160,0,795000,1987
2090,7640,1,0,1360,730,543000,1962
1570,3143,2,0,1570,0,325000,2001
1020,6000,1.5,0,1020,0,337500,1900
1300,11080,1,0,1300,0,425000,1955
2110,9773,1,0,2110,0,780000,1986
1210,17389,1,0,1210,0,259000,1948
1990,12950,1,0,1850,140,524400,1968
1630,8018,1,0,1630,0,260000,2003
1384,1822,2,0,1384,0,273000,1990
3380,75794,2,0,3380,0,639900,1997
2480,8626,2,0,2480,0,420000,2001
1270,8000,1,0,1270,0,510500,1957
1010,7200,1.5,0,1010,0,290000,1947
1490,6269,1,0,990,500,226000,1944
820,3844,1,0,820,0,300000,1916
1810,10860,1,0,1810,0,407450,1967
3060,7920,1,0,1530,1530,390000,1965
2980,20000,1,4,2130,850,1.06E+06,1965
3440,18167,2,0,3440,0,610000,1991
1820,7242,1,0,1220,600,239975,1959
2320,5760,1,0,1480,840,375000,1987
2620,4400,2,0,2620,0,742500,2004
2190,11625,1,0,2020,170,450000,1956
1780,10395,1,0,1780,0,300000,1967
2200,7700,1,0,1240,960,216600,1975
1600,6120,1.5,0,1600,0,525000,1924
2450,21000,1,2,1650,800,455000,1954
2680,35218,2,0,2680,0,390000,1986
1850,8667,1,0,880,970,450000,1982
1740,4400,1.5,0,1740,0,382000,1924
1490,9600,1,0,1170,320,287000,1987
1960,190357,1,3,1960,0,460000,1971
1380,3015,2,0,1380,0,435000,2009
1510,4032,1.5,0,1310,200,575000,1935
1410,3600,1,0,1410,0,626700,1906
1440,8680,1.5,0,1440,0,352000,1922
920,6750,1,0,920,0,650000,1951
1090,17630,1,0,1090,0,197000,1962
2790,6695,1,0,1470,1320,340000,1977
1840,14985,1,0,1840,0,560000,1968
1340,6300,1,0,1340,0,354000,1972
2570,9086,2,0,2570,0,670000,1999
3010,6202,2,0,3010,0,769000,2005
2160,3139,1,0,1080,1080,650000,1940
2140,9484,1,0,1290,850,650000,1953
2090,7416,1,0,1050,1040,289950,1970
1810,21138,1,0,1240,570,300000,1977
1760,5750,1,2,1070,690,471000,1962
2500,8540,2,0,2500,0,639000,1990
930,6900,1,2,930,0,287000,1952
3030,8335,2,0,3030,0,740000,1992
1460,3000,1,0,940,520,499922,1990
2940,14071,2,0,2940,0,675000,1986
3360,9200,2,0,3360,0,738515,2014
2110,4800,1,0,1210,900,445000,1956
2740,11343,1,2,1980,760,1.04E+06,1953
1070,2196,1,0,880,190,346000,1917
1680,4886,2,0,1180,500,450000,1940
2260,13755,1,0,2260,0,350000,1975
5860,7200,2,0,3690,2170,2.40E+06,1907
2380,35008,1,0,2380,0,594950,1977
3320,5354,2,0,3320,0,1.70E+06,2004
1050,9000,1.5,0,1050,0,219000,1984
2070,3982,2,0,2070,0,450000,2004
1790,7311,2,0,1790,0,402000,1992
840,4000,1,0,840,0,275000,1942
990,4500,1,0,990,0,421500,1948
4120,60392,2,2,3180,940,560000,1994
1620,9600,1,0,1620,0,314000,1966
1340,8190,1,0,1340,0,287000,1942
1500,5750,1.5,0,1500,0,277000,1925
1300,6731,1,0,1300,0,337500,1950
3100,10245,2,0,3100,0,792000,1999
3380,7074,2,0,2200,1180,435000,1999
2660,9030,1,0,1450,1210,313100,1977
1700,3333,1.5,0,1100,600,575000,1924
1840,7800,1,2,1240,600,510000,1972
890,5200,1,0,890,0,299950,1941
2800,5800,1,0,1580,1220,1.03E+06,1953
2010,8625,1,0,1340,670,364000,1957
1380,7470,1,0,1380,0,335000,1965
1210,8000,1,0,1210,0,219950,1954
1280,6994,1,0,1280,0,215000,1991
4090,215186,2,0,3670,420,640000,1979
1580,6300,1,0,1180,400,535000,1925
1910,7826,1,0,1140,770,253000,1973
1740,2500,2,2,1210,530,650000,1994
1130,4445,1.5,0,1130,0,672000,1930
1970,8540,1,3,1130,840,606000,1950
1780,9720,1,0,1280,500,292000,1981
1670,7757,1,0,1670,0,289950,1992
1360,9323,1,0,1360,0,257500,1968
1840,6985,1,0,1290,550,380000,1971
1255,1113,3,0,1255,0,360000,2010
1840,7412,1,0,1240,600,269500,1976
2960,6031,2,0,2960,0,449000,2005
1430,7232,1.5,0,1430,0,375000,1948
5990,10450,2,4,4050,1940,2.20E+06,2002
3480,59242,2,0,3480,0,810000,1988
4260,7861,2,0,4260,0,994000,2005
1820,10500,1,0,1080,740,275000,1979
1290,2482,2,0,1290,0,300000,2008
2130,8428,2,0,2130,0,380000,2013
1170,10051,1,0,1170,0,200000,1957
1730,1349,3,0,1350,380,635000,2009
880,5750,1,0,880,0,280000,1939
2380,6832,2,0,2380,0,574000,2002
1330,9729,1,0,1330,0,1.05E+06,1952
1780,191228,2,2,1780,0,545000,1988
1220,8400,1,0,1220,0,271950,1962
2490,24969,1,2,1540,950,630000,1959
1180,10800,1,0,1180,0,400000,1984
2310,6200,2,0,2310,0,334000,1998
1440,4855,2,0,1440,0,332500,1972
1620,1444,2,0,1080,540,525000,2007
2620,8403,2,0,2620,0,408000,1991
3710,7491,2,0,3710,0,846450,2003
1040,10323,1,0,1040,0,411100,1958
3320,11340,2,0,2480,840,409124,1999
800,5192,1,0,800,0,335950,1951
2040,9597,1,0,1240,800,480000,1963
1960,30144,1,0,980,980,280000,1957
2670,4410,2,0,2670,0,668000,1999
2930,8641,2,0,2930,0,750000,2010
830,4000,1,0,830,0,394475,1955
2290,4320,2,0,1980,310,848000,1928
2510,3600,2.5,0,2510,0,675000,1907
1280,7572,1,0,1280,0,175000,1958
1810,6000,1,1,1350,460,560000,1952
2080,13189,2,0,2080,0,538888,1987
1680,9244,2,0,1680,0,359000,1991
1660,5128,2,0,1660,0,300000,2001
1650,5994,2,0,1650,0,273000,1989
1420,1438,2,0,1280,140,670000,2003
2240,8376,1,0,1740,500,530000,1984
1230,3060,1,0,910,320,625000,1927
1260,6000,1,0,1260,0,248000,1954
2060,4812,2,0,2060,0,533000,1990
3090,10510,1,0,2190,900,549950,1991
3220,7392,1,0,2010,1210,485000,1959
2020,4845,2,0,2020,0,353500,2001
1910,12142,1,0,1910,0,435000,1976
1150,10000,1,0,1000,150,241000,1951
2730,3560,1.5,0,1550,1180,885000,1921
2890,2370,2.5,0,2290,600,799200,1906
2280,12746,1,0,1490,790,760000,1973
1040,5700,1,0,1040,0,270000,1922
2440,7475,1,0,2040,400,675000,1969
1720,5940,1,0,1000,720,499000,1977
3430,28718,1.5,0,3430,0,1.20E+06,1984
2570,4865,2,0,2570,0,320000,2005
4360,210254,1,0,2320,2040,890000,2000
2060,7350,1,0,1210,850,275000,1978
3020,8302,2,0,3020,0,490000,1994
2340,4200,1.5,0,1540,800,550000,1906
2400,9537,1,0,1210,1190,390000,1959
1610,11920,1,0,1110,500,277000,1968
1090,7647,1,0,1090,0,236000,1994
1470,13068,1,0,1470,0,265953,1975
1670,6240,1,0,1240,430,545000,1974
1850,10109,2,0,1850,0,535000,1991
3940,9671,1,4,2140,1800,1.45E+06,1967
2330,3497,2,0,1920,410,490000,2003
2020,7200,1.5,0,2020,0,319950,1954
1300,7200,1,0,1300,0,625000,1960
1180,6947,1,0,1180,0,248000,1968
1320,7840,1,0,1320,0,475000,1966
2520,9324,1,0,1320,1200,410000,1962
1680,2000,3,0,1680,0,670000,1909
2000,35438,2,0,2000,0,430000,1968
1180,4900,1,0,1180,0,313000,1954
3330,15093,2.5,0,3330,0,950000,1988
1880,5400,1.5,0,1880,0,751750,1902
2990,5280,2,0,2210,780,760000,2003
1510,12408,1,0,1510,0,310650,1969
3110,7231,2,0,3110,0,367500,1997
2150,5000,2,0,2150,0,580000,2001
1900,3960,1.5,0,1200,700,580000,1905
2720,10000,2,0,2720,0,665000,1987
1560,8280,2,0,1560,0,239950,1979
1990,30083,2,0,1990,0,470000,1998
1740,3060,1,0,950,790,733000,1930
2130,8400,1,0,1350,780,250000,1962
1510,9176,1,0,1510,0,402000,1957
2100,5107,2,0,1410,690,295000,1999
2344,8000,1,0,1560,784,355000,1976
1970,22486,1,0,1970,0,289000,1968
1470,9140,2,2,1470,0,376000,1982
940,5040,1,0,940,0,212700,1926
1780,13095,1,0,1780,0,325000,1983
2230,5743,2,0,2230,0,415000,2002
3570,15151,1,0,2400,1170,935000,1981
1920,15260,2,0,1920,0,372000,1990
1290,8366,1,0,1020,270,240000,1957
1880,16262,1,0,1880,0,334950,1980
2960,4640,2,0,2960,0,426500,2005
1840,14874,1,2,1300,540,430000,1952
1890,6183,1,0,1090,800,400000,1967
1820,6000,1,0,1120,700,455850,1964
4370,8510,2,1,3610,760,1.97E+06,2003
1530,10731,1,0,1530,0,400000,1986
1030,10480,1,0,1030,0,397500,1954
2000,1950,3,0,2000,0,755000,2005
1730,9230,1,0,1010,720,287000,1962
3620,16000,2,0,3620,0,480000,1976
2040,9622,2,0,2040,0,490000,1995
2640,6715,2,0,1680,960,365000,1991
1600,2244,2,0,1600,0,260000,2005
1480,12675,1.5,0,1480,0,505000,1929
700,4800,1,0,700,0,260000,1922
700,4800,1,0,700,0,430000,1922
3520,12193,2,0,3520,0,905000,1993
1650,6408,2,0,1650,0,440000,1977
1360,5500,1.5,0,1360,0,439500,1950
1350,6696,1,0,680,670,270000,1944
1970,6291,2,0,1970,0,306500,1998
1470,1656,2,0,1310,160,380000,2003
1610,9652,1,0,1610,0,215000,1969
810,6150,1,0,810,0,299900,1950
2820,7809,2,0,2820,0,1.45E+06,1995
1900,33888,1.5,0,1900,0,239950,1942
1830,7345,1,0,1540,290,494000,1973
1730,7700,1,0,1010,720,317500,1963
2110,7291,2,0,2110,0,670000,1977
3060,7831,2,2,3060,0,650000,2004
2620,7328,2,0,2620,0,852000,1983
1088,1360,2,0,1088,0,250000,1983
1400,10853,1,0,1400,0,264950,1964
1540,6804,1,0,1020,520,582500,1942
1540,1564,2,0,1300,240,384000,1998
2310,3360,1.5,0,1790,520,817000,1926
1730,9520,1,0,1730,0,320000,1971
2070,39446,1,0,1470,600,445800,1977
900,4500,1,0,900,0,263300,1951
860,6635,1,0,860,0,215000,1952
2980,4500,1.5,0,2070,910,842500,1921
2980,4500,1.5,0,2070,910,850000,1921
2740,12413,2,0,2740,0,386000,1990
1790,5257,2,0,1790,0,251100,1996
1750,16748,1,0,1330,420,435000,1978
3610,12811,2,0,3610,0,870000,2000
1430,20620,2,0,1430,0,800000,1954
1570,15500,1,0,1570,0,555000,1968
2280,37500,2,0,2280,0,280000,1932
940,2366,1,0,940,0,356000,1916
2920,6000,2,4,2920,0,675000,2004
2260,11900,2,0,2260,0,605000,1976
2000,4211,1.5,2,1280,720,690500,1908
1440,4225,1,0,1440,0,437000,2005
2310,13430,1.5,0,2310,0,850000,1966
2300,4600,1.5,0,1340,960,350000,1904
1490,6770,1.5,0,1490,0,480000,1926
1830,25641,2,0,1830,0,379500,1989
4440,9784,2,0,4440,0,600000,2012
4970,16582,2,3,3930,1040,1.44E+06,1992
1000,1075,2,0,840,160,303000,2007
4940,10037,1,4,3450,1490,800000,1953
1980,6000,1.5,0,1220,760,549000,1906
1560,9600,1,0,1210,350,324950,1964
870,6537,1,0,870,0,170000,1948
840,6500,1,0,840,0,178000,1969
1250,8314,1,0,1250,0,144000,1958
3120,20031,1,2,1980,1140,1.58E+06,1954
750,7000,1,0,750,0,258000,1932
710,5050,1,0,710,0,345000,1950
2290,14800,1,0,1620,670,470000,1965
3750,91681,2,4,3750,0,2.90E+06,1925
980,7790,1,0,980,0,350000,1969
1590,11276,1,0,1590,0,225500,1972
940,4000,1,0,720,220,473000,1942
1750,9623,1,0,1150,600,279000,1962
1460,8227,1,0,880,580,470000,1948
1540,4800,1,0,770,770,565000,1925
2560,6800,1,1,1380,1180,695000,1952
1660,37642,1,0,1660,0,315000,1991
1880,4499,2,0,1880,0,529000,1993
3500,101494,1.5,0,3500,0,750000,1967
1840,10500,2,0,1840,0,481500,1993
1060,7412,1,0,1060,0,211000,1987
1790,7500,1,0,1390,400,455000,1973
810,4838,1,0,810,0,238950,1938
2600,5100,2,0,1820,780,722500,2003
3230,19193,1,3,2000,1230,795000,1973
2240,9600,2,0,2240,0,327500,1971
3400,5100,2,0,3400,0,585000,2006
3140,10875,1,1,1940,1200,775000,1939
2780,4200,2,0,2780,0,645000,2001
2320,12368,1,0,1670,650,445000,1968
1370,5858,1,0,1370,0,257950,1987
2230,7560,1,0,1230,1000,375000,1959
1610,7223,2,0,1610,0,245000,1994
3410,41022,2,0,3410,0,725000,1990
2810,4922,2,0,2810,0,702000,2005
1850,14986,2,0,1850,0,330000,1943
1790,4800,1.5,0,1790,0,940000,1912
1150,11396,1.5,0,1150,0,354500,1950
2420,8700,1.5,0,2420,0,279950,1914
1580,7034,1,0,1180,400,284000,1989
1760,21562,1,1,1560,200,480000,1959
1760,21562,1,1,1560,200,647500,1959
2750,35000,2,0,2750,0,625000,1993
920,4875,1,0,920,0,152000,1978
960,10181,1,0,960,0,322000,1961
1120,4000,1,0,870,250,445000,1916
1560,3960,1.5,0,1560,0,595000,1907
1380,7334,1,0,980,400,165000,1981
1940,6206,2,0,1940,0,278500,1990
1810,10625,1,0,1370,440,517500,1973
1100,4200,1,0,1100,0,343566,1954
1980,9714,1,0,1170,810,286285,1977
1340,6200,1,0,1340,0,474905,1959
1680,4800,1,0,1400,280,550000,1960
2060,16000,2,0,2060,0,286000,1993
2620,7215,1,0,1770,850,900000,1980
1610,5159,2,0,1610,0,449950,1985
1490,7560,2,0,1490,0,259000,1966
1900,8125,1,0,1540,360,340000,1969
3440,56192,2,0,3440,0,785000,1994
1840,3300,1.5,0,1130,710,490000,1910
2330,6250,1,0,1400,930,344950,1941
2250,2975,2,0,1880,370,950000,1905
2000,3988,1,4,1000,1000,810000,1958
3010,16050,1,3,1260,1750,998160,1976
1680,7389,1,0,1150,530,377000,1979
1530,6773,1,0,1530,0,595000,1984
970,4800,1,0,970,0,313300,1911
1550,5225,1.5,0,1550,0,360000,1941
1660,7350,1,0,1660,0,188000,1979
3680,203860,1.5,0,3680,0,755000,1994
3210,4060,2,2,2290,920,1.29E+06,1917
1480,13280,2.5,0,1480,0,455000,1940
3600,9312,2,3,2680,920,817500,2005
1700,1481,3,0,1700,0,550000,2002
1680,8725,1,0,1240,440,260000,1978
1550,34175,1.5,0,1550,0,320000,1999
3780,10623,1,1,2650,1130,1.15E+06,1999
2360,7370,1,0,1460,900,362000,1985
1810,1750,2,0,1350,460,503500,1997
2290,3475,2,0,2290,0,653000,2006
3370,12447,2,0,3370,0,760000,1991
2090,5050,1,0,1090,1000,775000,1916
2130,34689,1.5,4,2130,0,1.34E+06,1955
2060,10911,1,0,1360,700,417500,1954
1560,9350,1,0,1220,340,525000,1969
730,2400,1,1,730,0,217000,1934
2910,6308,1,0,1640,1270,525000,1985
2490,8700,1,0,1890,600,442500,1976
1710,10440,1,0,1710,0,525000,1955
1520,10630,1,0,1520,0,425500,1967
2930,218235,2,2,2930,0,710000,1990
3160,10948,1,3,1930,1230,545000,1991
2910,16410,1.5,0,2910,0,410000,1967
1700,8100,1,0,1200,500,245000,1980
810,6697,1,0,810,0,194900,1923
2000,5390,2,0,2000,0,284000,2003
1894,52769,1.5,0,1520,374,280000,1936
2080,87991,1,0,1040,1040,280000,1970
1730,5500,1,0,1010,720,360000,1943
720,4323,1,0,720,0,405000,1942
3560,13981,2,0,3560,0,865000,2000
1210,11100,1,0,1210,0,483300,1955
2130,9268,2,0,2130,0,355000,1985
1570,8767,1,0,1180,390,274950,1990
3950,6134,2,3,2880,1070,1.93E+06,1998
3450,15586,2,0,2690,760,755000,1989
7220,223462,2,4,6220,1000,1.94E+06,2000
1150,9600,1,0,1150,0,309212,1979
1500,7615,1,0,1150,350,219950,1984
1300,5150,1.5,0,1300,0,690000,1920
1290,4000,1,0,1170,120,250800,1943
2510,35255,1,2,2510,0,557500,1994
2320,3825,1.5,0,1820,500,941000,1926
5480,19401,1.5,4,3910,1570,3.65E+06,1936
2030,8600,1,0,1230,800,305000,1977
2060,16110,1,0,2060,0,815000,1949
2920,34527,1,4,1800,1120,1.02E+06,1954
3330,6990,1.5,3,2330,1000,1.24E+06,1928
2110,8164,2,0,2110,0,535000,1990
1175,10454,1,0,1175,0,775000,1949
1590,8670,1,0,1590,0,255000,1994
1070,9750,1,0,1070,0,327000,1947
2720,8819,2,3,2240,480,560000,1976
2980,6349,2,3,2980,0,1.34E+06,1998
1160,5200,1,0,1160,0,199500,1977
3580,97574,2,0,3580,0,760000,2004
3020,6000,3,2,1980,1040,439000,1994
2380,5250,1,0,1410,970,527000,1961
2270,13590,1.5,0,1300,970,199950,1948
1660,8188,2,0,1660,0,254000,1988
830,5000,1,0,830,0,393000,1921
2480,12614,1,0,1860,620,585000,1979
1900,7740,1,0,1150,750,450000,1923
1670,4008,1,0,1670,0,565000,2005
2000,7900,1,0,1300,700,330000,1986
2320,65340,1.5,0,2320,0,870000,1992
1860,8117,1,0,1460,400,585000,1966
2110,208737,2,3,2110,0,500000,1977
1400,7384,1,0,1150,250,225000,1979
1400,7384,1,0,1150,250,295000,1979
2850,14800,1,0,1920,930,775000,1976
1370,11050,1,0,1370,0,280000,1981
2170,3200,1.5,0,1280,890,539000,1923
2570,14033,1,2,2570,0,567500,1953
1970,7902,1,0,1310,660,442500,1960
2980,4635,3,0,2980,0,598200,1997
2300,10843,2,0,2300,0,610000,1955
1990,4936,2,0,1990,0,544900,2004
2390,38258,2,0,2390,0,557500,2001
2160,7500,1,1,1430,730,532500,1979
3300,15907,2,0,3300,0,1.35E+06,1985
1840,2825,1,0,1040,800,750000,1920
2030,10958,2,0,2030,0,530000,1983
1400,2036,2,0,1400,0,346100,2003
2320,16800,2,0,2320,0,260000,1977
1410,9150,1,0,1410,0,365000,1959
1860,42800,1,0,930,930,615000,1983
1820,6916,2,0,1820,0,318400,1994
1910,7172,2,0,1910,0,498500,1993
1540,7490,1,0,1540,0,450000,1971
1430,7905,1,0,1430,0,200000,1988
1010,8906,1,0,1010,0,234000,1968
940,8384,1,0,940,0,121800,1947
2600,5875,1.5,2,1600,1000,805000,1929
2060,7283,1,0,1220,840,410000,1963
1920,4534,2,0,1920,0,475000,1986
2900,21074,2,0,2900,0,1.34E+06,1986
1020,7920,1,0,1020,0,269000,1947
2150,9520,2,0,2150,0,573000,1979
1660,2890,2,0,1660,0,330000,2001
1230,7410,1.5,0,1230,0,252750,1944
2170,7546,1,0,2170,0,745000,2007
1280,7633,1,0,1280,0,280000,1991
2240,6920,1,0,1380,860,535000,1974
1780,5100,1,0,1320,460,580000,1953
1840,7200,1,0,1220,620,301000,1968
1740,7700,1,0,1740,0,600000,1968
3040,6604,2,0,3040,0,538900,2005
2370,4375,2,0,2370,0,366000,2006
2100,6783,2,0,2100,0,303000,2003
1470,1578,2,0,1090,380,432000,2007
1300,6120,1,0,820,480,300000,1945
3420,7826,2,0,2430,990,908800,1939
1190,4750,1,0,970,220,500000,1940
2080,16117,1,0,1740,340,254000,1959
2180,4268,1.5,0,1340,840,470000,1924
1460,7860,1,0,1460,0,480000,1967
1530,8503,1,0,1150,380,536000,1983
4740,8611,2,3,3640,1100,1.35E+06,2006
1980,40887,1,0,1980,0,550000,1980
1710,6400,1,0,1240,470,260000,1976
1160,982,2,0,890,270,284900,2006
2200,3000,2,0,1530,670,740000,2002
1170,5000,1,0,1030,140,425000,1920
1120,7500,1,0,1120,0,230000,1965
1710,4000,2,0,1710,0,675000,1926
1650,7807,1,0,1650,0,267500,1986
2840,8820,1,2,1420,1420,814000,1952
3310,217800,1.5,0,3310,0,1.25E+06,1989
1860,7232,1,0,1320,540,460000,1985
2250,9608,2,0,2250,0,445000,1994
2890,7027,2,0,2890,0,715000,2004
2120,5992,1,0,1060,1060,425000,1947
2130,4750,2,0,2130,0,370000,2009
1170,8200,1,0,780,390,302000,1937
2120,7420,1,0,1060,1060,453000,1956
1280,10716,1,0,1280,0,290000,1969
3170,47502,2,0,3170,0,1.04E+06,1988
2260,41984,1,0,2260,0,925000,1967
2930,19876,1,0,2030,900,600000,1993
1060,5750,1,2,1060,0,354000,1981
1740,9344,1,0,1180,560,204950,1978
2990,5400,2,0,2990,0,675000,2005
3530,20012,2,0,3530,0,995000,1986
2960,10960,1,0,1500,1460,800000,1957
1650,3711,2,0,1650,0,472500,1996
2720,13500,1,0,1510,1210,549950,1969
1516,2897,1,0,998,518,575575,1925
4386,12275,1,0,2356,2030,545000,2006
2580,7434,1,0,1630,950,340000,1963
960,5512,1,0,960,0,225000,1963
1460,10506,1,0,1460,0,299950,1983
3840,4000,2,0,2640,1200,829900,2001
2090,4200,2,0,2090,0,340000,2007
2470,7800,1,0,1470,1000,515000,1975
2090,6906,2,0,2090,0,601000,1992
2070,8581,2,0,2070,0,470000,1994
1650,6400,1,0,980,670,371500,1954
1880,45738,1,0,1410,470,550000,1980
2060,7720,2,0,2060,0,242550,1995
1410,9647,1,0,1410,0,367500,1961
2770,8763,2,0,2100,670,359000,1996
1390,8245,1,0,1390,0,204900,1984
5440,239580,1,0,2720,2720,850000,1969
1280,4452,2,0,1280,0,187000,1985
1720,28000,1,0,1720,0,326000,1958
1720,28000,1,0,1720,0,340000,1958
3040,28535,1,0,1890,1150,330000,1951
3780,7769,2,0,3110,670,782000,2001
2670,5974,2,0,2670,0,612000,1999
1350,7216,1,0,1350,0,400000,1964
3490,9680,2,4,2460,1030,941500,1980
870,747,2,0,800,70,313000,2004
2410,4250,1.5,0,1460,950,735000,1929
1640,10123,1,0,1340,300,471000,1977
1540,9800,1,0,1540,0,350000,1950
2370,9601,1,0,1570,800,530000,1976
1830,9548,2,0,1830,0,415000,1991
2330,8994,2,0,2330,0,639500,1986
2240,27820,1.5,0,2240,0,580379,1976
1700,2513,2,0,1700,0,378000,2009
1750,9298,1,0,1410,340,265000,1969
1100,9750,1,0,1100,0,212000,1967
2320,13068,2,2,2320,0,400000,1998
2540,6491,2,0,2540,0,750000,1997
3090,12750,1,0,1750,1340,384900,1968
770,5200,1,0,770,0,176000,1969
2370,4632,2,0,2370,0,350000,2002
1200,7210,1,0,1200,0,168000,1977
2200,3060,1,0,1100,1100,358000,1908
2660,32757,1,0,2660,0,580000,1975
1600,10280,1,0,1050,550,442500,1977
1330,1249,3,0,1330,0,515000,2004
3440,12900,1,2,1720,1720,554000,1958
2510,6320,2,0,2510,0,659000,1996
2150,10098,1,0,1090,1060,414999,1963
1180,10277,1,0,1180,0,275000,1983
680,8640,1,0,680,0,193000,1951
2840,4750,2,0,2840,0,525000,2002
1820,7500,2,0,1820,0,424000,1985
1070,5150,1,0,870,200,455000,1908
1250,5650,2,1,1250,0,463000,1943
2190,6300,1,3,1240,950,1.10E+06,1960
3000,5413,2,0,1900,1100,523000,1963
2270,9830,1,0,2270,0,615000,1959
4500,11795,2,0,4500,0,1.52E+06,1991
3400,5000,2,0,2320,1080,870000,1900
2830,9680,2,0,2830,0,710000,1991
960,9563,1,0,960,0,215000,1967
1530,6450,1,0,1530,0,590000,1920
2500,13034,1,0,1300,1200,323000,1962
1560,7569,1.5,0,1560,0,279000,1966
2070,7207,1,0,1720,350,535100,1973
2710,19800,1,0,1910,800,830000,1959
3150,4203,2,0,3150,0,815000,2002
1880,10880,1,0,1480,400,535900,1975
1250,8800,1,0,1250,0,230000,1955
2290,8142,1,0,1490,800,325500,1969
1990,4331,2,0,1990,0,359000,1997
2100,5824,2,2,2100,0,505000,1999
940,8400,1,0,940,0,253905,1958
1640,4860,1,0,1200,440,369950,1965
1860,8378,2,0,1860,0,350000,1995
2100,2500,3,0,2100,0,650000,2001
1500,15246,1,0,1500,0,295000,1925
1680,28046,1,3,1180,500,620000,1948
3900,920423,2,0,3900,0,2.00E+06,2009
1400,7410,1,0,1400,0,246000,1944
2600,12860,1,0,1350,1250,430000,1965
1440,4859,2,0,1440,0,509990,1921
1870,9500,1,0,1090,780,490000,1962
2960,10454,1,1,2360,600,385000,1979
2440,6733,2,0,2440,0,769000,1999
1122,9100,1,0,1122,0,185000,1960
1060,10464,1,0,1060,0,303500,1973
2150,8165,1,0,1430,720,468000,1957
3100,10000,2,0,3100,0,449950,1978
880,1805,2,0,880,0,235000,1999
2490,34947,2,0,2150,340,520000,1985
1080,9067,1,0,1080,0,203000,1951
2530,10190,1,0,1290,1240,657000,1960
1200,7800,1,0,1200,0,275000,1954
2850,7453,2,0,2850,0,540000,1991
2950,4502,2,0,2950,0,455000,2005
1160,6828,1,0,860,300,458500,1941
3420,4751,2,0,3420,0,549900,2003
2240,10578,2,0,1550,690,750000,1923
1450,8891,1.5,0,1180,270,235000,1962
1820,7930,2,0,1820,0,286000,1989
4700,13730,2,3,3500,1200,2.65E+06,1958
2430,14000,1,0,1580,850,602000,1963
1960,4080,1.5,0,1960,0,640000,1915
1440,10920,1,0,1440,0,267000,1977
2730,4385,2,0,2730,0,712000,2001
910,9000,1,0,910,0,244500,1923
910,9000,1,0,910,0,301000,1923
2430,6325,2,0,2020,410,990000,1919
3350,6500,2,0,3350,0,739999,1999
2320,4322,1,0,1140,1180,480000,1910
1260,1622,3,0,1260,0,305000,2009
1980,3525,1.5,0,1590,390,703300,1932
1580,8468,2,0,1580,0,265000,1971
2710,35009,2,2,2710,0,600000,1992
1400,9750,1,0,1400,0,253000,1968
2410,7950,2,0,2410,0,617950,1997
1790,2460,2,0,1100,690,385000,2000
1640,9234,1,0,1060,580,319000,1967
1670,8023,1,0,1170,500,696000,1960
970,5750,1,0,970,0,345000,1932
1610,1778,3,0,1610,0,380000,2002
2060,26036,1,0,1160,900,647500,1947
3570,35271,2,0,3570,0,725000,1997
1400,7735,1,0,1400,0,269950,1989
3470,32109,2,0,3470,0,875000,1995
1210,9525,1,0,1210,0,299950,1955
3930,10929,2,0,3930,0,1.88E+06,2006
990,4802,1,0,990,0,430000,1947
2200,4942,2,0,2200,0,495000,1989
1510,16200,1,0,1510,0,275000,1970
1620,5040,1,0,1120,500,333000,1964
1580,7941,2,0,1580,0,247000,1986
1260,15000,1.5,0,1260,0,204555,1983
2190,13673,1,0,2190,0,432000,1994
1230,13056,1,0,1230,0,175000,1962
2030,7140,1,0,1400,630,556300,1968
780,3475,1,0,780,0,286000,1930
1110,1200,3,0,1110,0,320000,2000
2790,53143,2,0,2790,0,815000,1991
1660,10757,1,0,1000,660,385000,1980
3410,5000,2,0,2190,1220,1.04E+06,1910
2390,13002,2,0,2390,0,350000,1987
1850,5880,2,0,1850,0,277000,1998
2500,5200,1,0,1250,1250,415000,1966
1000,8320,1,0,1000,0,295000,1951
2450,5000,2,4,2200,250,969000,1919
1440,6144,1,0,720,720,339888,1947
1660,7003,2,0,1660,0,269950,1996
2510,4600,2,2,2510,0,1.19E+06,2006
3090,12511,2,0,3090,0,780000,1998
860,5185,1,0,860,0,198000,1968
1220,28703,1,0,1220,0,350000,1953
1010,7680,1,0,1010,0,350000,1967
2390,7350,2,0,2390,0,319000,1990
3340,8000,2,0,3340,0,311000,1973
3620,4650,2,0,2790,830,394000,2004
4200,5800,2.5,0,2910,1290,1.34E+06,1906
3831,13800,2,4,3831,0,2.70E+06,1959
1980,9540,1,0,1080,900,396000,1949
1790,8372,1,0,1340,450,809000,1976
1580,7400,1,0,1050,530,480000,1977
2460,6000,1,0,1230,1230,535000,1913
2110,5120,2,0,1870,240,425000,1947
1470,1204,3,0,1470,0,408000,2006
3510,13100,2,0,3510,0,1.26E+06,1966
520,2885,1,0,520,0,310000,1947
1950,7421,2,0,1950,0,292000,1996
770,9715,1,0,770,0,217000,1942
2250,6064,2,0,2250,0,398500,2005
4040,7200,1.5,2,3340,700,2.25E+06,1930
2360,6000,1,0,1280,1080,700000,1955
2330,45860,2,0,2330,0,585000,1989
1720,8910,1,0,1720,0,399950,1954
1900,8540,1,0,950,950,235000,1980
1040,6800,1,0,1040,0,212000,1951
2070,9195,1,0,1220,850,310000,1982
2070,9195,1,0,1220,850,539000,1982
1550,1608,2,0,1280,270,390000,2001
2020,11935,1,0,2020,0,560000,1976
3320,9024,2,0,3320,0,800000,1999
4130,112521,2,0,4130,0,1.90E+06,1978
2030,9804,1,0,1110,920,472000,1963
1770,7875,1,0,1170,600,502550,1958
3330,7809,2,0,3330,0,830000,2004
2260,9686,1,0,1520,740,224950,1965
1950,6871,2,0,1950,0,375000,1997
2930,19900,1.5,0,2930,0,645000,1983
1960,2500,1.5,0,1410,550,599000,1926
2980,12534,2,0,2980,0,515000,1996
780,6685,1,0,780,0,135000,1948
1650,4218,2,0,1650,0,485000,2000
4030,12765,2,0,2800,1230,890000,1975
1010,10125,1,0,1010,0,215000,1972
1190,9600,1,0,1190,0,299500,1981
1050,8750,1,0,1050,0,800000,1951
1560,4244,2,0,1560,0,275000,2002
1490,7800,1,0,1010,480,256400,1963
770,8149,1,0,770,0,310000,1948
620,5100,1,0,620,0,385000,1954
1200,9120,1,0,1000,200,203000,1963
2120,6865,1,0,1060,1060,285000,1954
2330,3610,2,0,2330,0,473975,1999
2000,9760,1,0,1400,600,320000,1978
2820,4608,1,0,1450,1370,599000,1967
2040,4800,1,0,1020,1020,580000,1925
1700,7056,2,0,1700,0,269500,1999
820,6200,1,0,820,0,274000,1954
1315,2162,2,0,1315,0,347000,1974
1390,10905,1,0,860,530,270000,1957
1890,12017,1,2,1890,0,1.43E+06,1949
1460,7226,1,0,1460,0,220000,1993
1480,15416,1,2,1480,0,243000,1955
1840,4030,1,0,1050,790,457500,1925
1880,7208,1,0,940,940,340000,1951
1910,5000,1.5,0,1610,300,657500,1912
2220,4720,2,0,2220,0,332500,1998
1410,10015,1,3,1410,0,340000,1993
3380,16133,1,1,2330,1050,350000,1959
1950,5602,1,0,1120,830,428000,1966
2400,8320,2,0,2400,0,515055,1999
1560,8968,1,0,1560,0,450000,1972
1040,8910,1,0,1040,0,190000,1943
3090,16538,3,0,2590,500,1.00E+06,1919
1850,4600,2,0,1850,0,299000,2005
1200,2500,2,2,1090,110,508000,1927
2190,3746,2,0,2190,0,294000,2005
1380,5820,1,0,1380,0,320000,1918
3710,8674,2,0,3710,0,641000,1996
2320,98445,1,0,1380,940,675000,1978
1110,10296,1,0,1110,0,255000,1964
1830,4997,2,0,1830,0,286651,2004
2460,45738,1,0,1650,810,607500,1969
1270,6500,1,0,1270,0,765000,1956
1700,40973,1,0,1700,0,334950,1961
1130,9147,1,0,1130,0,426000,1952
1640,18730,1.5,0,1640,0,775000,1946
1040,8526,1,0,1040,0,343000,1953
2320,7800,2,0,2320,0,470101,1986
1200,7800,1,0,1200,0,195000,1958
1720,4410,1.5,2,1720,0,772500,1928
2330,11740,1,0,1330,1000,450000,1954
4410,9231,3,3,4410,0,1.44E+06,2001
1650,8560,1,0,1650,0,525000,1970
1370,11400,2,0,1370,0,280000,1980
1770,8640,1,0,1420,350,270000,1986
1410,1332,3,0,1410,0,406100,2005
1710,4187,1,0,1710,0,332544,1987
790,8250,1,0,790,0,110000,1947
2770,5854,1.5,0,2120,650,685000,1921
1260,8505,1.5,0,1260,0,461000,1951
2300,8067,1,0,1300,1000,615000,1979
1070,3000,1,0,870,200,550000,1926
3850,8100,2,1,2430,1420,1.06E+06,1995
2320,219978,2,0,2320,0,685000,1993
2870,16238,2,0,2870,0,1.56E+06,1962
1830,5175,2,0,1830,0,312000,2003
1990,9594,1,0,1190,800,507500,1977
1110,9827,1,0,1110,0,217000,1966
1830,13477,1,3,1170,660,439000,1981
3600,6875,2,0,2740,860,620000,2004
3210,8532,2,0,3210,0,915000,1998
1490,5300,1,0,1110,380,425000,1977
990,5643,1,0,870,120,435000,1947
1646,12414,2,0,1646,0,305000,1996
720,4000,1,0,720,0,276000,1918
2310,7200,2,0,2310,0,327500,1990
2670,10481,2,0,2670,0,810000,2003
3060,9055,2,0,2460,600,715000,1994
1380,11760,1,0,1380,0,272000,1963
700,5559,1,0,700,0,266000,1949
1710,8364,2,2,1710,0,543000,1944
1450,8064,1,0,1450,0,400000,1984
2060,9000,1,0,1320,740,509500,1961
2380,6250,2,3,1670,710,495000,1997
2760,5564,2,0,2760,0,424950,2001
940,10875,1,0,940,0,230000,1957
1760,6150,1.5,0,1760,0,235000,1951
1360,8752,1,2,1360,0,763000,1942
2010,6150,2,0,2010,0,350000,1939
2160,2260,2,2,1620,540,900000,1917
930,6060,1,0,930,0,250000,1973
1020,2040,2,0,720,300,225000,2004
1360,5433,1,0,1360,0,255000,1974
1720,7200,1,0,1220,500,161700,1974
1790,13350,1,0,1190,600,336000,1988
1150,6800,1,0,1150,0,410500,1954
2710,14016,2,0,2710,0,502700,1968
2400,9601,1,0,1390,1010,505000,1977
1660,7650,1.5,0,1350,310,250000,1910
1660,7650,1.5,0,1350,310,570000,1910
2290,8796,2,0,2290,0,349900,1994
2870,25663,2,0,2870,0,465000,1988
4240,25639,2,3,3550,690,625000,1989
1800,5102,1,0,1170,630,655000,1952
2960,11347,1,0,1570,1390,469000,1946
1980,7200,1,0,1300,680,355000,1964
1730,2631,2,0,1730,0,596000,2001
3020,36893,2,0,3020,0,790000,1986
4470,86225,2,0,4470,0,885000,1991
2830,4000,2,0,1910,920,1.03E+06,1912
2120,5400,1,0,1060,1060,710000,1941
2150,9266,2,0,2150,0,428040,1988
3510,13843,1,2,1850,1660,1.37E+06,1959
970,3400,1,0,970,0,546000,1924
1360,5766,1.5,0,1360,0,540000,1951
1470,3000,1,0,930,540,435000,1985
3040,10283,1,0,1430,1610,540000,1984
860,7204,1,0,860,0,284000,1918
820,5700,1,0,820,0,208000,1942
1900,7076,1,0,1130,770,315000,1977
1330,5510,1,0,850,480,417500,1910
1240,38095,1,0,1240,0,345000,1978
1330,1064,3,0,1330,0,375000,2004
1880,12821,1,0,1880,0,389800,1959
1890,7560,1,0,1430,460,475000,1973
2250,41688,2,0,2250,0,569000,1980
4650,108464,2,0,3260,1390,985000,1999
1830,8022,2,0,1830,0,532000,1987
720,5000,1,0,720,0,280000,1951
1960,50112,1,0,1050,910,435000,1963
1220,71191,1,0,1220,0,223000,1952
1800,119790,1,0,1200,600,390000,1947
1340,12800,1,0,880,460,315000,1981
1740,3700,1,0,1740,0,612000,1982
1680,2400,1,0,870,810,591000,1922
3220,8436,2,0,3220,0,800000,1968
1610,8400,1,0,1610,0,225000,1990
3160,66646,2,0,3160,0,589900,1993
2520,13156,1,0,1520,1000,565000,1979
2120,8448,1,0,1060,1060,650000,1940
2090,8505,2,0,2090,0,499000,1951
1330,20562,1.5,0,1330,0,280000,1959
2420,7500,1,2,1210,1210,649950,1944
1510,6360,1,0,1510,0,420000,1954
2120,5293,2,0,2120,0,319990,2003
1850,16535,1,0,1850,0,265000,1992
2300,16474,1,0,1220,1080,482000,1984
2600,14810,1,2,1490,1110,452000,1956
5180,13077,2,3,4280,900,1.49E+06,1998
1810,8527,1.5,0,1810,0,375000,1943
2190,4900,2,0,1490,700,588000,1940
2500,10215,2,0,2500,0,635000,1998
1890,6962,2,0,1890,0,280500,1997
2040,8600,1,0,1430,610,210500,1985
1310,7000,1,0,1310,0,196500,1979
4010,8510,2,1,2850,1160,1.40E+06,1971
1780,8033,1,0,1210,570,475000,1977
1980,9061,2,0,1980,0,550000,1987
3690,7200,2,0,3690,0,1.58E+06,2007
1540,6687,1,0,1200,340,240000,1991
1130,8100,1.5,0,1130,0,272000,1934
2480,209199,1.5,0,1870,610,408506,2000
2580,7500,2,0,2580,0,640000,1991
2010,7226,2,0,2010,0,316000,1995
2320,12000,1,0,1720,600,299000,1943
1180,2090,2,0,1180,0,447500,2004
3180,21904,2,3,3180,0,736500,2000
2970,52567,2,0,2970,0,665000,1924
3050,13212,1,0,1590,1460,707000,1975
1630,8000,1,0,1630,0,215000,1959
1620,6415,2,0,1620,0,275000,1989
2170,8240,2,1,2170,0,648000,1983
2150,8173,2,0,2150,0,415000,1987
1770,1800,3,0,1770,0,690000,1999
2110,13260,1,0,1290,820,320000,1979
1590,8285,1,0,1590,0,750000,1956
1370,1524,3,0,1370,0,355000,2005
1390,7399,1,0,1390,0,246000,1975
1640,10464,1,2,1640,0,1.16E+06,1968
2670,12187,2,0,2670,0,744000,1986
5400,24740,2,0,5400,0,1.21E+06,1997
1690,6750,1,0,1210,480,217000,1977
2600,5100,2,1,2600,0,583000,1998
1400,5000,1,0,1150,250,515000,1904
2140,8000,1,0,1410,730,594000,1965
1640,5650,1,0,1640,0,303100,1952
1720,15225,1,0,1020,700,430000,1970
3060,11778,2,0,3060,0,708000,2004
1150,7260,1,0,1150,0,221000,1959
2000,7205,2,0,2000,0,325000,1998
4810,28008,2,0,4810,0,1.30E+06,1990
1560,5950,1,0,780,780,385000,1944
2070,4689,2,0,2070,0,359500,2013
1920,7200,1,0,1300,620,433000,1984
1000,4950,1,0,800,200,525000,1948
1690,10062,1,2,940,750,356200,1928
3090,87120,1,0,1590,1500,595000,1974
1790,3420,1,0,1020,770,560000,1923
4750,21701,1.5,0,4750,0,2.18E+06,1976
2090,4000,1,0,1480,610,513000,1951
680,2550,1,0,680,0,365000,1901
2100,11942,1,0,1030,1070,368000,1964
2840,4000,1.5,0,1960,880,870000,1912
1470,6808,1,0,1160,310,225000,1984
4490,24767,2,2,3800,690,1.39E+06,1998
1150,8079,1,0,1150,0,177000,1983
1460,9879,1,0,1460,0,465000,1956
3150,6343,1,3,1810,1340,750000,1976
1090,2800,1,0,1090,0,149000,1969
2670,47480,2,3,2670,0,605000,1981
2110,5800,1.5,0,1990,120,725000,1927
1770,5236,2,0,1770,0,413900,2007
1510,6600,1,0,1510,0,199950,1938
530,13679,1,0,530,0,400000,1949
2420,5000,2,0,2200,220,870000,1925
2490,7666,1,0,1490,1000,292000,1989
990,8012,1,0,990,0,225000,1966
1730,9139,2,0,1730,0,466750,1957
1440,11954,1,0,1440,0,330000,1978
3260,8145,2,0,3260,0,770000,1967
1950,7000,1,1,1450,500,802500,1957
2740,5400,2,0,2740,0,378800,2005
2940,12487,2,0,2940,0,795000,1997
1200,7320,1,0,1200,0,460000,1955
2070,10908,2,0,2070,0,567000,1986
1570,15570,1,0,1570,0,209950,1981
1050,60113,1,0,1050,0,415000,1943
1830,6985,1,0,1080,750,424500,1967
970,12500,1,0,970,0,261000,1941
2200,9696,2,0,2200,0,365000,1987
1930,3240,1.5,0,1930,0,631000,1911
7050,42840,1,2,4320,2730,3.80E+06,1978
1790,3962,2,0,1790,0,584000,1992
1560,82328,1,0,1560,0,310000,1974
2780,7985,2,0,2780,0,717000,1992
1720,8100,2,0,1720,0,667000,1907
1640,8100,1,0,1040,600,190000,1939
1730,9000,1,0,1370,360,430000,1978
740,7380,1,0,740,0,213000,1951
2280,3710,1,0,1550,730,475000,1990
2090,23962,2,3,2090,0,649000,1988
2550,13458,2,0,2550,0,715000,1990
3350,19487,1,0,2460,890,845000,1992
2770,8820,1,0,1900,870,390000,1980
2860,5724,1,0,1730,1130,390000,1983
1990,7194,1,0,1400,590,328000,1978
1740,8436,1,0,1140,600,239999,1967
1460,7740,1,0,1460,0,225000,1968
3670,11884,1,2,1950,1720,920000,1979
3270,9231,2,0,3270,0,940000,1995
1210,4872,1,0,1210,0,465000,1949
1770,7000,1,0,1770,0,241000,1986
1980,5909,2,0,1980,0,307550,2003
2650,9627,1,3,1610,1040,490000,1976
3040,6887,2,0,3040,0,647000,1999
3640,231739,1.5,0,3640,0,780000,1999
1810,4332,2,0,1810,0,517500,1992
1380,8682,1,0,1380,0,295000,1966
1810,3400,2,0,1810,0,560000,1926
2250,5472,1.5,0,1750,500,319450,1930
3860,7199,2,1,2870,990,1.50E+06,2005
2380,20277,1,0,1500,880,340000,1999
1370,11658,1,0,1370,0,249950,1958
1830,3000,1.5,0,1430,400,499950,1926
1440,13296,1,0,1440,0,1.04E+06,1967
2510,17200,1,2,1540,970,750000,1977
3230,256132,2,0,3230,0,875000,2006
1670,7210,1,0,1670,0,678000,1967
780,4200,1,0,780,0,360000,1920
1720,16552,1,0,1720,0,354900,1971
2260,10087,1,0,1520,740,632000,1967
1480,9375,1,0,1480,0,350000,1957
2550,3900,2,2,2050,500,990000,1940
3920,881654,3,3,3920,0,1.65E+06,2002
2286,8269,2,0,2286,0,481000,2002
1500,5412,1,0,900,600,485000,1920
1740,4960,2,0,1740,0,477000,1992
2880,9000,1,0,1440,1440,560000,1966
2600,9350,1,0,1340,1260,600000,1963
3320,23760,2,0,2190,1130,622500,1975
1660,2128,2,0,1660,0,410000,1974
1990,3644,2,0,1990,0,318200,2010
1680,8424,1,0,1680,0,289000,1993
1570,7775,2,0,1570,0,263000,1982
1150,4825,1,0,1150,0,240000,1957
1270,7500,1,0,1270,0,281500,1953
1890,1710,2,0,1640,250,587206,1999
1350,1248,2,0,1180,170,482000,2000
1650,9500,1,0,1650,0,485000,1967
1450,11480,2,0,1450,0,309000,1990
1640,7350,1,0,1140,500,221000,1984
2030,8398,2,0,2030,0,700000,1975
2420,7740,1,0,1360,1060,411500,1929
2770,10505,2,0,2770,0,285000,1940
1980,7931,1,0,1160,820,395000,1983
1460,7926,1,0,1460,0,237950,1987
1610,8064,1,2,1160,450,680000,1981
1010,10057,1,0,1010,0,199950,1961
2760,4000,2,2,2000,760,765000,1926
1060,4960,1,0,1060,0,515000,1926
1510,8000,1,0,1510,0,470000,1956
880,4000,1,0,780,100,330000,1937
2150,9375,1,0,1550,600,284000,1968
1660,8125,1,0,1150,510,295000,1999
2160,10987,1,0,1440,720,555000,1981
1370,8162,1.5,0,1370,0,350000,1949
1460,5818,1,0,1140,320,240000,1986
1450,7000,1,0,1450,0,419900,1955
1560,6300,1,0,1560,0,528000,1924
2480,9869,1,0,1240,1240,481000,1963
740,5995,1,0,740,0,304700,1949
2927,12171,2,0,2927,0,715000,1998
2260,12005,1,0,2260,0,738950,1956
1240,9405,1,0,1240,0,215000,1966
2040,10812,1,0,2040,0,300000,1943
1270,8100,1,0,880,390,346000,1950
4370,37193,2,3,2780,1590,473000,1996
1700,6120,1,0,1700,0,500000,1952
1300,7632,1,2,1300,0,750000,1943
1820,9350,1,0,1820,0,519900,1967
880,6171,1,0,880,0,378500,1949
1870,12381,1,0,1870,0,314500,1957
1350,9315,1,0,1350,0,499950,1968
4870,7700,2.5,3,3650,1220,1.74E+06,1929
2460,38794,2,0,2460,0,630000,1999
1720,6417,1,0,1720,0,360000,1953
2730,19877,1,0,1570,1160,460000,1976
1100,4046,1.5,4,1100,0,361000,1922
1810,9845,1,0,1810,0,713400,1959
930,3150,1,0,930,0,445000,1918
1590,131551,1,3,1590,0,305000,1966
2710,9204,1.5,4,1480,1230,1.43E+06,1975
1460,8400,1,0,1460,0,222000,1962
3400,4499,2,0,2740,660,510000,2005
2920,11440,2,0,2920,0,500000,2003
910,3600,1,0,910,0,605000,1909
1320,10720,2,0,1320,0,393000,1981
2490,5170,2,0,2490,0,725000,2000
2220,11646,1,0,1270,950,320000,1950
1130,7840,1,0,1130,0,210000,1970
2750,5767,2,0,2750,0,419900,2005
2240,4447,2,0,2240,0,410000,2006
2680,10440,1,1,1540,1140,721000,1963
1270,5500,1.5,0,1270,0,605000,1921
1520,5500,1.5,0,1520,0,738000,1936
2480,12000,2,0,2480,0,725000,1972
960,20954,1,0,960,0,255000,1977
1340,873,3,0,1340,0,303000,2009
1090,7700,1,0,1090,0,394950,1957
2240,5580,2,0,1830,410,530000,1949
3740,8700,1,0,2260,1480,475000,2004
1800,8100,2,0,1800,0,250000,1998
780,3540,1,0,780,0,180000,1920
1330,4140,1,0,930,400,443500,1919
1900,76877,1,0,1900,0,390000,2004
1570,7650,1,0,1100,470,430000,1975
3100,7260,2,0,3100,0,460000,1963
2740,3785,2,0,2190,550,660000,2001
1570,10939,1,0,1200,370,515000,1974
1330,6490,1,0,1330,0,482500,1954
1140,2980,2,0,1140,0,305000,1988
1550,4000,1.5,0,1550,0,835000,1930
1290,7952,1,0,1290,0,237000,1998
1510,2001,2,0,1510,0,445000,1985
2720,8000,1,0,1360,1360,710000,1955
840,5700,1,0,840,0,180000,1945
1850,8770,2,0,1850,0,280017,1996
2290,11173,2,0,2290,0,436500,1988
3200,7535,2,0,3200,0,1.26E+06,2006
1800,9800,1,0,1300,500,420000,1959
860,7467,1,0,860,0,205000,1944
1980,10203,1,0,1680,300,570000,1946
2140,7102,1,0,1070,1070,565000,1948
2410,7500,1,0,1550,860,287000,1978
1650,7276,1,0,1010,640,260000,1977
1650,7276,1,0,1010,640,470000,1977
2410,9916,2,0,2410,0,700000,1989
1520,7500,1,0,1520,0,249000,1985
2050,3520,1,0,1070,980,568000,1977
1720,4011,1.5,0,1720,0,500000,1904
2390,8775,1,0,1270,1120,358000,1980
1680,6755,2,0,1680,0,225000,1994
1060,7246,1,0,1060,0,275500,1981
1860,3150,2,0,1860,0,495000,2001
1750,5000,1,0,960,790,758800,1940
1480,8165,1,0,1480,0,280000,1985
1900,7361,2,0,1900,0,380500,1994
6210,8856,2.5,2,4760,1450,3.20E+06,1910
1440,12888,1,2,1090,350,260000,1958
1910,1502,3,0,1910,0,630000,2014
2010,4000,1,0,1210,800,875000,1915
960,4600,1.5,0,960,0,457500,1927
1240,5500,1,0,1240,0,900000,1954
870,6450,1,0,740,130,235000,1954
1400,45738,2,0,1400,0,410000,1981
1850,9600,1,0,1230,620,355000,1981
4270,6002,2,3,3180,1090,1.30E+06,2004
2260,8512,1,0,1130,1130,467500,1948
2690,7350,1.5,0,2690,0,500000,1949
2780,9550,2,4,2530,250,995000,1978
1140,8144,1,0,1140,0,277000,1956
2900,9680,2,0,1990,910,630000,1947
2830,11795,1,0,1710,1120,628000,1960
2560,46786,2,0,2560,0,655000,1995
1240,9900,1,0,940,300,170000,1950
2100,10750,1,2,2100,0,352500,1967
3120,34040,2,0,3120,0,615000,1997
970,6600,1,0,970,0,165000,1965
2300,15188,2,0,2300,0,243500,1966
950,676,2,0,850,100,304000,2003
2110,5195,1,0,1210,900,369000,1959
2990,4298,2,0,2990,0,779950,2014
2940,48788,1,0,1520,1420,605000,1961
1860,8709,2,0,1860,0,292500,1994
1820,6050,1,0,910,910,500007,1950
1950,4947,2,0,1950,0,449999,2000
1890,7867,2,0,1890,0,355000,1996
2710,7199,1,0,1710,1000,258000,1967
2150,20181,1,0,1090,1060,380000,1963
3720,57499,1,0,1880,1840,650000,2003
2580,11780,2,0,2580,0,456500,2003
1540,10212,1.5,0,1540,0,259950,1948
1050,6600,1.5,0,1050,0,123000,1964
1210,1250,3,0,1210,0,520000,2014
2040,12000,1,0,1300,740,506000,1963
980,4800,1.5,0,980,0,425000,1926
1990,6840,2,0,1990,0,438000,1974
2420,18480,1,0,2420,0,1.49E+06,1967
1240,3000,1,0,1040,200,375000,1908
1530,6600,1,0,1240,290,337500,1968
2080,7700,1,0,1450,630,300000,1968
3570,5425,2,0,3570,0,627000,2005
4230,6907,2,0,3450,780,1.40E+06,2008
2700,10160,2,0,2700,0,674725,1988
2200,7000,1,0,1280,920,325000,1977
1210,12538,2,0,1210,0,230000,1982
2140,43124,1,2,1220,920,485000,1962
2740,8400,1.5,2,2740,0,315000,1993
1370,1193,3,0,1370,0,560000,2003
2800,7198,2,0,2800,0,444000,2002
1060,7488,1,0,1060,0,325000,1977
790,7153,1,0,790,0,118125,1944
790,7153,1,0,790,0,212000,1944
2820,5056,2,0,2820,0,428900,2006
1850,9600,1,0,1850,0,510000,1968
1110,9762,1,0,1110,0,416000,1963
3230,438213,2,0,3230,0,950000,1999
1460,7140,1,0,980,480,204000,1980
12050,27600,2.5,3,8570,3480,7.70E+06,1910
3480,13421,2,0,3480,0,878000,1995
3560,4000,3,2,2970,590,1.05E+06,1996
840,5551,1,0,840,0,350000,1952
1820,5500,1,0,1620,200,659500,1957
1630,15200,1,0,1120,510,395000,1988
1920,8562,2,2,1920,0,308950,1994
1750,2550,1,0,1750,0,410000,1955
2750,7500,1,0,1630,1120,710000,1966
620,8685,1,0,620,0,175000,1976
1720,10098,1,0,1140,580,508800,1981
1800,5000,1.5,2,1500,300,606400,1929
1300,7958,1,0,1300,0,245100,1996
1970,14876,1,0,1320,650,540000,1981
1740,9046,1,0,1740,0,415000,1956
1930,13041,1,0,1180,750,469500,1980
1190,14777,1,0,1190,0,195000,1965
4250,12281,2,4,3020,1230,1.62E+06,1996
4360,24603,2,0,4360,0,1.45E+06,1998
3420,16622,1,4,2410,1010,1.20E+06,1991
4260,9800,2,0,4260,0,1.07E+06,2008
920,10000,1,0,920,0,555500,1981
1040,4000,1,0,1040,0,440000,1950
1260,7250,1,2,960,300,485000,1940
2460,12028,2,0,2460,0,693000,1996
830,3386,1,0,830,0,295000,1942
2060,10650,1,0,1050,1010,700000,1976
2210,9374,1,3,1560,650,767500,1951
5480,189050,2,0,5140,340,800000,1991
1860,217800,2,2,1860,0,440000,1998
1350,187313,1,0,1350,0,600000,1997
2790,5450,2,0,1930,860,1.16E+06,1925
1570,8210,1,0,1150,420,506000,1952
2030,15400,1,1,1130,900,474950,1975
2570,5500,1,0,1320,1250,654000,1961
1210,6000,1,0,1000,210,710000,1942
1530,7845,1,0,1030,500,620000,1981
1510,10827,2,0,1510,0,390000,1984
1720,9600,1,0,1220,500,550000,1967
2190,7021,1,2,1390,800,353000,1953
3030,47958,1,0,1660,1370,465000,1980
1410,6600,1,0,1410,0,279900,1990
1679,577605,2,0,1679,0,700000,2001
1980,10350,1,0,1430,550,395000,1968
1900,9428,2,0,1900,0,375000,1978
1720,2800,1.5,0,1200,520,547000,1926
2480,10277,2,0,1640,840,525000,1993
1210,4731,1.5,0,1210,0,285000,1901
1540,4025,1,0,1190,350,570000,1908
2740,9168,2,0,2740,0,409000,1991
1811,4381,2,0,1811,0,260000,2007
2720,7697,1,0,2120,600,348000,1987
1520,9800,1.5,0,1520,0,389000,1971
2160,7200,1,0,1220,940,445000,1976
1390,4602,1,0,930,460,400000,1981
1740,7895,2,0,1740,0,302000,1999
2849,9588,2,0,2849,0,798000,2001
1440,8842,1,0,840,600,335000,1950
3000,6892,2,0,3000,0,585000,2005
3330,24354,1,0,3330,0,2.50E+06,1961
1720,2300,1,0,860,860,555000,1940
3920,13085,2,4,3920,0,3.10E+06,1996
1500,3060,2,0,1500,0,295000,1994
2050,7100,1,0,1050,1000,265000,1963
1180,7275,1,0,1180,0,330000,1965
1600,5750,2,0,1600,0,286000,1902
1260,895,3,0,1160,100,305000,2009
1290,5376,1,0,1290,0,970000,1945
2680,14157,1,0,1460,1220,525000,1966
2370,9750,1,0,1280,1090,355000,1979
2310,8303,1,0,1300,1010,469950,1975
1450,8800,1,0,1450,0,435000,1954
2680,7700,2,0,2680,0,363500,1990
1030,4500,1,0,830,200,595000,1924
1320,11090,1,0,1320,0,275000,1955
670,7952,1,0,670,0,295000,1942
2670,37089,2,0,2670,0,345000,1990
2440,47916,2,0,2090,350,485000,1991
3370,8113,2,0,3370,0,1.25E+06,2005
940,5413,1,0,940,0,340500,1923
1100,5132,1,0,840,260,280000,1948
2520,78408,2,0,2520,0,449888,1988
1400,4720,1,0,820,580,483000,1927
1880,9360,1,0,940,940,445500,1941
2800,7350,2,0,2800,0,379900,1995
2500,3080,2,0,1810,690,599950,2008
810,5240,1,0,810,0,215000,1942
1720,6847,2,0,1720,0,263000,1987
2170,12100,1,0,2170,0,565000,1961
4530,258746,1.5,0,3200,1330,950000,2003
1440,8320,1.5,0,1440,0,395000,1946
2850,4100,2,3,1820,1030,1.54E+06,1908
2620,14126,1,4,1620,1000,922000,1941
1676,18778,2,0,1676,0,330000,1997
5850,35070,2,0,4410,1440,1.53E+06,1990
1910,8329,1,0,1910,0,323000,2004
1670,4996,1,0,1670,0,554000,2004
2050,11454,1,0,2050,0,500000,1987
3730,16679,1,0,2760,970,775000,1990
1800,5210,1,0,1080,720,340000,1979
2230,6838,1,0,1320,910,560000,1985
1670,5298,2,0,1670,0,304000,2002
1400,10800,1,0,1400,0,279900,1962
2110,10766,2,0,2110,0,315000,2005
2160,6300,1.5,1,2160,0,849000,1928
2420,14862,1,0,1380,1040,325000,1977
3320,8808,2,0,3320,0,786000,2005
3220,8160,2,0,3220,0,384000,1999
1340,6000,1.5,1,1340,0,907000,1927
2490,23891,2,0,2490,0,700000,1993
1640,8395,1,0,1640,0,269500,1991
1420,7297,1,0,1130,290,269000,1984
3340,123600,2,0,3340,0,749950,2005
1580,4007,2,0,1580,0,325000,2001
2170,16600,1,2,1130,1040,1.15E+06,1979
1370,7853,1,0,1370,0,406000,1962
2840,9354,2,0,2840,0,650000,1990
1940,7500,1.5,0,1940,0,295000,1918
1757,19370,1,2,1757,0,375000,1955
980,5100,1,0,980,0,395000,1907
2470,9267,2,0,2470,0,609000,1982
1610,11950,1,2,1210,400,510000,1984
1590,11745,1,0,1090,500,190000,1978
780,1033,1,0,780,0,250000,1922
720,7450,1,1,720,0,295000,1924
1630,4080,1.5,0,1630,0,740000,1927
1590,7759,2,0,1590,0,323000,1912
2310,1850,2,0,2020,290,713000,2011
2320,6090,2,3,2040,280,1.07E+06,1939
1660,9900,2,0,1660,0,460000,1978
2070,5000,1.5,0,2070,0,880000,1920
2500,7000,1,0,1250,1250,585000,1947
940,8532,1,0,940,0,249950,1959
1990,3478,2,0,1520,470,450000,1990
2620,14096,2,0,2620,0,450000,1989
3730,7071,3,2,3730,0,1.78E+06,1985
1600,1298,3,0,1600,0,350000,1999
2095,3438,2,0,2095,0,292500,2008
4230,31747,2,0,4230,0,879000,1985
3200,7500,1.5,1,1860,1340,1.18E+06,1948
2050,17859,1,0,1300,750,584999,1967
2020,8093,1,0,1300,720,366000,1961
3270,15760,1,0,2000,1270,987500,1974
1320,7200,1,0,1320,0,300000,1959
1270,7800,1,0,890,380,299000,1981
1980,2700,1.5,0,1210,770,560000,1931
2620,51354,2,0,2620,0,695000,1998
1750,18810,1,0,1220,530,360000,1977
1040,8892,1,0,800,240,183500,1958
1900,3000,1.5,0,1070,830,311000,1903
1660,7210,1,0,1660,0,263000,1977
1530,7930,1,0,1530,0,269000,1986
4280,9583,2,0,4280,0,1.60E+06,2005
2870,6658,2,0,2870,0,564000,2004
2540,5612,2,0,2540,0,425000,1999
2100,4480,1.5,0,1780,320,679000,1928
1740,9300,1,0,1740,0,410000,1952
2441,7316,2,0,2441,0,340000,2007
1810,7200,1,0,1030,780,360000,1959
2060,44866,1,0,2060,0,450000,1953
3160,8429,1,3,1620,1540,552000,1982
2930,12840,1.5,0,2930,0,294000,1965
1310,5200,1,0,910,400,663500,1946
4800,9097,2,0,3580,1220,1.98E+06,2007
1450,5530,1,0,1450,0,175409,1969
1900,9077,2,0,1900,0,459000,1954
1050,5402,1.5,0,1050,0,339950,1906
1610,15246,1,0,1610,0,393000,1936
720,11400,1,0,720,0,275500,1951
1020,9835,1,0,1020,0,485000,1955
1250,7920,1,0,1250,0,250000,1960
3200,8049,1,0,2700,500,935100,1980
990,9599,1,0,990,0,245000,1959
2850,25993,2,0,2850,0,670000,1989
4240,21578,2,0,3500,740,1.39E+06,1994
2800,49149,1,0,1400,1400,440000,1978
2310,3313,2,0,2310,0,1.25E+06,2006
1490,8000,1,0,1200,290,203000,1978
1840,4011,2,0,1840,0,583000,2005
1740,9163,1,0,1740,0,575000,1954
3280,3800,2,0,2880,400,2.58E+06,2011
4050,20925,2,3,3020,1030,1.60E+06,1973
2160,8755,2,0,2160,0,312500,1993
2720,31314,3,2,2720,0,455000,1986
3650,16600,1,3,1860,1790,1.31E+06,1978
1750,6120,1,0,1150,600,605000,1962
2450,49658,1,0,1770,680,325000,1978
1940,7306,1,0,1470,470,630000,1982
3280,6000,2,0,3280,0,928950,2014
2480,10804,1,0,1800,680,489950,1976
2120,18255,1,0,1590,530,550000,1984
1710,7920,1,0,1260,450,237000,1968
1690,10113,1,0,1310,380,390000,1991
2190,10370,2,0,2190,0,665000,1987
1960,5160,1,0,1170,790,277000,2001
1510,5000,1.5,0,1510,0,545000,1909
1490,1410,2,0,1300,190,615000,2008
2210,7920,1,0,1400,810,343000,1966
2340,7877,2,0,2340,0,597000,2004
940,19000,1,0,940,0,600000,1945
1470,6018,1,0,1470,0,479000,1987
1650,14633,1,0,1650,0,292000,1958
1400,6527,1,0,1110,290,265000,1957
2710,49044,2,0,2710,0,623000,1988
2150,39449,1,0,1420,730,486000,1978
1900,8100,1,0,950,950,520500,1940
4380,74052,1,0,4380,0,1.30E+06,2001
2290,6300,1.5,4,2150,140,825000,1921
1690,7953,1,0,1690,0,259900,1986
3090,12031,1,0,1600,1490,1.17E+06,1968
1120,5650,1,1,720,400,245000,1904
2680,4990,1,0,1440,1240,830200,1951
2400,7351,2,0,2400,0,650000,1990
1610,6250,1,0,1610,0,305000,1952
3470,12003,2,0,3470,0,599000,1978
2070,6175,2,0,2070,0,272000,1993
2420,10733,2,0,2420,0,415000,1996
2380,7400,1,0,1760,620,319000,1979
2120,15920,1,0,1060,1060,425000,1960
2190,8100,1,0,1250,940,297500,1978
2740,12899,2,0,2740,0,725000,1990
1830,7585,2,0,1830,0,325000,1995
1370,8467,1,0,970,400,460000,1972
1000,10800,1,0,1000,0,396480,1959
2050,4800,2,0,1950,100,1.03E+06,1922
1750,9166,1,0,1170,580,370000,1979
1620,13803,1,0,1620,0,260656,1969
1710,12677,2,0,1710,0,431000,1996
1060,5000,1,0,1060,0,320000,1958
2170,7900,1,0,1380,790,296500,1978
3080,8451,1,0,1540,1540,679000,1969
1320,1071,2,0,1080,240,359000,2003
1920,12040,1,0,1920,0,330000,1962
2440,4000,2,0,2440,0,350000,2009
1640,8922,1,0,1640,0,242000,1963
2420,198198,2,0,2420,0,692500,1997
1190,3400,1,0,990,200,441000,1919
2910,15016,2,0,2910,0,765000,1990
1010,4050,1,0,1010,0,375000,1950
2080,7800,1,0,1220,860,365000,1955
1990,6000,1,0,1430,560,580000,1944
3920,19088,1,1,2240,1680,1.61E+06,2005
3080,13870,2,0,3080,0,841000,1981
2670,11761,1,0,1370,1300,515000,1981
4320,107157,1,0,2160,2160,565000,1967
1200,6380,1,0,1200,0,365000,1929
1640,7222,2,0,1640,0,295000,1908
870,5750,1,0,870,0,406500,1947
2410,7225,2,0,2410,0,614905,1991
2640,14959,1,0,1770,870,1.40E+06,1929
990,10556,2,0,990,0,250000,1981
1500,3978,2,0,1500,0,549000,1929
1790,6590,2,0,1790,0,397000,2005
1490,10125,1,0,1490,0,184000,1962
3960,16224,2,2,3100,860,2.50E+06,1938
1620,5108,1,0,1620,0,499100,1954
2270,6010,1,0,1290,980,676101,1954
1150,8145,1,0,990,160,290000,1932
2180,7560,1,0,1560,620,390000,1962
910,4500,1,0,910,0,465000,1948
2770,54707,1.5,0,2370,400,470000,1938
940,7590,1,0,940,0,435000,1959
2410,8944,1,0,1860,550,415000,1967
1010,2820,1.5,0,1010,0,450000,1905
2120,196995,1,1,2120,0,645000,1997
1530,6375,2,0,1530,0,231000,1942
1810,100188,1,0,1810,0,358000,1969
1040,11900,1,0,1040,0,330000,1972
1160,1848,2,0,1160,0,229950,1972
1430,8137,1,0,1130,300,403250,1934
2280,6134,2,0,2280,0,470000,2004
1200,7810,1,0,1200,0,239000,1967
2480,6000,1,0,1520,960,579000,1955
1270,1348,3,0,1270,0,380500,2003
2730,6401,2,0,2730,0,614285,2015
1340,1635,2,0,1340,0,376000,2003
1240,9300,1,0,1240,0,290000,1954
2400,7000,1,0,1800,600,487000,1965
1220,7489,2,0,1220,0,935000,1903
2163,5882,2,0,2163,0,255000,2006
1860,3504,2,0,1860,0,380000,2000
810,4368,1,0,810,0,450000,1958
1950,7481,2,0,1950,0,622000,1987
1390,6004,2,0,1390,0,292500,1993
2120,3600,2,3,1830,290,1.32E+06,1908
1510,3240,1,0,870,640,410000,1901
1010,5355,1,0,1010,0,160000,1950
1840,4337,2,0,1840,0,809000,1917
1650,5453,1,0,1650,0,183750,1970
2860,12293,1,0,1430,1430,411000,1947
2650,5512,2,0,2250,400,1.05E+06,1984
1100,4160,1,0,1100,0,625000,1919
1646,9519,2,0,1646,0,305000,1994
5250,48352,2,0,5250,0,915000,1998
1390,8300,1,0,1390,0,317000,1974
780,6380,1,0,780,0,165000,1947
1490,6000,1,0,1090,400,575000,1946
970,7742,1,0,970,0,219900,1967
3730,7200,2,0,2810,920,1.49E+06,2006
1090,9900,1,0,1090,0,300000,1955
1940,219527,1,0,1940,0,520000,1991
1780,8820,1,0,1480,300,310000,1966
1190,6445,1,0,1190,0,322500,1996
2000,10374,2,1,2000,0,320000,1967
1390,4997,2,0,1390,0,440000,2004
1500,4500,1,0,1120,380,578000,1938
1070,877,3,0,1070,0,382000,2005
1720,4006,2,0,1720,0,535000,1994
3680,7236,2,0,3680,0,679000,2006
1400,10436,1,0,1040,360,258900,1985
1730,9509,2,0,1270,460,563000,1955
2795,15101,2,0,2795,0,562000,1996
2000,3750,1,0,1120,880,725000,1950
1830,8372,2,0,1830,0,236775,1987
3380,8098,1,1,1690,1690,860000,1952
1500,6337,1,0,1500,0,270000,1953
1950,6930,1,2,1250,700,621000,1960
2490,5928,2,2,2490,0,527900,1998
1780,10748,2,0,1780,0,395000,1964
1110,10500,1,0,1110,0,320000,1978
2500,4750,2,0,2500,0,300000,2003
1480,7225,1,0,1480,0,320000,1965
2570,47480,1,0,2570,0,625000,1979
810,5060,1,0,810,0,505000,1941
2700,10814,1,0,1560,1140,300000,1966
2180,9281,2,0,2180,0,363000,2004
4330,15335,2,0,3230,1100,1.70E+06,1988
4210,10308,2,0,4210,0,1.15E+06,2006
2880,9202,1,0,1780,1100,680000,1977
2610,4080,2,0,1750,860,678940,1909
2010,8065,1,0,1090,920,299000,1984
1500,11600,1,0,1000,500,379900,1955
1290,6566,1,0,1290,0,205000,1976
1320,4440,1.5,0,1320,0,387500,1929
1290,4720,1,0,790,500,256000,1948
2440,11005,2,0,2440,0,548000,1994
1290,4811,1,0,1290,0,163000,1996
1030,600,2,0,680,350,367500,2004
1640,2875,2,0,1240,400,390000,1983
1160,16008,1,0,1160,0,415000,1989
2230,8440,2,0,2230,0,449000,1968
1910,12264,1,0,1010,900,460000,1963
1980,15354,1,0,1980,0,395000,1977
1470,16500,1,0,1470,0,300000,1961
1520,7439,1,0,1520,0,345000,1969
1930,8442,1,0,1930,0,825000,1953
1330,2180,3,0,1330,0,539950,2014
1580,9581,1,0,1580,0,410000,1953
1370,6000,1,0,1370,0,245000,1955
3010,15750,1,0,1560,1450,482000,1973
1390,9000,1,0,1390,0,270000,1978
1330,14560,1,0,1330,0,475000,1983
1320,6500,1,0,1320,0,445800,1947
2430,11670,1,0,1330,1100,518000,1978
1260,4800,1.5,2,1080,180,785000,1942
1690,1310,2,0,1140,550,430000,2004
3420,7200,1,3,1770,1650,715000,1947
2790,6900,1,2,1700,1090,560000,1955
1270,6600,1.5,0,1270,0,449000,1903
2910,9000,2,0,2910,0,805000,1989
1560,5845,2,0,1560,0,296000,2003
770,4840,1,0,770,0,275000,1927
1770,16909,1,0,1770,0,419950,1977
1100,1307,2,0,780,320,285000,2008
2890,8470,2,0,2890,0,775000,1996
2110,15400,1,0,1380,730,288250,1963
1220,2268,1,0,610,610,257000,1909
950,10585,1.5,0,950,0,377000,1929
1420,3100,1,0,820,600,550000,1924
1100,4128,1,0,720,380,339000,1942
2140,6000,1,0,1070,1070,481500,1948
1300,7735,1,0,1300,0,224500,1980
1790,11884,1,0,1790,0,260000,1951
1470,5400,1.5,0,1470,0,865000,1912
2500,11779,1,0,1550,950,730000,1971
980,3080,1.5,0,980,0,550000,1910
2130,4000,2,0,2130,0,645000,1908
1360,16000,1,0,1360,0,250000,1978
1630,1329,2,0,1360,270,507200,2000
2500,11070,1,2,1300,1200,380000,1964
2260,19500,1,2,1450,810,540000,1971
2300,6009,1,0,2300,0,738500,2005
1060,10350,1,0,1060,0,206000,1980
940,9458,1,0,940,0,265000,1948
780,77603,1,0,780,0,190000,1945
1200,9087,1,0,1200,0,339900,1969
2590,10890,1,0,1340,1250,250000,1970
1100,4184,1,0,1100,0,416500,1965
2890,9775,2,2,2890,0,575000,2004
1230,7500,1,0,1230,0,385000,1987
1030,6250,1,0,1030,0,253000,1960
1140,4600,1,0,1140,0,460000,1942
3200,3600,3,3,2600,600,1.45E+06,1997
950,6000,1,0,950,0,492000,1942
1960,30480,1,2,1060,900,275000,1972
3010,1074218,1.5,0,2010,1000,542500,1931
1080,7775,1,0,1080,0,345000,1955
2730,35075,1,0,1530,1200,575000,1979
2570,17234,1,0,1300,1270,275000,1959
3300,7561,2,0,3300,0,510000,1980
4350,6000,2,0,2970,1380,2.54E+06,1908
3820,145054,2,3,2870,950,830000,1999
2260,5172,2,0,2260,0,640000,2004
3880,15025,2,0,3880,0,702000,2004
2010,6857,1,0,1450,560,960000,1955
950,7610,1,0,950,0,190000,1983
1730,13040,1,0,1290,440,500000,1988
3070,22098,2,0,3070,0,529000,1995
1500,8173,1,0,1500,0,435000,1997
2160,5760,1,0,1260,900,670000,1954
1960,1985,2,0,1750,210,365000,2003
3950,9520,1,0,2250,1700,1.27E+06,1953
1100,145490,1.5,0,1100,0,465000,1915
1400,7582,1,0,1400,0,285000,1956
1020,4960,1.5,0,920,100,219950,1926
1600,10548,1,0,1600,0,220000,1962
4230,6420,2,3,2360,1870,1.47E+06,1916
3090,3600,2,0,2060,1030,1.11E+06,2000
2320,9311,1,0,2320,0,694000,2007
2440,10363,2,0,2440,0,620000,1988
2020,19210,1,0,1760,260,415000,1949
3270,38088,2,0,3270,0,765000,1992
2260,6600,1,0,1220,1040,864000,1948
2020,4000,2,0,2020,0,385000,1950
1000,19969,1,0,1000,0,725000,1951
2030,11585,1,0,1590,440,545000,1967
1730,9893,1,0,1730,0,299900,1988
2010,8072,1,0,2010,0,639500,1974
1540,7168,1,0,1160,380,345000,1964
5330,18116,2,0,3950,1380,1.13E+06,2000
960,2700,1,0,780,180,345000,1904
1460,2800,1,0,730,730,600000,1921
2160,7417,1,0,1360,800,355000,1983
2640,11957,1.5,0,2260,380,698000,1978
2170,7737,2,0,2170,0,566000,1987
1530,3840,2,0,1530,0,449950,1994
1570,7727,1,2,1270,300,404600,1958
1490,7435,1,0,1120,370,258000,1969
1960,10559,2,0,1960,0,415000,1955
2190,9020,2,0,2190,0,320000,1978
1690,4102,2,0,1690,0,295000,2003
2330,10750,1,0,1190,1140,389000,1962
1470,27000,1,0,1470,0,299900,1958
2550,5349,2,0,2550,0,394000,2004
2130,5500,1.5,0,2130,0,762000,1939
3650,48351,1.5,0,3650,0,697000,1978
3340,70131,2,0,2420,920,485000,1994
800,5600,1,0,800,0,189900,1955
3470,9610,3,4,3470,0,2.15E+06,1989
1030,6969,1,0,1030,0,345000,1921
1630,7800,1,0,1630,0,376500,1950
2010,7017,2,3,2010,0,775000,1951
1360,3737,1.5,0,1360,0,450000,1910
2040,8315,1,0,1480,560,760000,1958
2830,10954,2,0,2830,0,569000,2003
2040,6750,1,0,1280,760,500000,1950
1340,5350,1.5,0,1340,0,592500,1941
2130,9139,2,0,2130,0,620000,1988
3920,16258,2,0,2900,1020,1.00E+06,1990
2415,2186,2,1,2415,0,815000,1981
3750,12077,2,4,3750,0,775000,2005
1010,7500,1,0,1010,0,340000,1975
990,5850,1,0,990,0,458000,1942
1200,5773,2,0,1200,0,250000,1985
1060,16988,1,0,1060,0,151600,1954
3200,6473,2,0,3200,0,515000,2005
1810,10360,1,0,1010,800,216000,1946
1670,24650,1,0,1670,0,245000,1974
1850,16960,1,2,1850,0,645000,1953
1100,5000,1,0,1100,0,249900,1960
1660,6250,1,0,830,830,410000,1980
2400,7500,1.5,0,1400,1000,499000,1975
2900,12160,1,0,1890,1010,790000,1967
2140,10350,1,0,1470,670,458000,1976
2670,5100,2,0,1940,730,925000,1929
1090,3264,1,0,1090,0,152000,1969
1970,12205,2,0,1970,0,402000,1990
1250,1178,2,0,980,270,340000,1996
4040,11350,2,2,3690,350,1.25E+06,1984
3220,38448,2,0,3220,0,775000,1993
1310,2814,1,0,810,500,299800,1944
2060,8400,1,0,1300,760,340000,1960
1750,1572,2.5,0,1470,280,626000,2005
1150,9186,1,0,1150,0,324950,1946
2050,4976,2,0,2050,0,535500,1994
3230,7639,2,0,3230,0,817500,1999
4170,4322,2,0,2940,1230,810000,2005
1940,3430,1.5,0,1220,720,565000,1926
2390,4000,1.5,0,1690,700,978000,1936
1440,27505,1,0,1440,0,530000,1951
2230,6487,2,0,2230,0,305000,2003
1210,1420,3,0,1210,0,345000,2008
750,6553,1.5,2,750,0,258000,1945
1770,7345,1.5,0,1770,0,275000,1966
1020,55756,1,0,1020,0,310000,1961
2050,9000,1,0,2050,0,713250,1951
2000,21780,1,0,1480,520,500000,1978
2180,7200,1,3,1090,1090,472000,1954
920,4429,1,0,920,0,250000,1952
3440,14237,2,0,3440,0,725000,1982
1610,15005,1,0,1610,0,345000,1986
1870,15685,1,0,1470,400,460000,1936
1110,6800,1,0,1000,110,440150,1947
2200,8036,1,0,1270,930,390000,1978
790,5120,1,0,790,0,375000,1950
1630,9282,1,0,1630,0,224950,1963
2100,67269,1,0,1220,880,480000,1949
2690,5400,2,0,2210,480,721000,1940
600,4854,1,0,600,0,174000,1922
810,9882,1,0,810,0,170000,1944
1660,3190,1.5,0,1660,0,658000,1919
1880,8494,1,0,1200,680,860000,1968
2310,68824,2,0,2310,0,407450,1968
2650,34000,2,0,2650,0,615000,1930
3130,12381,2,0,3130,0,920000,1995
860,10400,1,0,860,0,195000,1983
990,9950,1,0,990,0,269950,1961
4030,1024068,2,0,4030,0,855000,2006
1780,1429,3,0,1570,210,620000,2007
1480,6075,1,0,740,740,276000,1919
1140,5258,1.5,0,1140,0,329000,1911
1230,7500,1,0,1230,0,270000,1962
3080,10646,2,0,3080,0,440000,1993
1990,8034,2,0,1990,0,639000,1989
700,5621,1,0,700,0,403500,1945
1700,1156,2,2,1320,380,585000,2002
860,9000,1,0,860,0,216000,1942
3160,24437,1,3,2160,1000,1.15E+06,1991
2500,30056,1,0,1840,660,575000,1954
3000,9460,2,0,3000,0,430000,2001
1670,8195,1,0,1670,0,660000,1954
690,6400,1,0,690,0,338000,1943
1240,3867,1,0,800,440,400000,1987
900,5000,1,0,900,0,210000,1930
2200,8100,1.5,0,1400,800,305000,1942
960,223898,1,0,960,0,365000,1985
2130,6222,1,0,1300,830,325000,1991
2020,8800,1,0,2020,0,245000,1969
1060,7350,1,0,1060,0,182000,1959
1230,6600,1,0,1130,100,440000,1906
2510,12013,2,0,2510,0,225000,1988
2510,12013,2,0,2510,0,358000,1988
2720,5000,1.5,0,1530,1190,580000,1939
1070,8886,1,0,1070,0,240000,1984
3580,43093,1,0,3580,0,700000,1990
2230,8500,2,0,2230,0,325000,1994
2500,10890,1,0,1800,700,488000,1978
1670,4600,1.5,0,1670,0,875000,1906
2150,9070,2,0,2150,0,615000,1985
2020,4183,2,0,2020,0,321000,2012
2230,5750,2,0,2230,0,1.04E+06,2003
740,6300,1,0,740,0,299500,1942
2020,9583,2,0,2020,0,459000,1963
1730,4065,2,0,1730,0,435000,1996
1370,8280,1,0,1370,0,222000,1980
1210,6380,1.5,0,1210,0,485000,1936
2160,2323,3,0,2160,0,750000,2007
1550,6022,2,0,1550,0,266000,1989
1170,6000,1,0,970,200,455000,1941
2020,215622,2,0,2020,0,490000,1975
1740,8625,1,0,1240,500,280000,1978
3100,3900,2,2,2090,1010,1.45E+06,1923
1590,24330,1.5,0,1140,450,291000,1942
2400,10126,2,3,2400,0,745000,1981
2290,9142,1,0,2290,0,685900,1972
1610,7392,1,0,1610,0,160000,1964
2240,9934,1,0,1490,750,650000,1968
850,6370,1,0,850,0,250000,1951
920,1458,2,0,920,0,265000,1995
2590,6180,1,0,1330,1260,599000,1960
1340,7260,1.5,0,1340,0,199950,1944
2420,11201,1,1,1420,1000,712500,1948
1420,4305,1,0,920,500,490000,1941
1360,6000,1.5,0,1360,0,511500,1917
1510,6200,1,0,1010,500,299000,1955
2650,25248,1,2,2330,320,685000,1954
2120,4000,1.5,0,1720,400,597000,1927
1200,7200,1,0,1200,0,210000,1977
3190,11375,1,0,2210,980,659000,1946
1050,4160,1,0,1050,0,540000,1925
1300,22605,1,0,1300,0,469000,1998
3970,263538,1.5,0,3970,0,1.07E+06,1991
2990,7500,1,2,1800,1190,575000,1972
2440,7042,1.5,2,1640,800,725000,1941
1170,5400,1,0,1170,0,299950,1953
2270,18450,1,0,2270,0,375000,1961
1280,5525,1,0,1280,0,342450,1962
1950,3225,2,0,1950,0,315000,2002
1930,3840,1,0,1170,760,328000,1997
1970,7213,1,0,1170,800,323000,1977
1820,3120,1,0,1000,820,320000,1997
950,4080,1,0,950,0,550000,1924
4010,16200,1,0,2090,1920,1.65E+06,1955
4560,16643,1,3,2230,2330,1.21E+06,1995
4560,16643,1,3,2230,2330,1.20E+06,1995
1150,8924,1,0,1150,0,120000,1943
1150,8924,1,0,1150,0,175000,1943
910,5800,1.5,0,910,0,169900,1900
2890,7500,1,0,1830,1060,508000,1976
1070,6678,1,0,1070,0,335000,1951
2050,3320,1.5,0,1580,470,613200,1927
1040,3500,1.5,0,1040,0,420000,1904
3320,8587,3,0,2950,370,1.00E+06,2008
740,6180,1,0,740,0,342000,1948
3380,90968,1,0,1690,1690,850000,1979
1210,4141,1,0,910,300,582000,1942
2480,6031,2,0,2480,0,475000,2001
2010,6000,1,0,1330,680,570000,1975
3230,5000,1.5,0,1750,1480,826600,1916
1170,1394,2,0,1170,0,387000,2001
1250,9126,1,0,1250,0,330000,1969
2070,49658,1,0,1540,530,653450,1980
1050,3088,1,0,1050,0,285000,2005
1400,7800,1,0,1400,0,217000,1962
1120,12500,1,0,1120,0,615000,1977
3150,5886,2,0,3150,0,580135,2014
4540,19767,2,0,4200,340,1.15E+06,1998
1400,8821,1,0,1400,0,231200,1991
2500,4950,2,0,2500,0,680000,2010
1390,2153,2,0,1390,0,267500,2001
3160,37200,2,3,2310,850,942000,1939
1310,8065,1,0,1310,0,435000,1948
1740,3622,1,0,950,790,315000,1924
1490,1709,3,0,1490,0,354901,2004
1300,6515,1,0,1300,0,439888,2005
1460,3840,1.5,0,1340,120,360000,1928
1030,6621,1,0,1030,0,205000,1955
1970,7500,2,0,1970,0,299995,1988
790,7275,1,0,790,0,150000,1944
3800,33825,1,0,3330,470,575000,1976
2168,12616,2,1,2168,0,625000,1950
4140,13392,2,0,4140,0,950000,2000
2440,7797,1,0,1560,880,278800,1965
1720,4200,2,0,1720,0,713500,1908
3020,11489,1.5,3,2110,910,1.90E+06,1916
2610,5009,1,0,1710,900,439000,1988
1500,8086,1,0,1060,440,425000,1981
2600,11280,1.5,0,1570,1030,252500,1961
1370,8470,1,0,1370,0,185000,1961
2400,15781,1,0,1200,1200,406550,1974
1068,1758,2,0,1068,0,243000,1990
2220,8994,1,0,1110,1110,500000,1962
880,7575,1,0,880,0,204750,1942
1310,9273,1,0,1310,0,222000,1968
1350,11507,1,0,1350,0,200000,1966
1400,1320,3,2,1400,0,367000,2006
1170,7320,1,0,1170,0,183000,1962
1020,1570,2,0,720,300,300000,2004
1300,3844,1,0,1300,0,369000,1985
2010,16736,2,0,2010,0,380000,1929
1590,5009,2,0,1590,0,463000,1985
1470,9750,1,0,1470,0,475000,1963
1580,14400,1,0,1580,0,225000,1981
1970,9512,1,0,1970,0,371000,1968
2330,3141,2,0,2330,0,625000,2003
7100,18200,2.5,0,5240,1860,3.20E+06,1933
1230,10725,1,0,1230,0,329000,1980
2570,13000,2,0,2570,0,634000,1962
3440,6915,2,0,3440,0,616000,2006
3330,20053,2,0,3330,0,1.82E+06,1968
1780,2684,2,0,1780,0,435000,2002
2110,6295,2,0,2110,0,320000,2000
2770,8049,2,0,2770,0,820000,2002
1590,3359,2,0,1590,0,310000,2000
1460,968,2,0,1140,320,443750,2003
2070,13084,1,0,1700,370,795000,1967
2420,36862,1,0,1530,890,475000,1957
2000,3750,2,0,2000,0,585000,1921
1010,7338,2,0,1010,0,315000,1981
3050,7238,2,0,3050,0,635000,1989
1160,11776,1,0,1160,0,305000,1968
2180,5440,1,0,1100,1080,785000,1904
1560,6000,1,0,780,780,525000,1944
1580,3635,1,0,790,790,537000,1910
1660,8303,1,0,1380,280,279950,1974
2350,9329,2,0,2350,0,659000,1977
1440,6650,1,0,970,470,203000,1980
2930,7806,2,0,2930,0,782500,2005
1590,7560,1,0,1130,460,250000,1984
1400,9450,1,0,1060,340,279000,1955
3190,12196,2,0,3190,0,664000,1979
4580,4838,2,3,3080,1500,2.90E+06,1991
1830,6000,1,0,1070,760,378500,1953
2720,149410,1.5,0,2720,0,535000,1988
1360,22508,1,0,1360,0,520000,1932
1520,4000,1,0,800,720,369950,1943
2290,14585,2,0,2290,0,545000,1981
2150,14092,2,0,2150,0,360000,1991
1170,7645,1,0,1170,0,760000,1955
1830,5488,1,2,1010,820,450000,1939
2730,12261,2,0,2730,0,612500,1991
1090,10710,1,0,1090,0,280000,1962
2560,9182,2,0,2560,0,750000,1993
1160,6132,1,0,1160,0,237000,1958
1010,4000,1.5,0,1010,0,441500,1919
1650,7930,1,0,1650,0,251000,1989
2120,31564,1,0,1220,900,200000,1942
960,2640,1,0,760,200,332000,1908
1509,1114,3,0,1509,0,401500,2014
2270,27122,1,0,1300,970,585000,1957
1954,4805,2,0,1954,0,340000,2005
2800,7694,1,0,2800,0,920000,2005
1270,6405,1.5,0,1270,0,153000,1944
1810,7601,1,0,1080,730,299950,1986
2410,7517,2,0,2410,0,440000,1983
1690,17383,2,0,1690,0,293000,2003
1190,6000,1,0,1190,0,203000,1952
1280,6774,1,0,1280,0,193000,1991
1460,7862,1,0,1460,0,305000,1965
1600,6380,1,0,1130,470,495000,1959
1770,6000,1,0,1130,640,420000,1952
2800,8190,1,0,1700,1100,569500,1971
2680,9185,2,0,2680,0,620000,1989
1680,9460,1,0,1680,0,466000,1959
1120,10032,1,0,1120,0,355500,1962
1040,7200,1,0,1040,0,687500,1955
1790,2240,2,0,1790,0,432100,1975
2410,34848,1.5,0,2410,0,500000,1976
3370,7313,2,0,2140,1230,690000,1988
800,5150,1,0,800,0,350000,1949
1380,5000,1,0,870,510,268000,1943
990,39964,1,0,990,0,120000,1945
1800,9229,2,0,1800,0,285000,1994
1820,12327,1,0,1380,440,365000,1955
2620,6842,2,0,2620,0,635000,2002
2290,3507,2,0,2290,0,630000,2005
2200,4466,2,0,2200,0,450000,1968
2940,12600,1,0,1850,1090,590000,1974
1700,3618,1,1,1260,440,895000,1950
860,11900,1,0,860,0,160000,1963
910,5000,1,0,910,0,520000,1924
2820,13059,2,0,2820,0,432000,1976
930,4743,1,0,930,0,141800,1942
2190,4560,2.5,0,2190,0,980000,1910
3430,7200,2,0,3430,0,1.29E+06,2014
2560,6900,1,0,1480,1080,740000,1959
770,6450,1,0,770,0,230000,1948
5230,17826,2,4,3740,1490,3.40E+06,2005
2440,9689,1,2,1830,610,954500,1974
1650,3150,1.5,0,1650,0,622000,1929
780,4000,1,0,780,0,90000,1905
1260,1634,3,0,1260,0,342000,1998
2320,4683,2,0,2320,0,305000,2007
1560,8820,1,3,1060,500,259900,1979
2330,6346,1.5,0,1600,730,420000,1934
1400,19570,1.5,0,1100,300,250000,1929
1450,6875,1,0,1450,0,249950,1961
1140,15120,1,0,990,150,199000,1932
1120,7320,1,0,1120,0,355200,1954
1970,13709,1,0,1680,290,425000,1955
1110,7128,1,0,1110,0,379500,1980
3070,6923,2,0,3070,0,860000,2009
1940,4927,2,0,1940,0,335000,2004
3050,12558,2,0,3050,0,865000,1997
1240,3600,1.5,0,1240,0,390000,1902
3380,7805,2,0,3380,0,569950,2014
3190,7828,2,0,3190,0,495500,2006
1670,10200,1,0,1390,280,476500,1953
1660,11200,1,0,1660,0,261000,1957
2070,9822,1,0,2070,0,375000,1955
2070,9822,1,0,2070,0,550000,1955
1430,4000,1,0,930,500,230000,1949
2270,10700,1,0,1570,700,526750,1963
1980,7680,1.5,0,1070,910,606000,1911
2500,26400,1,0,1780,720,368500,1977
1230,171190,1,0,1230,0,275000,1973
1390,9023,1.5,0,1390,0,342000,1955
2120,8520,1,0,1600,520,278100,1978
1540,4840,1,2,850,690,450000,1929
2000,5006,2,0,2000,0,349950,2005
2400,6053,2,0,2400,0,425000,2001
2110,8751,1,0,1510,600,435000,1962
2550,19017,1,0,1300,1250,460000,1961
1440,8114,1,0,1440,0,323000,1963
810,6827,1,0,810,0,325000,1944
1170,4635,1,0,690,480,480000,1924
3590,8400,1,0,2950,640,1.33E+06,1958
2090,6485,1,0,1280,810,210000,1956
3820,5750,2,3,2830,990,920000,2000
1460,8290,1,0,1460,0,399000,1959
2360,4063,1,0,1180,1180,631750,1940
1100,8680,1,0,1100,0,184000,1962
2100,7208,2,0,2100,0,333000,1974
1310,2841,2,0,1310,0,218000,2004
750,2964,1,0,750,0,258305,1919
1720,5000,1.5,0,1720,0,775000,1915
3370,19585,2,0,3200,170,515000,1951
1200,1259,2,0,1000,200,455000,2015
1830,6807,2.5,0,1830,0,440000,1954
3870,3819,2,0,2760,1110,1.44E+06,2002
2220,3707,2,0,1620,600,850000,1919
2920,21375,1,0,1850,1070,480000,1961
2540,27007,1,0,1520,1020,420000,1980
1970,7100,1,0,1590,380,408000,1976
2170,9752,1,0,1100,1070,278000,1962
2350,1620,2,0,1560,790,1.20E+06,2001
2630,39000,2,0,2630,0,454000,1979
4120,14866,1,4,2070,2050,1.85E+06,1965
2440,5000,2,0,2440,0,499000,2007
3480,6625,2,0,3480,0,590000,2012
1900,4805,2,0,1560,340,385000,1999
3160,10043,2,2,3160,0,1.25E+06,2011
1330,2159,1,0,1330,0,202200,1979
1420,13468,1,0,960,460,450000,1976
2570,233481,1.5,0,2570,0,435000,1986
1270,43560,1,0,1270,0,550000,1908
2470,5650,1,2,1550,920,361000,1973
2590,12600,2,0,2590,0,760000,1979
3030,8507,2,0,3030,0,902000,2003
1240,4550,1.5,0,1240,0,505000,1951
1040,8925,1,0,1040,0,200000,1961
2320,6375,1,0,1270,1050,260000,1967
1190,5100,1.5,0,1190,0,417000,1928
2030,8690,1,0,1360,670,287500,1986
1390,10530,1,0,1390,0,450000,1961
2050,4000,1.5,2,2050,0,825000,1979
3050,6179,2,0,2330,720,1.48E+06,1926
1240,5500,1.5,0,1240,0,319950,1921
3030,30000,2,0,3030,0,682000,1981
1930,6000,1,0,1130,800,560000,1956
1490,10344,1,0,1490,0,350000,1985
1510,10215,1,0,1510,0,270000,1995
1320,35100,1,0,1320,0,284000,1990
2330,4606,2,0,2330,0,308000,2004
2240,7725,1,0,1120,1120,450000,1956
2050,34222,2,0,2050,0,540000,1989
1680,11123,1,0,1130,550,380000,1959
2200,122403,1.5,0,2200,0,522500,1971
670,7957,1,0,670,0,118000,1978
1730,7210,1,0,1010,720,280400,1968
2710,41811,1.5,0,1690,1020,710000,1995
3410,25741,2,0,3410,0,720000,1993
1330,7500,1,0,1330,0,787000,1961
1990,2660,2,0,1990,0,537000,2012
1900,4450,1,0,1500,400,650000,1916
1310,8640,1,0,910,400,154200,1948
1690,7260,1,0,1080,610,238000,1979
1040,8199,1,0,1040,0,285650,1953
1340,1286,2,0,1190,150,485500,2006
1120,7350,1,0,1120,0,315000,1942
9640,13068,1,4,4820,4820,4.67E+06,1983
2310,10525,2,0,2310,0,627000,1965
2190,34528,2,0,2190,0,525000,1994
1220,1281,2,0,930,290,526000,2014
1200,3060,1,0,1060,140,480000,1910
3840,53696,2,0,3840,0,970000,1996
2460,9973,1,0,1560,900,640000,1965
1630,7950,1,0,1320,310,279000,1985
970,9750,1,0,970,0,303000,1940
1780,5336,1.5,0,930,850,315000,1918
1760,7268,1,0,1080,680,336500,1979
770,8150,1,0,770,0,163250,1951
1760,6927,1,0,1050,710,444950,1962
990,2446,2,0,990,0,285000,1998
1250,4960,1,0,940,310,370000,1938
1440,5150,2,0,1440,0,330000,1997
1960,4018,1,0,980,980,395000,1950
2510,5310,1,0,1460,1050,440000,1944
2920,6605,2,0,2920,0,625000,2012
1730,46638,2,0,1730,0,435000,1991
1570,2577,2,0,1570,0,299950,2005
970,4233,1,0,970,0,560000,1944
2800,9764,2,0,2800,0,380000,2002
1580,7800,2,0,1580,0,333000,1906
1220,3000,1,0,920,300,499000,1926
1550,8000,1,0,1330,220,386000,1980
1220,7620,1,0,720,500,320600,1947
1651,18200,1,0,1651,0,285000,1946
3150,7800,2,0,3150,0,450000,2013
800,7150,1,0,800,0,175000,1933
3190,5857,2,0,3190,0,544800,2004
1720,7587,1,0,1140,580,220000,1981
1100,1695,2,0,1100,0,374000,2009
1010,7896,1,0,1010,0,200000,1984
1010,7896,1,0,1010,0,259950,1984
1760,9222,1,0,1140,620,255000,1971
1400,6750,1,0,1040,360,447000,1975
1820,8722,1.5,0,1820,0,287000,1926
1470,6950,1,0,1470,0,344950,1932
770,7000,1,0,770,0,212000,1921
1340,11583,1,0,1190,150,425000,1962
480,4560,1,0,480,0,170000,1922
1260,4080,1.5,0,1260,0,565000,1928
870,11100,1,0,870,0,234000,1940
4010,12105,1,3,2600,1410,1.51E+06,1983
2340,8414,1,0,1280,1060,345000,1993
1770,3172,2,0,1770,0,415000,2009
2660,10637,1.5,0,1670,990,760000,1922
3600,20001,2,0,3600,0,484000,1976
1230,1107,2,0,1230,0,360000,2006
3270,39586,1.5,0,3270,0,875000,1988
3100,20553,1,0,3100,0,930000,1954
1900,6660,1,0,950,950,250000,1966
1750,2731,2,0,1750,0,394000,2012
3380,11270,2,1,2160,1220,865000,2007
2090,6000,2,1,2090,0,477500,1918
4120,12500,1,4,2060,2060,1.25E+06,1947
1260,7500,1,0,840,420,270000,1947
1800,6875,1,0,1230,570,567000,1974
1960,7200,1,0,980,980,635000,1940
4460,6952,2.5,2,3460,1000,1.87E+06,1930
1330,9200,1,0,1330,0,183000,1973
1820,78408,1,0,1220,600,309933,1950
3360,9100,1,0,1760,1600,945800,1973
2860,59612,1,4,1510,1350,503000,1948
1460,10200,1,0,1460,0,220000,1957
1900,36769,1,0,1900,0,335000,1987
1790,9927,1,2,1240,550,650000,1969
3100,7600,2,0,3100,0,511000,2005
900,57063,1,0,900,0,275000,1938
1530,5000,2,0,1260,270,576250,1989
2070,3128,2,3,1760,310,1.45E+06,1988
1340,4320,1,0,920,420,186000,1912
1220,4160,1,0,1220,0,655100,1922
2370,6500,2,0,2370,0,328000,1998
1890,11036,1,0,1460,430,441000,1973
1480,7725,1.5,0,1480,0,370000,1981
1050,8382,1,0,1050,0,630000,1959
2070,14000,1,0,1720,350,470500,1958
1170,6000,1,0,1170,0,285950,1948
1090,7200,1,0,1090,0,698000,1958
1650,6684,2,0,1650,0,268000,1991
4410,8112,3,4,3570,840,1.63E+06,2003
1780,15000,2,0,1780,0,355000,1993
1550,8778,1,0,1250,300,299000,1952
2290,6120,2,0,2170,120,1.00E+06,1926
2220,8229,1.5,0,2220,0,275000,1958
1150,10240,1,0,1030,120,475000,1918
2000,37045,2,0,2000,0,260000,1989
1270,7560,1.5,0,1270,0,416000,1932
1810,11205,1.5,2,1810,0,495000,1915
1450,8100,1,0,1450,0,357500,1952
1170,1079,3,0,1170,0,459500,2003
1730,6930,2,0,1730,0,258000,1994
2680,98445,1,0,2680,0,600000,1962
1260,24550,1.5,2,1260,0,665000,1937
1020,10152,1,0,1020,0,165000,1959
1970,8605,2,0,1970,0,297000,1994
830,5100,1,0,830,0,350000,1942
5030,11023,2,2,3250,1780,2.45E+06,2008
800,9450,1,0,800,0,180000,1958
1330,12092,1,0,720,610,339950,1981
1030,4700,1,0,1030,0,365000,1952
5660,193593,2,0,4100,1560,955000,2001
2330,1987,2,4,1410,920,732000,2004
1540,10800,1,0,770,770,500000,1947
2040,8560,1,2,1100,940,610000,1961
1540,7800,1,0,1540,0,525000,2004
1920,13787,1,0,1220,700,170000,1966
1870,3439,2,0,1870,0,300000,2005
2960,12527,2,0,1940,1020,389500,1986
1690,10250,1,0,1690,0,330000,1955
1610,7187,2,0,1610,0,269950,1988
670,4720,1,0,670,0,107000,1948
1752,14626,2,2,1752,0,249000,2005
1540,5920,1.5,0,1540,0,442500,1935
3160,286181,2,3,3160,0,579000,2002
2570,39634,2,0,2570,0,621500,1984
1370,7500,1,0,1080,290,203000,1958
860,5800,1,0,860,0,222900,1942
1680,17400,1.5,0,1680,0,453000,1991
930,29258,1,0,930,0,190000,1941
1820,7381,1,0,1150,670,320000,1962
2120,4370,1.5,0,2120,0,733500,1904
3330,21785,2,0,3330,0,555000,1994
2520,6170,2,0,1850,670,364950,2003
1560,9247,1,0,1160,400,490000,1989
2250,13526,1,1,1350,900,688000,1957
640,7768,1,0,640,0,165000,1942
3880,8370,2,0,3880,0,506000,2004
3360,7108,2,0,2770,590,2.19E+06,1905
2350,7800,1,0,1510,840,754000,1968
2340,1989,2,4,2340,0,949950,1959
1430,1056,3,0,1430,0,443600,2003
1920,12244,2,0,1920,0,380600,1998
4330,14600,2,0,3630,700,722800,1985
790,5150,1,0,790,0,342888,1948
2350,5946,1,2,1350,1000,555000,1957
1350,3068,2,0,1350,0,613000,1991
1470,10052,1,0,1470,0,480000,1956
1680,5202,1.5,0,1680,0,619500,1911
1890,8505,1,0,1290,600,437000,1980
2030,9905,1,0,2030,0,621000,1959
1760,4080,1.5,0,1760,0,810000,1906
1950,8868,1,0,1350,600,415000,1964
1440,7404,1,0,1080,360,250000,1918
2230,6000,1,1,1260,970,585000,1968
1180,5002,1.5,0,1180,0,220000,1946
2500,11900,1,0,1400,1100,580000,1963
2680,20104,1,0,1820,860,1.32E+06,1964
2040,9225,1,0,1610,430,675000,1968
2660,7389,2,0,2660,0,695000,2002
2580,7630,1,0,1730,850,915000,1954
1000,6947,1,0,1000,0,375000,1947
1330,1265,2,0,1140,190,500000,2008
1420,5185,1,0,1420,0,335000,2004
1280,21750,1.5,0,1280,0,170000,1912
2200,8500,1,0,1400,800,320900,1971
1800,8462,1,0,1440,360,508000,1978
1200,9085,1,0,1200,0,228950,1968
1840,4760,1.5,0,1080,760,433000,1929
960,5150,1,0,960,0,267500,1951
2890,9000,2,4,2090,800,910000,1939
1290,10117,1,0,1290,0,370000,1984
1140,3834,1.5,0,1140,0,320000,1911
1750,5200,1,1,1750,0,660000,1956
2580,21115,2,0,2580,0,787888,1977
2650,5880,2,0,2650,0,329000,2005
1470,6398,1,0,970,500,602000,1941
1640,9750,1,0,1640,0,375000,1959
620,7620,1,0,620,0,212000,1926
1440,8370,1,0,1440,0,224000,1977
1160,10079,1,0,1160,0,315500,1986
1070,2880,1,0,1070,0,350000,1902
3560,14010,2,0,3560,0,389000,1989
1720,13104,1,0,1720,0,285000,1962
1530,9800,1,0,1530,0,425000,1958
1270,7875,1,0,1270,0,190000,1980
1510,18439,1,0,1510,0,374000,1971
880,5500,1,0,880,0,292000,1904
2020,5100,1.5,0,1320,700,475000,1911
1410,2675,1,0,820,590,546500,1985
860,10426,1,0,860,0,82000,1954
860,10426,1,0,860,0,219900,1954
1210,5750,1.5,0,1210,0,440000,1910
2090,32718,2,4,1550,540,400000,1919
1430,20193,1,0,1430,0,453000,1955
2120,6893,1,0,1060,1060,330000,1983
2540,8604,2,0,2540,0,359950,1991
2490,12929,2,0,2490,0,616000,1983
670,2356,1,0,670,0,245000,1960
1320,2040,3,0,1320,0,296000,1997
950,9000,1,0,950,0,193000,1924
1870,8442,1.5,0,1060,810,456000,1927
1840,9250,1,0,980,860,480000,1956
1410,1253,3,0,1410,0,382000,2005
1050,2542,1,0,880,170,650000,1904
1400,10052,1,0,1400,0,431750,1957
1630,1755,2,0,1320,310,419900,1997
1900,9513,1,0,1900,0,315000,1995
1890,35280,1,0,1510,380,597500,1979
2980,43301,1,0,1930,1050,615000,1978
2885,33671,2,0,2885,0,605000,1984
1980,11900,2,0,1980,0,220000,1990
3020,8750,1,0,1710,1310,340000,1960
2980,210395,2,0,2980,0,620000,2001
3290,11900,1.5,0,3290,0,602000,1973
1580,11750,1,0,1180,400,575000,1951
2090,10834,1,0,1360,730,285000,1987
1100,8140,1,0,1100,0,306500,1965
1870,3480,2,0,1870,0,325000,2002
2390,21804,1,0,1450,940,623000,1973
1320,8568,1,0,1320,0,256500,1993
3430,6872,2,0,2830,600,473000,2002
2250,9235,2,0,2250,0,549000,1985
1710,19115,1,0,1710,0,305000,1986
2160,8049,2,0,2160,0,317000,1988
1400,13775,1,0,1400,0,450000,1963
1560,5333,1,0,780,780,225000,1947
2300,7897,2.5,0,2300,0,500000,1956
820,4860,1,0,820,0,207000,1955
1630,8308,1.5,0,1630,0,474900,1948
2010,7200,2,0,2010,0,515000,1994
1540,5000,1.5,0,1090,450,542000,1922
2420,10962,1,0,1530,890,725000,1977
1690,4533,2,0,1690,0,314950,2003
1410,10078,1,0,1410,0,375000,1983
1640,47044,1,0,1640,0,500000,1989
2200,9840,1,0,1500,700,689000,1978
1290,1182,2,0,1000,290,525000,2006
1060,6232,1,0,1060,0,360000,1968
1240,5750,1,0,1240,0,425000,1948
1280,5500,1,0,1280,0,239950,1949
2330,3000,2,3,2330,0,577500,1915
2360,7291,1,0,1360,1000,615000,1948
2210,10800,1,0,1170,1040,516000,1997
3670,15400,2,3,3670,0,1.22E+06,1986
3080,4815,2,3,2300,780,1.66E+06,1937
770,6731,1,0,770,0,315000,1943
2600,9000,1,0,1410,1190,250000,1959
1220,4900,1,0,1220,0,250000,1942
2910,48351,1,0,1910,1000,925000,1967
1150,4681,1,0,1150,0,358000,1955
1700,6200,2,0,1700,0,262000,1997
1220,7370,1,0,1220,0,500000,1964
1670,6400,1.5,0,1670,0,1.30E+06,1919
2420,65501,2,1,2420,0,500000,1984
2610,9002,2,0,2610,0,675000,1988
960,5030,1,0,960,0,235000,1955
960,5030,1,0,960,0,545000,1955
1010,9360,1,0,1010,0,350000,1981
1550,1827,2,0,1550,0,320000,2008
5067,13315,1,2,3154,1913,452000,1968
2350,6000,1.5,0,1990,360,875000,1922
1310,2998,2,0,1310,0,325000,1998
2160,5600,1,0,1080,1080,756000,1947
2510,7992,1,0,1610,900,319000,1978
890,3800,1.5,0,750,140,455000,1926
1129,3840,1,0,1129,0,330000,1953
1980,9988,1,0,1340,640,510000,1980
2360,5012,1,0,1560,800,532000,1964
2480,5007,2,0,1960,520,775000,2014
2160,4000,1,0,1080,1080,410000,1953
1740,5100,1,0,580,1160,205000,1915
2430,6766,2,0,2430,0,585000,1999
1950,8200,1,0,1950,0,255000,1975
910,3750,1,0,910,0,415000,1904
2360,7080,1,0,1180,1180,459000,1925
1130,11250,1,0,1130,0,354000,1965
2150,5193,2,0,2150,0,587000,1995
5270,53428,2,0,3440,1830,782000,2004
1300,7287,1,0,1300,0,570000,1965
1050,6002,1,0,840,210,414500,1941
1380,6700,1,0,1190,190,185000,1928
1610,10291,1,0,1610,0,262500,1961
3150,67518,1,0,2250,900,370000,1965
1520,9507,1,0,1520,0,362500,1954
1990,7397,2,0,1990,0,536000,1993
2500,7804,1.5,0,1570,930,425000,1921
1890,7200,1,0,1230,660,435000,1973
1840,9240,1,0,1540,300,435000,1942
1220,6300,1,0,760,460,400000,1942
1370,1221,2,0,1080,290,446000,2008
2710,13120,1,0,2710,0,1.25E+06,1959
1760,5421,2,0,1760,0,300000,1991
800,5080,1,0,800,0,404500,1938
3530,49222,2,0,3530,0,910000,1986
1780,6120,1.5,0,1390,390,771000,1927
2610,4781,2,0,2610,0,335000,2009
1850,15170,1,0,1850,0,390000,1965
1560,9706,1,0,1560,0,288000,1963
1270,10790,1,0,1270,0,403000,1956
1420,1309,3,0,1420,0,510000,2006
2880,6800,2,0,2880,0,751000,1980
1420,8000,1,4,1420,0,408000,1950
1640,12855,1.5,0,1500,140,1.01E+06,1920
1730,9030,1,0,1730,0,575000,1956
1250,8100,1,0,1250,0,330000,1951
1520,1221,3,0,1520,0,565000,2013
1820,2935,2,0,1820,0,456000,1999
2700,9122,2,0,2700,0,652500,1990
1820,3140,2,0,1820,0,582000,1949
2770,5686,2,0,2770,0,700000,2004
1270,9182,1.5,0,1270,0,235000,1917
1400,12155,1,0,1400,0,460000,1977
1820,8008,1,0,1240,580,475000,1981
1870,6275,1,0,1870,0,579000,2003
1360,2746,1.5,0,1360,0,507000,1945
1040,2643,2,0,720,320,210000,2004
2140,10316,2,0,2140,0,359500,1993
1330,9831,1,0,1330,0,248000,1987
1070,5750,1,0,1070,0,239300,1952
1370,1533,3,0,1370,0,315000,2009
3510,12410,2,0,3510,0,970000,1976
1730,6240,1,1,1000,730,510000,1954
1550,9176,1,0,1000,550,418000,1956
3280,27441,2,0,3280,0,699000,1996
2150,8536,1,3,1400,750,871000,1967
1580,9147,1,1,1210,370,515000,1967
1460,43000,1,0,1460,0,400000,1952
1410,5100,1,0,1110,300,445000,1954
3090,6600,1,2,1800,1290,1.11E+06,1956
1690,9600,1,0,1210,480,212000,1976
2870,11304,2,0,2870,0,710000,1980
1100,7110,1,0,880,220,225800,1907
2310,36665,1,2,1580,730,520000,1983
3490,15246,1,1,1940,1550,1.30E+06,1968
2080,13510,1,0,1040,1040,248000,1950
2230,7200,1,0,1220,1010,556000,1957
1710,11900,1,0,1070,640,319950,1958
1640,3000,1,0,1000,640,320000,1984
1600,2788,2,0,1600,0,245000,1992
2850,36585,2,0,2850,0,700000,1987
2600,8160,2,0,2600,0,628000,2015
1380,4800,1,0,1380,0,640000,1948
1320,4978,1,0,940,380,420000,1942
1420,1162,3,0,1420,0,349950,2002
2420,8438,2,0,2420,0,307999,1996
2600,6050,2,0,1960,640,749950,1949
840,3844,1,0,840,0,290000,1919
1420,7920,1,0,1420,0,235000,1962
1790,6120,1,0,1790,0,225000,1937
1790,6120,1,0,1790,0,302100,1937
1340,6380,1,0,890,450,520000,1939
1010,7200,1,0,1010,0,285000,1975
1640,15258,1,0,1640,0,525000,1981
2980,8500,1,0,1540,1440,374900,1982
1370,7200,1,0,1130,240,377500,1926
2190,8775,1.5,1,2190,0,587450,1927
1530,12000,1,0,1070,460,245000,1979
1290,5757,1,0,1290,0,200000,1994
5150,453895,2,3,4360,790,2.14E+06,1997
2470,9226,2,0,2470,0,607000,1991
1810,5070,1.5,4,1230,580,1.25E+06,1967
2230,14694,1,0,1180,1050,549950,1981
2300,7701,1,0,2300,0,250000,1960
2030,6970,2,0,2030,0,525000,1991
2000,9900,1,2,1480,520,440000,1957
3610,107386,1.5,3,3130,480,425000,1918
3290,5029,2,0,3290,0,739900,2004
1300,3731,1,0,900,400,315000,1993
1880,3774,1.5,0,1360,520,340000,1917
2170,9743,2,0,2170,0,366000,1995
1680,7250,1,0,930,750,315000,1952
1190,9135,1,0,1190,0,299000,1959
940,5000,1,0,940,0,350000,1950
1010,1461,1,0,670,340,340000,2003
1290,8580,1,0,1290,0,460000,1962
1480,10588,1,0,1480,0,224000,1957
900,6400,1,0,900,0,140000,1940
1400,7632,1.5,0,1400,0,246000,1930
2040,14071,2,0,2040,0,330000,1995
1450,7200,1,0,1010,440,306000,1969
1210,7440,1,0,1210,0,324950,1949
1800,26615,1,0,1240,560,345000,1987
1490,8995,1,0,1490,0,207000,1954
1240,5700,1.5,0,1240,0,238000,1953
2632,18743,2,3,2632,0,695000,2000
2150,15304,2,0,2150,0,649950,1979
1710,9448,1,0,1010,700,515000,1947
1530,5032,2,0,1530,0,452000,1998
1630,3060,2,0,1630,0,236000,2003
4080,14450,2,2,3210,870,1.29E+06,1998
2340,16500,1,0,1500,840,563000,1972
1000,14061,1,0,1000,0,410988,1967
2290,8319,2,0,2290,0,339950,1985
3180,13118,2,0,3180,0,1.20E+06,1986
2170,19785,2,0,2170,0,340000,1992
3020,13457,1,0,3020,0,808100,1956
1330,6301,1,0,1330,0,236000,1998
1720,8300,1,0,1720,0,330000,1965
2540,5808,2,0,1820,720,799990,1910
1810,5669,2,0,1810,0,240000,2003
1410,18600,1,0,1410,0,343000,1960
1530,9406,1,0,1270,260,332000,1993
4380,14925,2,0,4380,0,945000,2003
1140,8366,1,0,1140,0,239950,1943
2110,5000,1.5,0,1250,860,674000,1946
1050,5000,1,0,1050,0,200000,1967
1600,7232,1,0,1600,0,453000,1966
1430,8865,1,0,1430,0,330000,1950
1996,4547,2,0,1996,0,285000,2009
1530,8152,1,0,910,620,338000,1948
1000,6000,1,0,1000,0,264950,1951
2530,10800,1,0,1350,1180,880000,1954
970,5488,1,0,970,0,209500,1976
2400,9398,1,0,1310,1090,380000,1958
1830,12891,1,0,1830,0,336500,1994
2130,8466,1,0,1290,840,360000,1983
3330,33826,2,0,3330,0,911100,1924
560,7560,1,0,560,0,249900,1944
1210,6250,1,0,1210,0,175000,1962
2380,2500,3,3,2380,0,549950,1988
1370,10866,1,0,1370,0,225000,1945
1370,10866,1,0,1370,0,270000,1945
1740,11040,2,0,1740,0,400000,1980
790,5240,1,0,790,0,299800,1925
2480,8676,2,0,2480,0,555000,1989
1920,9180,2,0,1920,0,230000,1988
2750,6259,2,0,2750,0,360000,2002
880,3200,1,0,880,0,415000,1910
2160,8000,1,0,1660,500,355000,1976
2570,27972,2,0,2570,0,635000,1997
2130,5000,1,0,1100,1030,353000,1978
3150,34830,1,0,3150,0,999000,1957
1780,10196,1,0,1270,510,265000,1967
1910,8250,1,0,1910,0,250000,1959
1170,7142,1,0,1170,0,225000,1951
900,5000,1,0,900,0,553000,1944
2650,11455,1,0,1400,1250,565000,1961
1170,5150,1,0,980,190,312000,1907
2630,185130,2,0,2630,0,475000,1991
2150,9163,1,0,1340,810,320000,1992
1430,9583,1,0,1430,0,453000,1964
960,6180,1,0,960,0,320000,1910
2640,8400,1,2,1440,1200,610000,1947
1490,9630,1,0,1490,0,385000,1959
1210,8075,1,0,1210,0,215000,1983
1860,5040,1.5,0,1860,0,215000,1920
1980,4274,2,0,1980,0,415000,2003
900,6380,1,0,900,0,350000,1947
900,6380,1,0,900,0,395000,1947
1490,9874,1,0,1490,0,898000,1963
2980,7338,2,0,2980,0,480000,2006
2660,1973,3,3,1870,790,1.24E+06,2007
2790,230868,2,0,2790,0,599000,1989
2800,9127,2,0,2800,0,770000,1999
1590,8520,2,0,1590,0,1.21E+06,1980
3240,11131,1,0,2080,1160,1.59E+06,1953
2130,35169,1,0,2130,0,880000,1989
1510,7884,1,0,1510,0,332000,1942
1750,7200,1,0,1750,0,445000,1966
4010,87555,2,0,4010,0,849000,2004
1650,2970,1.5,0,1650,0,752000,1903
4050,6504,2,0,4050,0,450000,1996
1320,5500,1,0,1320,0,420000,1955
2310,6320,2,0,2310,0,330000,1997
1440,9065,1,0,1440,0,409000,1972
2330,14322,1,0,1180,1150,350000,1968
2430,44001,1,0,2430,0,570000,1994
1390,8333,1,0,1390,0,315000,1982
1150,15000,1,0,1060,90,224000,1930
2120,9706,1,0,1370,750,293550,1965
2300,3175,1.5,0,1340,960,350000,1966
3320,9380,2,3,3320,0,1.11E+06,1988
2400,7092,2,0,2400,0,442500,1997
3580,118047,1,0,3240,340,616500,1992
2100,9040,1,0,1700,400,506400,1989
1550,4411,2,0,1550,0,324000,2001
1570,6450,1.5,0,1570,0,169000,1931
1480,5000,1,0,750,730,595000,1928
2720,6014,2,0,2720,0,299900,2002
2270,8876,1,0,1380,890,332000,1977
2410,8400,1,0,1600,810,432000,1978
2730,9112,1,2,1740,990,510000,1996
1540,7739,2,0,1540,0,270000,1986
3120,15593,2,4,3120,0,750000,1986
1480,3120,1,0,930,550,509250,1914
860,5200,1,0,860,0,189000,1969
2180,3893,2,0,2180,0,726500,1999
1300,11374,1.5,0,1300,0,287000,1933
3420,49223,2,0,3420,0,679000,2004
2130,8721,1,0,1570,560,316000,1987
2300,22445,2,0,2300,0,498000,1992
2560,8270,1,0,1480,1080,448000,1979
1040,5527,1,0,1040,0,535000,1951
3080,9601,2,1,3080,0,560000,1990
2670,14255,1,0,1610,1060,437850,1975
3270,50994,2,0,2720,550,435000,1983
2610,8031,2,0,2610,0,510000,1998
2460,54885,2,0,2460,0,520000,1980
1930,3521,2,0,1930,0,509000,1989
1220,5652,1,0,1220,0,575000,1905
2030,7210,1,0,1330,700,365000,1969
2420,17859,1,1,1500,920,795000,1979
1870,4060,2,0,1870,0,285000,2005
3020,43560,2,0,2720,300,955000,1969
2880,8400,2,4,2050,830,775000,1955
1810,5012,2,0,1810,0,400000,1997
2590,8483,2,0,2590,0,570000,1991
3830,6507,2,0,3830,0,955990,2014
3250,34848,1,0,2260,990,1.15E+06,2006
2760,21465,1,0,2120,640,459950,1979
1220,8382,1,0,1220,0,245000,1942
1280,974,3,0,1280,0,281000,2003
770,7000,1,0,770,0,205000,1942
1520,15090,1,0,1520,0,290000,1968
2080,11176,1,0,2080,0,635000,1954
570,6000,1,0,570,0,310000,1918
1500,3659,1,0,830,670,470000,1906
2510,14878,2,0,2510,0,600000,1990
1980,10051,1,0,1980,0,279000,1969
2500,4270,2,0,2500,0,538500,2000
2720,10006,2,0,2720,0,594950,1989
910,295772,1,0,910,0,533050,1953
1480,7040,1,0,1480,0,510000,1974
2470,8686,1,0,1270,1200,360000,1974
1650,5106,1,0,1090,560,435000,1960
1700,6500,1,0,1700,0,559000,1967
1995,115670,1.5,1,1995,0,645000,1991
1280,9690,1,0,640,640,340000,1919
2980,10459,2,0,2980,0,565000,2001
1730,6130,1,0,1480,250,575700,1941
2420,1923,2,2,1840,580,1.01E+06,2006
2800,185130,1,0,2320,480,540500,1996
1400,8580,1,0,900,500,265000,1954
2070,7830,1,1,1180,890,699950,1941
750,20339,1,0,550,200,355000,1946
1460,11407,1,0,1460,0,381000,1954
2140,8700,1,2,1220,920,564000,1962
740,6250,1,0,740,0,114975,1942
410,8636,1,0,410,0,325000,1953
1570,125452,1,3,1570,0,299990,1953
2860,5280,2,0,2860,0,751000,2006
1400,6970,2,0,1400,0,425000,1984
2700,5040,1,2,1560,1140,665000,1947
4460,269345,2,4,3330,1130,833450,1996
2670,11250,1.5,0,2320,350,575000,1948
1520,9600,1,0,1520,0,190000,1967
1520,9600,1,0,1520,0,314950,1967
1660,5200,1,0,1120,540,601150,1906
860,8308,1,0,860,0,315000,1948
2340,13380,1,0,1280,1060,545000,1954
2110,10698,2,0,2110,0,565000,1979
1010,7034,1,0,1010,0,175000,1954
2330,26571,2.5,0,2330,0,530000,1987
6430,27517,2,0,6430,0,4.49E+06,2001
1610,7900,1,0,1310,300,430000,1960
1460,8372,1,0,1460,0,225000,1981
2900,9779,2,0,1950,950,312000,1937
1260,7980,1,0,1260,0,380000,1951
1210,10000,1,0,1210,0,222200,1953
3420,8000,2,0,3420,0,1.44E+06,2006
2120,4558,2,0,2120,0,329950,2002
2460,10300,1,0,2460,0,995000,1992
3790,10829,2,0,3790,0,929950,1993
2350,9779,1,0,2350,0,692000,1987
620,2475,1,0,620,0,402000,1911
1920,43560,1,0,1340,580,510000,1962
1050,8498,1,0,1050,0,249000,1959
1360,9980,1,0,1360,0,244900,1966
1180,7068,1,0,1180,0,289900,1944
1560,7980,1,0,1170,390,552500,1939
3300,165528,2,0,3300,0,760000,1984
1100,1088,2,0,750,350,440000,2006
1770,9000,1,0,1090,680,286000,1954
1200,4592,1,0,800,400,260000,1950
1330,10838,2,0,1330,0,355000,1985
1570,12506,1,0,1570,0,318000,1959
1610,19965,1,0,1610,0,255000,1952
1100,17334,1,0,1100,0,139000,1978
1810,7068,2,0,1810,0,485000,1976
2930,266587,2,0,2440,490,549950,1995
1780,4200,1.5,0,1780,0,588000,1916
3050,7410,1.5,0,1950,1100,975000,1950
1540,1827,2,0,1540,0,402000,2005
1380,9875,1,0,1380,0,245000,1959
1890,32340,1.5,3,1890,0,445000,1976
1570,8459,1,0,1570,0,195000,1991
2540,11750,1,0,1480,1060,385000,1962
1520,7903,1,0,1000,520,450000,1955
2780,6837,2,0,2780,0,1.09E+06,2004
1730,6375,2,0,1730,0,396675,1945
2340,7494,1,0,1170,1170,242000,1951
1300,12378,1,0,1300,0,380000,1943
1420,4635,2,0,1420,0,496000,1941
1470,4488,2,0,1470,0,399950,1980
2850,8526,2,0,2850,0,895000,1998
2360,6149,2,3,1560,800,690000,1926
1610,8375,2,0,1610,0,270000,1927
2420,38781,1,0,1210,1210,349900,1949
1470,1741,2,0,1170,300,454280,2004
1410,26375,1,0,1410,0,390000,1992
1840,14005,1,0,1840,0,275000,1983
2450,8932,2,0,2450,0,300000,1990
1500,6000,1,0,850,650,700000,1940
2080,6609,1,0,1280,800,520000,1950
2770,39529,2,0,2770,0,715000,1987
2370,4324,2,0,2370,0,404000,2006
3000,21883,2,0,1970,1030,490500,1998
4430,6440,2,3,2680,1750,1.49E+06,1964
1550,6000,1,0,1550,0,557800,1944
2290,9900,1,2,1550,740,571000,1959
2560,4020,2,0,2560,0,410000,2006
1240,5506,1,0,1240,0,225000,1971
2590,4498,2,0,2590,0,700000,2004
1370,3500,1.5,0,1370,0,500000,1905
1360,1860,1,0,680,680,536500,1925
2060,25046,1,0,1600,460,330000,1980
1120,15210,1,0,1120,0,249950,1976
1630,8410,1.5,0,1630,0,249000,1943
1590,7535,1.5,0,1590,0,249000,1909
2480,9195,1,0,1390,1090,780000,1950
2700,4275,2,0,2700,0,1.20E+06,2004
1930,7210,1,0,1110,820,434500,1975
2490,339332,1,0,2490,0,590000,2002
1000,4000,1,0,1000,0,417200,1910
2130,11900,2,0,2130,0,649990,1976
1060,3588,1,0,960,100,506000,1926
1730,4004,2,0,1730,0,348000,1999
2810,6146,2,0,2810,0,301000,1998
880,4000,1,0,880,0,427550,1940
1040,6720,1.5,0,1040,0,361000,1951
1830,8107,1,0,930,900,460000,1946
1800,6400,2,2,1800,0,958000,1984
2460,6846,1.5,0,1340,1120,445000,1911
1670,3565,2,0,1670,0,373000,1999
2660,7957,1,0,1750,910,525000,1977
2850,12593,2,0,2850,0,364988,1997
820,8370,1,0,820,0,324000,1941
2350,5627,1,0,1490,860,625000,1960
1480,7830,1,0,1480,0,237500,1980
2930,15949,1,0,1730,1200,429300,1965
1250,6250,1,0,1030,220,155000,1949
2760,8160,1.5,2,1780,980,614000,1940
2380,3332,2,0,2380,0,650000,2014
1730,12219,1,0,1730,0,625000,1986
1670,6414,1,0,1670,0,587100,1961
2150,37647,2,0,2150,0,380000,1991
930,5760,1,0,730,200,479500,1917
620,2380,1,0,620,0,382888,1900
1960,3565,2,0,1960,0,540000,1940
2550,8632,1,0,1700,850,691000,1972
1990,3990,1,0,1130,860,760500,1912
3550,10968,2,0,3550,0,685000,2006
860,33664,1,0,860,0,199129,1955
2031,7702,2,0,2031,0,335000,1988
1590,35988,1,0,1590,0,305100,1974
3010,12202,1,0,3010,0,830000,1959
2610,8481,2,0,2610,0,810000,1993
1440,15661,1,0,1180,260,500000,1988
1920,5405,1,2,960,960,490000,1947
1670,4200,2,0,1670,0,490000,1912
1390,10660,1,0,1030,360,272000,1960
2140,7200,2,0,2140,0,280000,1979
1250,6180,1.5,0,1250,0,233000,1955
1080,6000,1,0,1080,0,275000,1952
2760,6420,2,2,2110,650,375000,1991
2180,3703,2,0,2180,0,445000,2004
1260,1125,3,0,1260,0,437500,2002
1610,6000,1.5,0,1510,100,426250,1905
2450,12497,1,0,2450,0,358000,1967
4150,49503,2,0,4150,0,1.18E+06,2003
960,8276,1,0,960,0,305000,1939
1340,4664,1,0,1340,0,415000,2004
3000,4960,2,0,2400,600,520000,1918
3080,5974,2,0,3080,0,733000,2003
1130,8159,1,0,1130,0,411500,1954
2280,16671,1.5,0,1760,520,540000,1909
1952,8613,1,0,1652,300,270500,1960
1280,1256,2,0,1200,80,422250,1998
3690,12353,2,0,3690,0,655000,1977
4610,10576,2,3,3310,1300,1.20E+06,2006
2920,169448,2.5,0,2920,0,550000,1990
1230,929,2,0,1020,210,460000,2004
1580,6200,1,0,790,790,159075,1944
1220,4000,1.5,0,1220,0,470000,1908
1020,7920,1,0,1020,0,235000,1939
1510,9843,1,0,1510,0,309950,1961
1830,9600,1,0,1010,820,433000,1966
2750,10000,1,3,1650,1100,895000,1967
1860,60960,1,0,1140,720,291000,1967
2720,13124,2,0,2720,0,835000,1988
1360,5000,1,0,1200,160,640000,1936
2340,14279,1,0,1340,1000,438000,1965
2600,9935,2,0,2600,0,540000,2005
2090,7434,1,0,1090,1000,325000,1993
2260,7200,1.5,0,1360,900,380000,1924
1390,5544,1,0,930,460,510000,1947
2300,7707,2,0,2300,0,380000,2004
2810,9800,1,0,1710,1100,825000,1973
4060,52707,2,0,4060,0,880000,1996
2790,13295,2,4,2370,420,1.80E+06,1933
1290,6380,1.5,0,1290,0,790000,1930
720,4346,1,0,720,0,287000,1942
2130,5000,1.5,0,1570,560,509000,1913
1750,8400,1,0,1350,400,270000,1965
960,9380,1,0,960,0,210000,1949
1570,11752,1.5,0,1570,0,415000,1930
3070,14400,1,3,1720,1350,550000,1985
2920,5500,1,3,2030,890,1.25E+06,1957
1870,4984,1,0,1120,750,499950,1955
1540,5040,2,0,1540,0,659000,1907
1440,22081,2,0,1440,0,265000,1990
2810,10840,2,2,2070,740,492000,1994
2450,7700,1,0,1250,1200,715000,1958
1330,28270,1.5,0,1330,0,175000,1925
3130,52322,2,0,2430,700,975000,2011
730,5005,1,0,730,0,306950,1945
2480,3680,1.5,0,1470,1010,630000,1916
1270,8792,1,0,1270,0,367500,1969
2230,5460,1,1,1430,800,699950,1977
2880,3750,2,0,2220,660,1.00E+06,1909
2434,4400,2,0,2434,0,285000,2007
1120,1312,2,0,1000,120,215000,2004
4080,11054,2,0,4080,0,1.05E+06,2001
3720,9450,1,4,1960,1760,1.37E+06,1962
1430,7599,1.5,0,1010,420,235000,1930
1560,2589,1,0,790,770,604000,1923
1700,8400,1,0,1460,240,750000,1947
2510,9963,1,0,2200,310,800000,1967
2600,3750,1.5,0,1400,1200,580000,1914
790,4590,1,0,790,0,350000,1911
1710,7490,2,0,1320,390,353750,1956
2660,8737,1,4,1470,1190,1.10E+06,1969
1470,10291,1,0,1470,0,465000,1963
2350,5080,1.5,0,1780,570,568000,1929
2440,3080,2,0,2440,0,1.01E+06,1910
1150,11571,1,0,1150,0,213500,1961
1510,10384,1,0,1030,480,250000,1976
870,4600,1,0,870,0,357000,1942
1280,4095,2,0,1280,0,425000,1918
2600,7465,2,0,2600,0,571000,1988
2030,7350,1,0,1190,840,588000,1977
1930,15531,2,0,1930,0,275000,1979
3210,15939,2,1,3210,0,565000,1998
1970,9135,1,0,1370,600,460000,1961
4060,9734,1,4,2150,1910,603500,1977
3316,11447,2,0,3316,0,490600,1986
1460,9052,1,2,1460,0,1.01E+06,1900
2100,12620,1,0,2100,0,500000,1972
1830,6136,2,0,1830,0,249000,1990
1530,8700,1,0,1530,0,235000,1970
1490,13736,1,0,1490,0,410000,1942
860,6050,1,0,860,0,370000,1952
2130,7111,1,0,1330,800,360000,1968
3580,16789,2,0,3580,0,1.41E+06,1966
2420,3825,2,0,2420,0,298000,2003
1900,7200,1,0,1370,530,485000,1977
1330,9143,1,0,1330,0,400000,1960
2150,4604,2,0,2150,0,580000,2003
1370,1140,2,0,1080,290,355000,2009
2430,12997,2,0,2430,0,650000,1992
1640,8467,1,2,1220,420,261490,1943
1010,7200,1,0,1010,0,347000,1968
1500,4100,1.5,0,1370,130,485000,1926
1740,1251,2,0,1180,560,601000,2012
2090,51212,1,0,1510,580,380000,1989
1850,12556,2,0,1850,0,565000,1976
2790,21043,2,0,2790,0,750000,1993
1480,7200,1,0,1190,290,291000,1975
2280,12498,2,0,2280,0,560000,1987
3180,9600,2,0,3180,0,725000,1984
2350,209088,1,0,2350,0,539000,1993
3910,7077,2,0,2710,1200,470000,2000
770,7434,1,0,770,0,264950,1947
1780,8000,2,0,1080,700,200000,1900
2300,23345,1,0,1170,1130,453500,1967
2510,17986,2,0,2510,0,811000,1943
1410,1350,3,0,1410,0,425000,2005
4250,16940,1,2,2380,1870,1.53E+06,1974
2560,83200,1,0,1860,700,562000,1980
1760,7601,2,0,1760,0,281000,1992
2100,14027,2,0,2100,0,270000,1979
1490,8239,1,0,1490,0,205950,1963
870,5400,1,0,870,0,310000,1950
1260,1111,2,0,1260,0,350000,2003
2630,16475,2,0,2630,0,843500,1953
1950,3757,1,0,1160,790,370000,1908
2200,7700,1,0,1100,1100,279000,1979
1600,313672,1,0,1600,0,408000,1960
1230,9600,1,0,1230,0,392000,1952
1030,5000,1,0,1030,0,455000,1917
1040,83199,1,0,870,170,310000,1965
2240,11536,2,0,2240,0,323500,1943
1600,4489,1,2,800,800,364500,1944
2190,14439,1,0,1180,1010,280000,1977
1899,11325,2,0,1899,0,289900,1943
1870,2807,1.5,0,1580,290,585000,1927
1730,6653,1,0,1360,370,269000,1990
1860,9210,2,0,1860,0,280000,1994
1940,9000,1,0,1290,650,287000,1965
670,5140,1,0,670,0,183000,1926
1820,8142,1,0,1040,780,309000,1961
3810,13579,2,0,3810,0,920000,2003
2060,4800,2.5,0,2060,0,815241,1907
1520,7252,1,0,1140,380,405000,1975
3450,19080,2,3,3450,0,525000,2001
830,4045,1,0,830,0,150000,1943
1880,9600,1,0,1020,860,240000,1946
2200,11250,1.5,0,1300,900,698000,1920
1800,10950,1,0,1800,0,440000,1982
1200,12500,1.5,0,1200,0,204000,1936
2220,6641,1,2,1220,1000,875000,1947
1380,4500,1,0,1380,0,650000,1960
1660,8839,1,0,1660,0,392500,1947
2320,4000,1.5,0,1310,1010,400000,1921
2800,17300,1,0,1420,1380,653000,1971
1210,3760,1.5,0,1210,0,452000,1900
2331,3826,2,0,2331,0,345000,2007
1820,6930,1,2,1320,500,350000,1952
2860,5576,2,0,2860,0,650000,2004
2750,3800,1.5,0,1750,1000,525000,1926
2750,3800,1.5,0,1750,1000,840000,1926
2280,5000,2,3,2280,0,1.33E+06,1926
1610,6650,1,0,1610,0,259950,1989
3760,10207,2,0,3150,610,998000,1969
2940,4622,2,0,2230,710,1.07E+06,1988
4460,6833,2,0,3140,1320,1.91E+06,1955
1110,1150,2,0,940,170,190500,2007
2560,117176,1,0,1280,1280,465000,1977
1060,7419,1,2,1060,0,370000,1906
2810,11214,1,0,2010,800,290000,1958
1380,4590,1,0,930,450,350000,1950
1380,4590,1,0,930,450,740000,1950
2560,8400,1,0,1970,590,460000,1959
1010,10800,1,0,1010,0,290000,1972
1790,229125,2,3,1790,0,475000,1987
1600,2231,2,0,1600,0,214000,2003
910,5759,1,0,910,0,455000,1951
2497,4400,2,0,2497,0,275000,2007
1800,12196,1,0,1800,0,305000,1966
2570,61855,1,0,1470,1100,449000,1981
1320,4320,1,0,660,660,366000,1918
1670,5090,2,0,1670,0,348000,2003
2800,21370,2,0,2800,0,515000,2003
3360,11548,2,0,3360,0,950000,1988
2590,21494,2,0,2590,0,815000,1991
1530,2132,2,0,1530,0,199950,1993
1330,8100,1,0,1330,0,386000,1969
2160,7964,2,0,2160,0,273000,1991
1830,6360,2,0,1830,0,284000,1994
1470,7930,1,0,1070,400,399950,1950
1150,6423,1,0,590,560,285000,1927
1790,6452,2,0,1790,0,315000,2004
1700,7700,1,0,1120,580,250000,1960
1630,7618,1.5,0,1630,0,290000,1967
3420,30410,2,0,3420,0,725000,1988
1650,9641,1.5,0,1650,0,410000,1983
2810,52062,1.5,0,2810,0,855000,1988
2710,8127,2,0,2710,0,399900,1994
3320,11901,2,0,2650,670,852600,1977
720,6321,1,0,720,0,235000,1940
930,12724,1,0,930,0,230950,1912
1490,8722,2,0,1490,0,230000,1997
1690,1609,2,0,1150,540,404763,2014
1720,3407,2,0,1720,0,245000,1992
1140,8500,1,0,1140,0,188000,1964
2280,7219,2,0,2280,0,626100,1987
1100,4080,1,0,900,200,428750,1929
1800,8623,1,0,1360,440,522000,1980
2500,8434,2,0,2500,0,684000,1988
2950,7232,1,2,1520,1430,1.07E+06,1983
1940,6300,1,3,1940,0,611206,1963
1280,5250,1,0,1140,140,350000,1942
3800,22029,2,0,3800,0,894000,1993
930,5368,1,0,930,0,420000,1953
1930,9747,1,0,1020,910,400000,1962
2980,28000,1,0,1820,1160,675000,1981
2800,8494,2,0,2800,0,426000,2004
3190,11597,2,0,2300,890,750000,1984
1710,10800,1,0,1710,0,368000,1958
1980,6450,1,0,1120,860,342000,1950
1910,4800,1,0,1080,830,700000,1959
3160,5000,2,0,3160,0,848750,1989
1590,5200,1,0,1320,270,720000,1939
1890,8549,1,0,1890,0,525000,1967
2500,35245,1,0,1580,920,397900,2000
1740,18000,1,0,1230,510,405000,1989
1080,11856,1,0,1080,0,392800,1986
1730,7800,1,0,1330,400,394999,1958
2480,6112,2,0,2480,0,340000,2004
1450,1445,2,0,980,470,482500,2005
2750,10159,2,0,2750,0,812500,1991
2820,10208,1,1,1410,1410,450000,1954
1830,27468,1,0,1830,0,398000,1954
1550,1767,3,3,1550,0,1.08E+06,2006
1640,3021,1,2,840,800,540000,1959
1720,5472,1,0,860,860,275000,1923
2880,12000,2,0,2880,0,780000,1921
1220,8345,1.5,0,1220,0,225000,1931
1560,2250,2,0,1560,0,503045,2009
1090,1357,2,0,1090,0,249000,1990
1140,5940,1,2,1140,0,569950,1916
1040,1377,2,0,1040,0,450000,2003
2580,6000,1,0,1300,1280,1.10E+06,1950
2310,3570,1.5,0,1490,820,700000,1927
1590,4094,2,0,1590,0,454000,1991
1270,9170,1,0,1270,0,555000,1969
1240,5200,1,0,1240,0,214000,1970
2210,8622,2,0,2210,0,590000,1988
2340,51836,1.5,0,1510,830,459900,1978
1420,5000,1,0,920,500,205000,1987
1430,9857,1,2,1140,290,390000,1980
2470,10125,2,0,2470,0,970500,1960
2390,15084,2,0,2390,0,790000,2000
1120,10576,1,0,1120,0,320000,1969
2700,4025,2,0,1760,940,552500,1907
3490,4500,2.5,0,3170,320,1.05E+06,1924
1640,7187,1,0,1640,0,230000,1966
1620,5500,1,0,1110,510,680000,1950
1670,5400,2,0,1670,0,985000,1912
1870,7471,2,0,1870,0,375000,1990
1300,4000,1.5,0,1300,0,431000,1900
2190,17108,2,0,2190,0,463000,1991
1320,10500,1,0,1320,0,350000,1966
1250,7200,1,0,1250,0,485000,1964
2040,15000,1,0,1360,680,355000,1967
2140,7280,1,0,1070,1070,603500,1910
2510,6000,1.5,0,2010,500,860000,1920
2200,6250,2,0,2200,0,259875,1996
2170,8680,1,0,1220,950,685000,1959
2980,8786,2,0,2980,0,382500,2003
1180,2250,1.5,0,1180,0,490000,1902
1540,6000,1,0,1540,0,229000,1953
1540,6000,1,0,1540,0,430000,1953
3110,15783,1,0,1720,1390,580000,1974
1370,6700,1,0,1370,0,510000,1940
2440,20828,1.5,0,2440,0,489990,1975
1760,1800,2,0,1330,430,440000,1983
2810,4984,1,0,1750,1060,479950,2006
2500,206474,1,0,2500,0,806000,1997
3220,22588,2,0,3220,0,875000,1996
2880,36820,2,0,2880,0,710800,1992
2700,6037,2,0,2700,0,565000,2004
2680,9624,2,0,1870,810,359999,1995
1780,4500,1,0,920,860,625000,1922
2240,7565,2,0,2240,0,349950,1999
1610,9600,1,0,1610,0,415000,1967
1440,1170,2,0,960,480,435000,2004
1550,9060,2,0,1550,0,225000,1948
1720,5000,1,0,1720,0,770000,1954
1740,10800,1,0,1740,0,340000,1959
3280,12673,1,0,2050,1230,965000,1981
2216,31215,1,0,2216,0,667000,1968
1100,4373,1,0,820,280,250000,1947
1180,11862,1,0,1180,0,397990,1948
2020,10031,1,0,1370,650,535000,1952
1150,8450,1,0,1150,0,265950,1951
2090,7461,1,0,1200,890,258000,1986
1300,1187,3,0,1300,0,505500,2005
2240,7770,1,0,1340,900,455000,1978
3540,5971,1,2,2000,1540,1.35E+06,2005
2840,31720,1,0,1780,1060,600000,1958
2080,7047,2,0,2080,0,329800,1996
1550,38449,1,0,1550,0,222000,1947
1900,9240,1,0,1900,0,450000,1962
2760,4500,2,0,2120,640,952000,2004
1410,4480,1.5,0,1410,0,625000,1927
1240,11393,1,0,1240,0,226800,1960
4420,13497,2,0,3510,910,1.21E+06,2000
3390,16153,1,0,1970,1420,350000,1961
1400,8640,1,0,1400,0,395000,1962
2110,5260,2,0,1670,440,285000,2002
1310,18135,1,0,1310,0,553000,1948
1270,16800,1,0,1270,0,254000,1957
2060,10880,1,0,1190,870,348140,1924
2530,7350,1,0,1280,1250,354950,1977
1900,6400,1,0,1410,490,706000,1942
2910,6479,2,0,2910,0,499000,2006
1900,43186,1.5,0,1300,600,427500,1971
2880,10000,2,3,1980,900,439000,1991
2820,25995,2,0,2820,0,545000,1998
1620,4774,1.5,0,1620,0,842000,1920
3320,38043,2,0,3320,0,685000,1997
3770,47480,2,0,3770,0,665000,2003
1200,9000,1,2,1200,0,255000,1917
2130,4360,1,2,1240,890,565000,1959
1950,8720,1,0,1050,900,274000,1962
1920,8075,1,0,1510,410,260000,1969
2510,13695,1,0,1280,1230,581000,1961
1990,5978,1.5,4,1990,0,625000,1926
1230,9720,1,0,1230,0,220000,1969
3190,324086,2,2,3190,0,765000,1982
5720,10213,2,0,4170,1550,1.33E+06,2004
2280,3000,1.5,0,1210,1070,700000,1911
1550,7260,1,0,1550,0,351000,1959
1690,1613,2,0,1150,540,413565,2014
1651,1779,2,0,1341,310,363000,2008
2260,41236,1,0,1690,570,679000,1962
1510,4555,1,0,1510,0,473000,2005
1490,7431,1,0,1490,0,585888,1966
2220,4652,2,0,2220,0,405000,2001
2800,19386,1,4,1400,1400,650000,1965
2210,213008,1,0,1210,1000,415000,1975
2150,3880,1,0,1080,1070,575000,1951
1400,7205,1,0,1140,260,220000,1985
2450,10117,1,0,1580,870,610000,1967
980,6380,1,0,760,220,499950,1941
2800,6874,2,0,2170,630,883000,1990
1240,8100,1.5,2,1240,0,436000,1925
1610,1356,2,0,1240,370,320000,2007
1510,44000,1,0,1240,270,425000,1989
1670,9987,1,0,1670,0,204700,1967
2320,4502,1,0,1200,1120,384000,1987
1900,8200,2,0,1900,0,314000,1984
2390,6263,2,0,2390,0,535000,2003
2110,265716,1,0,2110,0,568000,1979
1470,5850,1,0,810,660,426000,1973
2670,6780,2,3,1630,1040,675000,1908
2540,6365,2,0,1870,670,380000,2000
3450,8000,3,0,2970,480,685000,1927
1700,52826,1,0,1700,0,429000,1991
1810,6583,1,0,1500,310,799000,1968
1550,6986,1,0,1030,520,318500,1978
4110,20900,2,0,2630,1480,925000,2002
2080,5000,1,0,1300,780,420000,1963
1100,4000,1,0,1100,0,570000,1906
3950,12840,2,0,3950,0,1.05E+06,1960
1250,8450,1,0,1250,0,333000,1954
2620,14138,2,4,2120,500,1.36E+06,1931
2290,2798,3,0,2290,0,660000,1953
3500,8504,2,0,3500,0,350000,1980
3500,8504,2,0,3500,0,682500,1980
1690,4000,1,0,970,720,399990,1943
4500,9648,2,4,3000,1500,860000,1968
1120,7797,1,0,1120,0,216180,1948
1740,9613,2,0,1740,0,300000,1989
1010,11880,1,0,1010,0,145000,1960
1010,11880,1,0,1010,0,255000,1960
1200,24805,1,0,1200,0,250000,1984
1020,8625,1,0,1020,0,245000,1978
1850,7056,2.5,0,1850,0,445000,1979
1830,8000,1,0,1830,0,562000,1957
2070,7519,1,0,1160,910,501000,1963
1160,5850,1,0,1160,0,190000,1918
3280,24440,2,0,3280,0,862500,1996
2340,6000,2,0,2340,0,1.09E+06,1922
3690,49709,1,2,2690,1000,575000,1960
720,123710,1,0,720,0,250000,1935
2660,15111,1.5,0,2660,0,310000,1962
4300,9270,2,3,2910,1390,1.40E+06,1957
1590,8256,1,1,1090,500,284850,1969
2590,7910,2,0,2590,0,570000,2003
1720,6000,1,2,1000,720,304000,1954
1790,9787,1,2,1240,550,560000,1983
1590,8160,1,1,1090,500,325000,1954
1580,4800,1.5,2,1580,0,557510,1912
2580,8820,1,0,1620,960,305000,1967
1740,27350,1,0,1740,0,320000,1958
3470,28212,1.5,0,2790,680,455000,1978
1180,7210,1,0,1180,0,383001,1963
1700,51649,1.5,0,1700,0,545000,1931
1190,5000,1,0,1190,0,487500,1925
2450,6994,2,0,2450,0,345000,2002
2630,16411,1,0,1650,980,583000,1974
2130,12286,2,0,2130,0,534950,1977
1060,5750,1,0,950,110,403504,1904
1480,6120,1.5,0,1480,0,500000,1946
1610,38707,1,0,1610,0,319502,1990
2440,5080,2,0,1750,690,525000,1960
3100,15480,2,0,2400,700,563000,1996
2890,5000,1.5,0,1990,900,898500,1911
3240,108366,2,0,3240,0,651000,1991
2900,6400,2,0,2040,860,450000,1911
2650,8149,1,0,1610,1040,665000,1975
2560,4000,2,0,1610,950,825000,1929
1150,4800,1.5,0,1150,0,200000,1938
1760,6092,1,0,1760,0,295000,1998
3220,8379,2,0,3220,0,748000,2004
3200,18750,1,0,2660,540,580000,1967
1250,10744,1,0,1250,0,275000,1942
1000,8470,1,0,1000,0,196000,1963
740,11250,1,0,740,0,235750,1938
2170,8480,1,0,2170,0,315000,1965
2370,10631,2,0,2370,0,338000,1999
2300,4249,2,0,2300,0,353000,2006
1400,6300,1,0,1400,0,235000,1998
3080,13880,2,0,3080,0,569999,1990
2350,12540,2,0,2350,0,505000,1968
2660,4600,1.5,0,1820,840,1.23E+06,1906
1250,34395,1,0,1250,0,299000,1950
1100,6360,1,0,1100,0,240000,1991
3330,12566,1,4,1940,1390,1.96E+06,1960
3640,3604,2,2,1960,1680,1.27E+06,1913
1350,2653,2,0,1350,0,405000,1986
1310,8454,1,0,1310,0,304000,1953
1800,5555,2,0,1800,0,272000,2003
1260,3960,1,0,690,570,412000,1925
2990,7231,2,0,2990,0,698000,2001
1140,5100,1,0,1140,0,400000,1942
2100,6825,2,0,2100,0,305000,1994
2400,12753,1,0,2400,0,585000,1962
1400,9031,1,0,960,440,190000,1982
2990,12788,2,0,2990,0,760000,1988
1930,36210,1,0,1930,0,570000,1977
980,6800,1,0,980,0,144000,1946
690,5280,1,0,690,0,139000,1942
1430,6380,1.5,0,1130,300,525000,1945
1110,5421,1,0,1110,0,293000,1935
1250,1580,2,0,1030,220,267100,2005
3470,5222,2,0,2830,640,1.50E+06,2005
1500,15334,2,0,1500,0,240000,1992
2530,7000,2.5,4,2530,0,975000,1915
2150,7171,1,0,1460,690,279950,1970
1260,7373,1,0,1260,0,405000,1979
2740,83199,2,4,2740,0,400000,1973
960,6500,1,0,960,0,225000,1954
1520,7800,1,0,1120,400,250000,1967
1570,9096,1,0,1180,390,272950,1991
3240,5324,2,0,3240,0,625000,2007
1280,2147,1.5,0,1280,0,670000,1910
2130,3545,3,0,2130,0,1.07E+06,1990
1970,8200,1,0,1420,550,540000,1963
2990,6725,2,0,2990,0,525000,2003
1160,17700,1,0,1160,0,425000,1947
1890,7004,1,0,1290,600,465500,1965
2170,5866,2,0,2170,0,443500,2006
1570,499571,1,3,1570,0,350000,1972
3260,91911,2,0,3260,0,850000,1984
1250,952,3,0,1250,0,205000,2008
1940,10200,1,0,1140,800,315000,1977
2150,8221,2,0,2150,0,470000,1992
3310,8540,1,4,1660,1650,1.10E+06,1973
3400,46382,1,0,2050,1350,340000,1979
2660,12672,1,0,1740,920,310000,1960
950,13475,1,0,950,0,305000,1950
1480,6752,1,0,1480,0,307150,1959
2840,12866,1,0,1780,1060,729032,1977
3240,9960,1,1,2020,1220,750000,1958
1961,3207,2,0,1961,0,289000,2006
1100,5700,1,0,1100,0,480000,1950
1500,7367,1,0,1500,0,529000,1974
1480,4800,2,0,1140,340,585000,1944
2510,12500,1,0,2050,460,704000,1976
1490,4054,1.5,0,1490,0,607000,1926
2190,8188,2,0,1810,380,580000,1978
2530,8564,2,0,2530,0,875000,1976
2440,9350,1,0,1560,880,610000,1976
1040,15000,1,0,1040,0,230000,1941
2450,62290,2,0,2450,0,510000,1976
2210,5002,1,0,1370,840,733000,1977
1050,18304,1,0,1050,0,169100,1953
1050,18304,1,0,1050,0,250000,1953
2730,35100,2,0,2730,0,500000,1977
1620,9855,1,4,1320,300,700000,1948
2410,5225,2,0,2410,0,379000,2001
3420,222156,2,0,3420,0,650000,2002
920,4400,1,0,920,0,412133,1948
2330,14190,1,0,1740,590,480000,1962
1940,10245,1,0,1940,0,650000,1957
1900,5065,2,0,1900,0,505000,2005
3510,17400,1,0,1930,1580,931088,1957
1860,7700,1,0,1860,0,570000,1964
1380,4635,1,0,1380,0,475000,1919
2210,8594,1,0,1310,900,240000,1959
2640,47480,1,0,1590,1050,462000,1979
4530,22873,2,2,3220,1310,1.12E+06,1912
1500,6600,1,0,1500,0,243000,1970
2010,15375,1,0,2010,0,660000,1957
2080,8112,1,4,1040,1040,1.19E+06,1939
5584,68257,2,0,5584,0,1.68E+06,1998
9890,31374,2,4,8860,1030,6.89E+06,2001
2080,4307,2,0,2080,0,368000,2004
3970,4500,2,0,2860,1110,811500,2004
770,8149,1,0,770,0,275000,1948
2500,6005,2,0,2500,0,650000,2001
2410,50654,1.5,0,2410,0,485000,1995
1340,10018,1,0,1340,0,425000,1976
2640,13775,1,0,1550,1090,530000,1978
2740,8520,1,2,1370,1370,657000,1954
1580,3770,1,0,1080,500,315000,2002
2180,22870,1,0,1280,900,273000,1954
1960,13252,1,0,1240,720,550000,1975
1560,1705,2,0,1270,290,347000,2006
2440,8000,1,0,1240,1200,525000,1972
990,1343,2,0,840,150,490000,2007
2210,7916,2,0,2210,0,500000,1978
3080,7282,2,0,3080,0,585000,2008
2900,17802,1,2,1750,1150,926500,1981
1020,3200,1,0,1020,0,465000,1927
1900,8160,1,0,1900,0,200000,1975
5770,16747,2,3,4500,1270,1.68E+06,1998
990,57499,1,0,990,0,220500,1949
990,57499,1,0,990,0,329000,1949
2080,2250,3,4,2080,0,715000,1997
2080,2250,3,4,2080,0,780000,1997
1480,4080,1,0,1050,430,410000,1949
1480,4080,1,0,1050,430,778100,1949
1090,11292,1,0,1090,0,406000,1952
2800,5900,1,0,1660,1140,665000,1963
1000,8212,1,0,1000,0,305000,1947
1640,7668,2,0,1640,0,265000,1991
1620,4080,1.5,0,1620,0,485000,1923
2460,108900,1,0,1860,600,600000,1977
1860,5100,1,0,1060,800,510000,1940
1080,3899,1,0,1080,0,195000,1972
1980,5100,1,0,1270,710,432500,1965
1510,8433,1,0,1220,290,490000,1967
1690,7165,2,0,1690,0,270000,1992
1010,2102,2,0,1010,0,370000,1984
2090,12027,2,0,2090,0,327500,1991
1060,6120,1,0,1060,0,826000,1908
1750,7020,2,0,1750,0,510000,1934
890,4730,1,0,890,0,587750,1941
3020,24750,1,0,1650,1370,449228,1965
2030,217805,1,0,2030,0,565000,1999
3170,186436,2,0,3170,0,660000,2000
2470,19200,1,0,1250,1220,400000,1977
2060,5000,1,0,1030,1030,612500,1949
2120,6250,1,0,1060,1060,560000,1917
2180,4200,1.5,0,1520,660,727000,1939
2300,7609,2,0,2300,0,224000,1976
4200,35267,2,0,4200,0,1.08E+06,1990
1480,7565,1,0,1220,260,439000,1977
2240,87625,1.5,0,1480,760,335000,1980
2740,4912,1,0,1370,1370,779000,1937
1830,47916,1.5,0,1830,0,452000,1948
2000,5304,1.5,0,2000,0,775000,1947
1380,8362,1,0,1380,0,235000,1967
1620,37913,2,0,1620,0,370000,1953
3180,12070,2,0,3180,0,790000,1976
1140,7800,1,0,1140,0,903000,1947
970,9583,1,0,970,0,209950,1967
1780,7859,2,0,1780,0,309000,1988
2240,8153,1,0,1120,1120,440000,1948
2810,25990,2,0,1860,950,571500,1959
920,4000,1,0,920,0,514000,1906
1830,12500,1,1,1200,630,323000,1947
1560,7575,1,0,1560,0,290000,2002
5540,15408,2,1,4280,1260,2.58E+06,2006
2310,21318,1,0,2310,0,1.36E+06,1979
1470,5100,1.5,0,1470,0,551000,1946
3430,43560,1.5,2,3430,0,960000,1979
2900,9525,2,0,2900,0,720000,1989
1850,7684,1,0,1320,530,218000,1979
2190,7000,2,0,2190,0,334950,1997
2510,31584,2,0,2510,0,605000,1979
3200,4477,2,0,2390,810,825000,2006
1670,8000,1,0,1670,0,268500,1974
1010,9600,1,0,1010,0,230000,1969
5050,202554,2,0,3260,1790,1.34E+06,2000
1430,9782,1,0,1430,0,245500,1955
1880,7989,1,0,1280,600,440000,1982
2180,5799,2,0,2180,0,571500,1993
1830,4744,2,0,1830,0,182500,1997
970,5600,1,0,970,0,217000,1951
1170,5248,1,0,1170,0,335000,1941
1010,4320,1,0,1010,0,501000,1924
2140,7641,1,0,1290,850,339950,1979
2230,10403,1,0,1630,600,340000,1968
1140,23779,1.5,0,1140,0,582500,1966
860,8189,1,0,860,0,298800,1948
2540,8400,1,0,1340,1200,317500,1977
2420,5118,1.5,2,1550,870,598000,1926
1640,2240,2,0,1640,0,375000,1980
2550,7650,2,2,2550,0,465000,1996
2507,18400,2,0,2507,0,551870,2006
1920,7229,2,0,1920,0,295000,1993
2210,6375,1,0,1640,570,263500,1977
3530,8400,2,0,2630,900,1.10E+06,1958
1100,4010,1.5,0,1100,0,300000,1920
3390,4500,1.5,0,2190,1200,780000,1924
1590,7936,1,0,1590,0,325000,1956
820,6550,1,0,820,0,370000,1949
2370,10000,1,0,1660,710,715000,1974
1600,12500,1,0,1600,0,356000,1938
1740,7208,1.5,0,1740,0,329950,1976
1470,2500,2,0,1080,390,490000,1984
1410,1246,3,0,1410,0,429000,2005
1620,8125,2,0,1620,0,510000,1983
2360,4080,2,0,2360,0,550000,2003
1830,6453,1,0,1830,0,467500,1956
2130,4180,1.5,0,1270,860,615000,1926
990,15120,1,0,990,0,325000,1953
1010,4120,2,0,1010,0,219950,1907
1720,9830,1,0,1720,0,950000,1946
1630,3200,1.5,0,1630,0,925000,1912
1310,8250,1,0,1060,250,251200,1953
1610,5304,1,0,1610,0,215000,1968
1850,8208,1,0,1180,670,245000,1970
1270,4815,1.5,0,980,290,259000,1922
1420,6720,1.5,0,1420,0,349950,1925
5220,67319,2,0,5220,0,1.57E+06,2001
1410,4500,1,0,1020,390,600000,1939
1170,1274,3,0,1170,0,405000,2001
1860,10027,2,0,1860,0,625000,1993
1620,37075,1.5,0,1620,0,430000,1943
1280,1085,3,0,1280,0,533000,2004
2750,9949,2,0,2750,0,1.05E+06,1999
1420,3000,1,0,710,710,230000,1931
2000,8700,1,0,1010,990,275000,1975
1100,3598,1,0,1100,0,403000,1926
1720,70567,1,2,1720,0,550388,1966
1240,12400,1,0,1240,0,415500,1958
2170,4000,1,0,1110,1060,913000,1925
1800,5182,1,0,900,900,334998,1942
1160,8320,1,0,1160,0,201500,1959
3030,46538,2,0,3030,0,820000,1997
890,7200,1,0,890,0,371000,1951
2150,7670,1,0,1240,910,229950,1976
2150,7670,1,0,1240,910,344900,1976
2060,9715,2,0,2060,0,840000,1924
1380,12196,1,0,1380,0,285000,1967
1800,7200,1,0,1230,570,475000,1979
1460,7832,1,0,1460,0,420000,1924
2210,5000,1.5,2,1710,500,685000,1909
3590,89640,2,0,3590,0,879000,2005
1140,8775,1,0,990,150,197200,1942
1240,5000,1.5,0,1240,0,529950,1909
4340,141570,2.5,0,4340,0,1.09E+06,1992
1570,1050,2,0,1570,0,792000,1915
1680,10300,2,0,1680,0,262000,1994
1560,5760,1,0,780,780,353900,1927
1200,44866,1.5,0,1200,0,380000,1983
1690,5175,2,0,1690,0,305000,2002
2310,5004,1,0,1430,880,440000,1994
2650,3060,2,0,2060,590,1.01E+06,2001
3610,7555,2,0,3610,0,549900,2003
2620,214750,2,0,2620,0,678500,1992
1760,8287,1,0,1160,600,270000,1986
940,12521,1.5,0,940,0,430000,1949
4830,8050,2.5,2,3710,1120,1.93E+06,1914
3350,5416,2,0,3350,0,790500,2014
1570,7200,2,0,1570,0,447450,1991
2240,5200,1,0,1630,610,375000,1954
1950,9940,1,0,1950,0,565000,1963
1010,3916,1,2,810,200,400000,1918
1630,10200,1,0,1300,330,246000,1976
1420,6289,1,0,1100,320,329922,1967
3950,44431,1,0,2100,1850,1.25E+06,1969
1210,7425,1,0,1210,0,375000,1910
1890,9920,1,0,1230,660,385000,1944
1690,4080,1.5,0,1140,550,591500,1912
2560,12155,1,0,1350,1210,255000,1960
1350,7800,1,0,1350,0,275000,1959
3120,5000,2,0,3120,0,800000,2010
1140,7435,1,0,1140,0,327000,1952
2230,11536,1,1,1220,1010,355000,1954
1050,8220,1,0,780,270,310000,1947
4180,49222,2,0,2880,1300,869000,1979
1200,5700,1,0,1200,0,272000,1942
3320,60984,2,0,3320,0,665000,2000
1590,8449,2,0,1590,0,225000,1989
2750,37096,2,0,2750,0,375000,1989
1530,7200,1,0,1530,0,375500,1975
1570,6500,1,0,920,650,550000,1948
1470,7680,1,0,1220,250,248000,1946
1470,7680,1,0,1220,250,546940,1946
3150,6175,2,0,3150,0,680000,2001
2380,6124,2,0,2380,0,350000,1997
2000,2500,3,1,1810,190,593000,1994
1140,8147,1,0,1140,0,390000,1958
1340,18000,1,0,1340,0,297000,1924
1450,9150,1,0,1450,0,355000,1965
2020,26670,2,0,2020,0,309900,1987
1810,12000,2,0,1810,0,257000,1992
3600,9687,2,0,3600,0,1.70E+06,1959
1260,2550,2,0,1260,0,300000,1987
1560,1156,3,0,1560,0,500000,2014
4020,7500,1,0,2010,2010,900000,1968
3150,9130,2,0,3150,0,695000,2001
1680,6655,2,0,1680,0,213400,2001
1320,8830,1,0,1020,300,425000,1939
2700,47050,2,0,1570,1130,420000,1986
1080,5000,1.5,0,1080,0,411000,1948
3130,41382,2,0,3130,0,762500,1986
4850,40902,2,0,4850,0,569950,2001
1220,8500,1.5,0,1220,0,258000,1916
1780,3665,2,0,1780,0,499000,2004
1250,10723,1,0,1250,0,310000,1961
1780,1311,3,0,1350,430,398500,2005
1930,8660,1,0,1120,810,250600,1981
2470,6116,1,0,1420,1050,352000,1985
1180,2160,1,1,940,240,600000,1909
2270,4182,1,0,1170,1100,645000,1946
1770,5000,2,0,1770,0,291500,2004
2250,13515,1,0,2150,100,350000,1940
1540,7280,1,0,1080,460,279000,1974
820,5400,1,0,820,0,320000,1940
1580,5203,1,0,1580,0,495000,2004
2430,42646,1,0,1450,980,490000,1989
2160,5000,1.5,2,2160,0,770000,1926
1770,29004,1,0,1770,0,215000,1959
3580,95832,1.5,0,3580,0,665000,2005
1890,7498,1,0,1190,700,423500,1987
1910,4800,1.5,0,1910,0,850000,1900
910,6232,1,0,910,0,155000,1943
1460,7210,1,0,1460,0,505000,1963
3310,5558,2,0,3310,0,780000,2005
1630,22764,1,0,1630,0,165000,1970
2130,5001,1,0,1330,800,707000,1972
1220,1475,3,0,1220,0,497000,2000
1670,8856,1,2,1070,600,349170,1955
1300,10050,1.5,0,1300,0,287000,1963
3220,20251,1,0,3220,0,2.38E+06,1969
2430,14400,1,0,1670,760,645000,1963
2240,9652,2,0,2240,0,238000,1990
2240,9652,2,0,2240,0,328000,1990
790,1123,2,0,700,90,365000,2003
1380,8147,1,0,1380,0,380000,1948
1680,10500,2,0,1680,0,525000,1962
2000,3672,2,0,1650,350,402000,1926
1680,9250,1,0,860,820,308000,1969
1960,6997,2,0,1960,0,405000,2006
2590,32380,1,0,2590,0,808000,1951
3790,6874,2.5,0,3790,0,875000,2010
2370,55321,3,0,2370,0,860000,1982
1930,7925,1,0,1300,630,367500,1960
2580,13572,1,0,1290,1290,604000,1987
890,19703,1,0,890,0,230000,1934
2160,8148,1,0,1410,750,435000,1978
1970,7098,2,0,1970,0,347500,2007
1570,16697,1,2,1030,540,525000,1981
1480,15641,1,0,1480,0,280000,1940
1480,15641,1,0,1480,0,490000,1940
1430,5490,1,0,1430,0,265000,1942
2720,18295,1,0,2000,720,645000,1979
2420,31497,1,0,1750,670,390000,1964
1400,7629,1,0,1120,280,267500,1988
5844,10766,2,1,5844,0,1.28E+06,2007
1840,10720,1,0,960,880,404000,1958
2530,12042,2,0,2530,0,380000,1989
2810,10300,1,0,1810,1000,812500,1978
1020,8610,1,0,1020,0,265000,1959
2550,7725,1,0,1390,1160,480000,1967
710,4725,1,0,710,0,264000,1939
5530,38816,1.5,2,5530,0,1.35E+06,1969
2150,9000,1,0,1110,1040,550000,1966
880,2400,1.5,0,880,0,615000,1929
1630,28600,1,0,1630,0,464000,1967
1380,30940,2,0,1380,0,365000,1976
2800,10800,1,0,1680,1120,490000,1977
2070,7350,2,0,2070,0,280927,1977
830,6017,1,0,830,0,282613,1954
2770,15886,2,0,2770,0,675000,1982
2060,7475,1,0,1440,620,575550,1985
1490,7770,1,0,1490,0,259900,1990
2120,8267,2,0,2120,0,450000,1996
2810,6296,2,0,2810,0,487500,2013
2400,17842,2,0,2400,0,275000,1973
2460,5027,2,0,2460,0,305000,2002
2030,217800,1,2,2030,0,395000,1977
880,7648,1,2,880,0,215000,1940
1320,6000,1.5,0,1320,0,410000,1920
2160,7826,1,0,1390,770,440000,1976
4190,15724,2,2,4190,0,1.16E+06,1994
2280,7200,1,0,2280,0,500000,1956
2590,6120,2,0,2590,0,961000,1909
2770,9340,2,0,2770,0,825000,1979
2145,3840,1.5,0,2145,0,734000,1910
4480,5715,2,0,3680,800,490000,2003
1780,6000,2,0,1780,0,175000,1991
720,4800,1,0,720,0,190000,1914
2050,12581,2,0,2050,0,305000,1978
2040,7936,1,3,1680,360,1.30E+06,1940
920,6600,1,0,920,0,417000,1919
680,4190,1,0,680,0,275000,1906
1940,8196,2,0,1940,0,661000,1991
2230,9640,1,0,1320,910,435000,1998
2910,9454,1,1,1910,1000,788000,1972
5270,17232,2,1,4010,1260,1.80E+06,1977
2820,6589,1.5,0,2320,500,408000,1906
1790,3760,1.5,0,1490,300,570000,1912
2920,6960,2,1,2120,800,1.54E+06,1953
840,5510,1,0,840,0,400000,1955
1820,8740,1,0,1820,0,247000,1987
1550,7200,1,0,1100,450,453000,1949
1270,3008,1,0,650,620,235000,1923
2460,5750,1.5,3,1620,840,675000,1919
2110,5150,1,0,1080,1030,516200,1919
920,91476,1.5,0,920,0,650000,1996
1500,10227,1,0,1000,500,257100,1945
1440,9985,1,0,1440,0,457000,2006
1610,3478,1.5,0,1060,550,540000,1929
1970,10270,1,0,1970,0,268000,1966
1150,7314,1,0,1150,0,300000,1960
2110,114127,1,0,1590,520,380000,1975
3580,54450,1.5,0,3580,0,725000,1990
1000,19204,1,0,1000,0,249000,1968
1680,9383,1,0,1400,280,274000,1929
3950,10912,2,0,3950,0,1.78E+06,2003
2390,7149,1,0,1350,1040,396500,1955
1820,7800,1,0,1240,580,460000,1956
1100,8536,1,0,1100,0,277000,1957
2280,5275,1,0,1270,1010,449500,1998
2530,4560,1.5,0,1540,990,785950,1925
1940,9775,1,2,1440,500,545000,1975
1360,9688,1,0,1360,0,244000,1983
1660,2415,2,0,1660,0,165000,1983
800,5000,1,0,800,0,435000,1906
2670,10082,1,0,2670,0,642000,1987
1720,4120,2,0,1720,0,340000,1999
3550,35689,2,0,3550,0,730000,1991
1370,2800,1,0,800,570,563250,1982
2820,67518,2,0,2820,0,675000,1979
1620,6630,1,0,1280,340,620000,1954
1290,9041,1,0,950,340,275000,1956
1830,8209,1,0,1830,0,270000,1942
2040,5472,2,0,2040,0,325000,2003
1850,1836,2,0,1600,250,476100,2005
1300,12000,1,0,1300,0,700000,1959
1620,5200,1.5,0,1620,0,220000,1978
1560,10919,1,0,1560,0,236000,1975
2600,4750,1,0,1700,900,790000,1951
2010,6000,1,0,1210,800,350000,1967
780,5300,1,0,780,0,130000,1941
1982,6406,2,0,1982,0,283200,2004
1500,6250,1,0,890,610,273000,1945
2460,8710,1,0,1330,1130,599000,1976
2680,11998,1,3,1510,1170,460000,1960
5860,52889,2,0,4910,950,1.16E+06,1996
1720,8750,1,0,860,860,385000,1971
1420,7420,1.5,0,1420,0,264250,1944
1760,1472,3,0,1640,120,608000,2006
2790,48994,2,0,2790,0,450000,1984
2360,4800,2,0,2360,0,1.76E+06,1909
1890,6050,2,0,1890,0,339950,1944
3810,6150,2,0,3810,0,760000,1977
1160,5395,1,0,860,300,350000,1940
2320,55847,1,2,2320,0,541500,1960
3280,16449,1,0,1910,1370,730000,1963
980,5600,1,0,980,0,215000,1949
1640,9972,1,0,1640,0,420000,1977
2060,8470,1,0,1440,620,655000,1983
1500,10652,2,0,1500,0,240000,1981
2360,6000,1,0,1260,1100,730000,1939
1940,12100,1,0,1940,0,390000,1962
1280,10000,1,0,1280,0,473000,1954
3630,5670,2,0,3630,0,698000,1970
1820,4883,2,0,1820,0,511000,2005
960,1808,2,0,960,0,358000,1993
1630,8400,1,0,1060,570,499990,1955
1940,10200,1,0,1360,580,322000,1960
980,9682,1,0,980,0,201000,1969
3140,16200,1,1,2570,570,765000,1988
2880,5750,1.5,0,1710,1170,920000,1928
1650,7552,1,0,860,790,360000,1977
1980,9220,2,0,1980,0,297300,1987
860,9403,1,0,860,0,399000,1942
1430,10005,1.5,0,1430,0,400000,1950
1260,10164,1,0,1260,0,230000,1964
960,4560,1,0,960,0,290000,1968
2060,7658,2,0,2060,0,323800,2003
1430,6380,1.5,0,1430,0,574500,1930
1670,1596,2,0,1220,450,505000,2002
880,10950,1,0,880,0,372500,1944
1300,19163,1,0,1300,0,425000,1964
2380,214315,1.5,0,2380,0,446250,2000
520,6862,1,0,520,0,330000,1924
2680,17707,2,1,2680,0,608095,1983
2140,10136,1,0,1320,820,550000,1958
1820,16103,2,0,1820,0,265000,2004
1820,8255,1.5,0,1320,500,399888,1930
1050,2570,1,0,850,200,430000,1927
2100,6092,2,0,2100,0,554990,2013
2210,6280,2,0,2210,0,359950,2003
860,2599,1,0,860,0,405000,1901
870,4025,1,0,870,0,280000,1981
2570,11070,2,0,2570,0,479950,1966
2980,53578,1,0,2230,750,575000,1976
2360,7733,2,0,2360,0,392000,1983
2310,36136,2,0,2310,0,760500,1977
2300,9521,2,0,2300,0,435000,2003
2810,8570,2,0,2810,0,1.57E+06,1993
2040,10488,1,0,1190,850,261000,1961
3290,5000,2,0,2730,560,1.48E+06,1939
2960,2665,2,0,1950,1010,853800,1927
2670,10496,2,0,2670,0,657500,1989
2530,9933,2,2,2010,520,331950,1990
1720,5899,1,1,1220,500,514000,1986
3090,27598,2,2,2020,1070,496000,1995
3930,21894,2,0,3930,0,1.09E+06,1987
1120,5200,1,0,1120,0,195700,1976
3960,8640,2,2,2630,1330,1.40E+06,1925
4060,20822,2,0,4060,0,1.18E+06,1991
2350,9648,1,0,2350,0,643403,1966
2380,7066,2,0,2380,0,357000,1997
1480,8163,1,0,1040,440,865000,1953
2930,9280,2,0,2930,0,905000,1988
1290,7100,1,0,1290,0,265000,1954
2730,7246,2,0,2730,0,535000,1998
1290,5440,1,0,790,500,450000,1929
2170,7533,2,0,2170,0,460500,1991
1850,8580,1,0,1140,710,315000,1960
2110,13939,1,0,1270,840,607500,1978
960,3235,1,0,960,0,432000,1916
3910,5350,2,2,2610,1300,1.70E+06,1933
2590,6139,2,0,2590,0,479000,2001
3080,6600,2,0,3080,0,475000,2002
1630,8146,1,0,1630,0,415000,1952
910,5000,1,0,910,0,450000,1914
2780,33503,1.5,1,2110,670,1.14E+06,1969
3880,8432,2,0,3880,0,430000,2004
1360,10742,1,0,960,400,296000,1971
2560,8927,1,0,1790,770,303000,1976
2600,6015,2,0,2600,0,641000,2004
1220,5739,1,0,790,430,280000,1984
1560,9635,1,0,1260,300,260750,1966
2080,5191,2,0,2080,0,601000,2001
1490,6604,1,0,1490,0,255000,1918
2020,10720,1,0,1420,600,555000,1976
1530,10827,1,0,1530,0,865000,1955
3450,17400,1.5,0,2180,1270,1.39E+06,1964
1400,31626,1,0,1140,260,315000,1987
1730,9610,1,0,1380,350,200000,1962
1370,6450,1,0,1370,0,357000,1948
1050,934,2,0,960,90,390000,2007
2840,10220,1,0,2210,630,462000,1954
1010,5200,1,0,1010,0,174500,1955
1210,7140,1.5,0,1210,0,305000,1921
1720,14040,1,0,1150,570,449000,1956
2710,5000,2,0,2710,0,260000,1951
3110,6142,2,0,3110,0,751000,2004
1250,9270,1,0,1250,0,370037,1948
1900,8910,2,0,1900,0,229950,1988
1740,7682,1,0,1330,410,349000,1978
2070,3808,2,0,2070,0,348000,2003
3030,5600,2,2,2220,810,1.22E+06,1905
3610,18948,2,0,3610,0,510000,1993
1520,6805,1,0,1040,480,265000,1981
2780,4815,3,2,2780,0,1.25E+06,1974
5545,871200,2,0,3605,1940,937500,2003
2590,8384,1,0,1590,1000,485000,1971
1150,5217,1.5,0,1150,0,489000,1951
920,5120,1,0,920,0,400000,1952
2110,3600,2,0,2110,0,638000,2005
1170,8740,1,0,1170,0,440000,1968
1900,8240,1,0,1200,700,305000,1964
1900,8240,1,0,1200,700,649950,1964
3290,6012,2,0,3290,0,680000,2005
2660,22050,2,0,2660,0,629000,1996
2160,7584,2,0,2160,0,555000,1988
2700,35362,2,0,2700,0,669000,1976
1980,6608,2,0,1980,0,272000,1994
2600,9900,1,0,1600,1000,270000,1965
1280,9775,1,0,1280,0,215000,1964
1710,17707,1,0,1180,530,690000,1947
1270,6825,1,2,1270,0,256000,1950
1890,7314,1,0,1100,790,255000,1981
3440,8100,2,0,3440,0,550000,1970
1190,5280,1,0,1190,0,410000,1957
1030,4366,1,0,1030,0,410000,1912
1240,4000,1,0,1240,0,259000,1986
1730,21183,1,0,1030,700,292000,1955
4610,12500,2,2,4610,0,1.65E+06,2003
1590,5000,1.5,0,1190,400,518000,1929
1760,3097,2,0,1760,0,485000,1992
1330,35060,1,0,1330,0,259500,1989
2340,5420,2,0,2340,0,354000,2003
3740,22464,2,0,2330,1410,999950,1966
1150,10466,1,0,1150,0,464500,1959
1750,4200,2,0,1750,0,300000,2005
3890,7216,2,1,3260,630,1.08E+06,1967
1770,6666,2,0,1770,0,309950,1989
1160,3700,1.5,0,1160,0,315000,1909
1440,5580,1.5,0,1440,0,499950,1908
2600,4800,1,2,1400,1200,780000,1953
2640,16090,1,2,1960,680,885000,1976
1010,3885,1.5,0,1010,0,500000,1906
1840,6755,1,2,1840,0,329000,1989
1720,7455,1,0,1020,700,246000,1963
1280,9600,1,0,1280,0,405000,1960
1700,7800,1,0,1120,580,349000,1981
1980,12062,2,0,1980,0,374950,1992
1160,7217,1,0,1160,0,306000,1969
1980,7840,1,0,990,990,416000,1961
1960,12476,2,0,1960,0,560000,1989
1270,20700,1,0,1150,120,260000,1948
2060,38377,1,0,1560,500,306500,1978
1980,11274,1,0,1480,500,299950,1968
1450,8977,1,0,1450,0,265500,1990
1200,12000,1,0,1200,0,219000,1986
1830,17349,1,0,1230,600,365000,1977
2090,42689,1.5,0,2090,0,499000,1959
1510,8301,1,0,1510,0,366000,1967
1310,1264,3,0,1310,0,514950,2014
3790,10669,2,0,3790,0,875000,1999
2240,8800,1,0,2240,0,831000,1957
2740,7266,2,0,2060,680,689900,2003
1660,10763,2,0,1660,0,315000,1994
2460,8049,2,0,2460,0,355000,1990
1480,7284,1,0,970,510,336500,1963
2640,4050,1.5,0,1750,890,1.10E+06,1926
1900,8057,1,0,1170,730,375000,1959
2860,24046,1,0,1700,1160,289275,1985
3440,6000,2,0,3440,0,455000,2002
1640,10695,1,2,1640,0,505000,1975
1450,3350,1.5,0,1450,0,450000,1919
2300,7398,2,0,2300,0,567500,2001
1460,8505,1,0,1460,0,265000,1955
1570,14992,1,0,1570,0,340000,2001
1540,8885,1.5,0,1540,0,375000,1939
3300,4218,2,0,2200,1100,920000,1970
2130,11843,2,0,2130,0,850000,1972
1010,9750,1,0,1010,0,202000,1969
2420,12000,1,0,2420,0,725000,1984
3870,33980,2,0,3150,720,900000,1991
1960,6000,1,0,1210,750,680200,1951
1170,9000,1,0,1170,0,216500,1918
1890,7650,1,0,1890,0,325000,1966
2250,4134,2,0,2250,0,675000,2004
750,16321,1,1,750,0,435000,1936
1610,14000,1,0,1050,560,263500,1977
2590,36256,2,0,2590,0,550000,1978
2520,3750,2,1,2520,0,875000,1995
1340,8400,1,0,1340,0,246600,1966
1460,941,3,0,1460,0,337000,2006
1380,7500,1,0,1380,0,240000,1988
1510,11120,1,0,1510,0,490000,1984
2510,83231,1,0,1260,1250,510000,1975
910,8008,1,0,910,0,305000,1971
1970,3655,2,0,1970,0,350000,2003
1540,6632,1,0,1070,470,284200,1959
1980,9757,2,0,1980,0,357000,1995
3150,38865,1,0,2480,670,854000,1986
4700,49658,2,0,4700,0,1.18E+06,1999
2300,15952,1,0,1150,1150,1.00E+06,1963
1880,3000,2,0,1760,120,616500,1909
2640,3750,2,0,1840,800,750000,1911
3900,9100,2,0,2870,1030,650000,1979
2670,10050,1,0,1420,1250,275000,1962
1840,4280,1,0,920,920,540000,1918
1120,10665,1,0,1120,0,225000,1961
2970,9072,2,0,2970,0,845000,1991
1410,7740,1,0,1410,0,490000,1923
3060,8167,2,0,3060,0,753000,2005
2490,7210,1,0,1290,1200,475000,1972
840,7203,1.5,0,840,0,124000,1949
840,7203,1.5,0,840,0,224000,1949
1130,3800,1,0,1130,0,485000,1916
1850,6000,1,0,1270,580,230000,1944
2330,14175,1,0,1800,530,372000,1980
1880,9426,2,0,1880,0,306000,1990
2980,3000,2,0,2340,640,905000,2008
1440,6678,1,0,1040,400,440000,1950
1630,10001,1,0,1100,530,280000,1977
1778,147823,2,0,1778,0,435000,1999
1930,4500,2,0,1930,0,425000,1990
1130,11429,1,0,1130,0,204950,1956
1650,7500,1,0,1000,650,670000,1959
820,2723,1,0,820,0,475000,1921
2900,6650,1,0,1450,1450,352000,1964
2330,8800,1,2,1260,1070,575000,1961
4440,20668,2,2,3240,1200,1.73E+06,1965
1660,5070,2,3,1660,0,491000,1950
3020,7465,2,0,3020,0,750000,2004
1850,50662,1,0,1430,420,830000,1978
5960,20197,2,4,3900,2060,1.14E+06,2005
960,27442,1,0,960,0,137124,1970
1150,6000,1.5,0,1150,0,225000,1907
2130,7300,1,0,1230,900,732600,1963
2460,8001,2,0,2460,0,818000,1984
2360,14950,1,0,2360,0,431000,1978
1320,1034,3,0,1320,0,304000,1996
1910,4667,1,0,1010,900,650000,1908
1610,6160,2,0,1610,0,450000,1977
1610,8401,1,0,1610,0,269000,1958
1160,10732,1,0,1160,0,875000,1953
2870,8393,1,0,1480,1390,890000,1977
2280,9725,2,0,2280,0,565000,1986
1370,1339,2,0,1150,220,448175,2006
1470,4800,2,0,1470,0,235000,1996
2970,6500,2,0,2970,0,680000,2000
1460,12367,2,4,1120,340,629000,1970
1570,1486,2.5,0,1330,240,494000,2000
2880,5500,2,0,1920,960,1.10E+06,1926
1900,9460,1,0,1190,710,450000,1969
2020,11050,1,0,1320,700,330000,1969
3110,11397,2,3,3110,0,960000,1984
2390,7056,2,0,2390,0,360000,1990
2150,11672,2,0,2150,0,378000,2004
1340,6250,1,0,1090,250,499950,1941
1990,12866,2,0,1990,0,450000,1986
1600,5969,1,0,800,800,523500,1950
2680,43995,2,0,2680,0,600000,1986
2080,4828,2,0,2080,0,290000,2002
1340,5434,2,0,1340,0,176000,1986
2590,3750,1.5,0,1790,800,885000,1904
1240,3000,1.5,0,1240,0,483000,1906
1310,7125,1,0,1310,0,240000,1978
2530,5200,1,1,1530,1000,720000,1957
1780,5822,2,0,1780,0,311000,2001
1600,7995,1,0,1600,0,332500,1950
1570,15330,1,0,1080,490,164950,1956
1570,15330,1,0,1080,490,371000,1956
1650,16200,1,0,1650,0,264500,1976
2920,6513,2,0,2260,660,1.74E+06,1937
870,4280,1,2,870,0,503000,1921
2830,5010,2,0,2170,660,738000,2000
980,3350,1,0,980,0,393000,1925
990,45528,1,0,990,0,280000,1992
2360,9647,1,2,1530,830,260000,1964
1000,4640,1,2,1000,0,505000,1915
1660,8000,1,0,1120,540,241000,1976
1520,9605,1,0,1520,0,530000,1975
1180,4000,1.5,2,840,340,713000,1910
1770,10125,2,0,1770,0,487000,1944
980,5393,1,0,980,0,128000,1969
1840,10178,1,0,1040,800,210500,1960
1810,7210,1,0,1210,600,420000,1968
1780,4320,2,0,1780,0,679000,1930
2840,4227,3,0,2840,0,784950,2014
2650,6366,2,0,2650,0,352000,1998
1270,1318,2,0,1080,190,386000,2004
1260,17000,1,0,1260,0,335000,1994
1750,15500,1,0,1490,260,472500,1982
2680,13292,1,0,1340,1340,599950,1976
3830,6765,2,0,3830,0,963990,2014
1610,3600,2,2,1610,0,735000,1925
3840,9751,2,0,3840,0,858450,1998
2670,4000,2,0,1800,870,665000,1914
2000,7414,2,0,2000,0,290000,1993
860,4320,1,0,860,0,250000,1925
1420,7205,1,0,1420,0,192500,1986
2060,13400,1,2,2060,0,350000,1957
2790,9910,2,0,2790,0,518000,2003
1410,3376,1.5,0,1410,0,563000,1911
2420,9566,2,0,2420,0,375000,2003
1460,1319,3,0,1460,0,400000,2002
2460,16000,1,0,1230,1230,240000,1957
1000,5120,1,0,1000,0,317500,1902
4420,36342,2,0,2740,1680,1.32E+06,1982
1240,239144,1,0,1240,0,234000,1921
1740,13750,2,0,1740,0,645000,1975
1280,4840,1,0,1200,80,649000,1908
2520,3980,2,0,2520,0,605000,2004
1500,1471,3,0,1500,0,337900,1999
2490,3600,2,0,2290,200,535000,1906
1530,5684,1,0,1130,400,325000,1957
1740,10875,1,0,1740,0,429950,1967
3550,32807,2,0,3550,0,775000,1989
1280,6000,1,0,1280,0,650000,1965
2320,13114,2,0,2320,0,1.20E+06,1967
1140,10404,1,0,1140,0,275000,1935
3930,16970,2,0,3930,0,575000,1997
2370,16455,1,0,1640,730,540000,1959
2340,4206,1,0,1170,1170,640000,1917
1240,9125,1,0,1240,0,275000,1967
2740,10533,2,0,2740,0,672800,1997
1940,9144,1,0,1430,510,495000,1956
2950,35108,1.5,0,2950,0,820000,1995
1980,11443,1,0,1980,0,475000,1952
2850,7861,1,4,1450,1400,1.28E+06,1970
1160,9375,1,0,1160,0,380000,1967
2130,8225,1,0,2130,0,397500,1987
2420,8560,1,2,1620,800,352000,1978
2820,8600,1,0,1430,1390,893880,1967
3710,34200,2,0,2510,1200,635000,1986
1770,8165,2,0,1770,0,420000,1977
1260,2500,1,0,750,510,503000,1987
2330,10143,1,2,1220,1110,689000,1953
2490,3840,1.5,0,1610,880,749500,1922
4090,49542,2,0,3100,990,1.15E+06,1984
2800,12831,2,0,2800,0,563500,2001
2440,9664,2,0,1890,550,480000,1981
2540,8800,1,1,1620,920,374950,1977
1600,6250,2,0,1600,0,308950,1995
2680,16934,1,0,1340,1340,445000,1958
1220,9000,1,0,1220,0,237200,1968
1550,7270,1.5,0,1550,0,453500,1953
2080,4549,1,0,1040,1040,616500,1954
5000,32909,2,0,5000,0,1.25E+06,2000
630,5150,1,0,630,0,396000,1954
1070,8179,1,0,1070,0,210000,1949
1900,5175,1,0,1200,700,539000,1919
2960,18600,2,0,2960,0,605000,1979
1490,4800,2,0,1490,0,437500,1948
1500,15000,1,0,1500,0,215000,1952
2410,4780,2,0,2410,0,440000,2000
2000,22500,1,0,1680,320,525000,1939
1140,20383,1,0,840,300,319900,1985
1120,9075,1,0,1120,0,335000,1977
2900,35273,2,0,2900,0,485000,1986
3220,7700,2,0,3220,0,359999,1976
2500,19783,1,3,2500,0,799000,1959
1610,10454,1,0,1610,0,280000,1977
2250,3433,1.5,0,1500,750,1.05E+06,1927
1240,4800,2,0,1240,0,290000,1910
1660,2748,2,0,1660,0,235000,1995
2080,3000,1,0,1040,1040,495000,1925
1880,7488,2,0,1880,0,290000,1980
1050,9516,1,0,1050,0,230000,1969
1480,8475,1,0,1480,0,234000,1968
2420,4500,2,0,2420,0,597400,2001
2190,17600,1,0,1110,1080,370000,1966
2660,10452,2,0,2660,0,755000,1993
2430,5715,2,0,2430,0,342000,1999
770,3325,1,0,770,0,497000,1918
3060,30166,1,0,3060,0,835000,1959
2920,4500,2,0,2920,0,730000,1999
1370,5250,1,0,1070,300,655000,1939
1870,3118,2,0,1870,0,205000,1993
1800,4800,1.5,0,1800,0,632750,1918
2100,7715,1,0,1250,850,330000,2013
2530,8250,2,0,2530,0,527500,1961
3290,6465,2,0,3290,0,716500,2002
1890,5395,2,0,1890,0,388500,2006
1680,7770,1,0,1680,0,530000,1967
2170,4517,2,0,2170,0,419000,2002
1200,7360,1,0,1200,0,385000,1978
2990,5669,2,0,2990,0,655000,2003
3770,10900,2,2,3070,700,1.70E+06,1924
1020,47044,1,0,1020,0,279000,1904
1700,9579,1,0,1100,600,262000,1962
1550,4750,1.5,0,1550,0,533000,1919
1680,8100,1,2,1680,0,640000,1950
1680,35127,2,0,1680,0,285000,1987
1910,10300,1,0,1910,0,458400,1921
3160,10587,1,0,2190,970,620000,1960
2020,11358,1,0,1190,830,465000,1956
3210,7054,2,0,3210,0,690000,1985
2350,51400,1,0,1390,960,462500,1977
1910,10221,2,0,1910,0,369950,1994
840,6480,1,0,840,0,124500,1954
2620,10920,1,0,2620,0,950000,1965
1220,10580,1,0,1220,0,418000,1965
1060,8000,1,0,1060,0,160000,1927
2200,10800,1,0,1500,700,457000,1964
2120,7680,1,0,1130,990,530000,1948
1250,7300,1,0,1250,0,385000,1956
1440,7800,1,0,1440,0,491000,1958
1890,8034,1,0,1890,0,521000,1967
1140,8528,1,0,1140,0,255000,1967
2840,7199,1,0,1710,1130,292050,2003
1880,7200,1,0,1880,0,326000,1966
750,5120,1,0,750,0,300000,1941
1630,7480,1,0,1330,300,291600,1979
1720,12551,1,0,1720,0,435000,1967
1600,1311,3,0,1600,0,465000,2005
1230,7420,1.5,0,1230,0,200000,1913
1610,6132,1,2,1090,520,238000,1959
1320,7000,1,0,1320,0,455000,1956
2180,7220,2,0,2180,0,230000,1980
2190,4104,2,0,1410,780,808000,1928
1490,5700,1.5,0,1490,0,578500,1916
1463,868,3,0,1463,0,390000,2003
1800,3933,2,0,1800,0,517500,1989
2880,4000,1.5,0,2100,780,755000,1912
1250,4120,1,0,980,270,579500,1925
1670,1350,3,0,1350,320,649950,2014
2000,6120,1,0,1100,900,228000,1965
2280,3680,1.5,0,1470,810,665000,1926
2110,6069,2,0,2110,0,689000,1999
2520,11240,1,0,1440,1080,560000,1977
1590,6420,1,0,1590,0,529000,1944
2100,14858,1,0,2100,0,375000,1970
2090,9240,1,0,2090,0,325000,1949
3390,10519,2,2,3390,0,583000,1990
790,9784,1,0,790,0,330000,1932
1970,8727,2,0,1970,0,262000,1995
2870,6776,2,0,2870,0,555000,2004
1110,6000,1,0,1010,100,585000,1951
1940,3088,2,3,1770,170,425590,2008
720,4840,1,0,720,0,235000,1947
710,4000,1,0,710,0,362362,1909
1370,7500,1,0,1370,0,252000,1997
2690,9551,2,0,2690,0,439000,1992
3360,10810,2,0,3360,0,465000,1988
1500,7854,1.5,0,1500,0,249900,1983
2600,5000,1,0,1300,1300,665000,1926
1160,8774,1,0,1160,0,370000,1972
1430,3000,1.5,0,1300,130,620000,1929
1870,7671,1,0,1720,150,375000,1937
2560,9390,1,0,1280,1280,552625,1957
1160,10500,1,0,1160,0,315500,1966
1680,8187,1,0,1680,0,620000,1983
2010,9075,1,0,1310,700,510000,1959
2540,38677,2,0,2540,0,652500,1987
3240,22795,2,0,3240,0,574000,1998
2670,12806,2,0,2670,0,430000,2010
1080,7236,1,0,1080,0,390000,1947
1430,3840,1,0,950,480,466500,1945
1290,2436,2,0,1290,0,315000,1984
1240,9600,1,0,1240,0,220000,1971
1840,17286,1,0,1440,400,325000,1978
1120,8443,1,0,1120,0,365000,1953
2100,12384,2,0,2100,0,356000,1980
2030,12518,1,0,1610,420,380000,1950
2030,8764,2,0,2030,0,579000,1983
890,5000,1,0,890,0,682000,1943
1750,12325,1,0,1470,280,499000,1968
1300,5880,1,0,1300,0,333760,1968
2650,18903,2,0,2650,0,745000,1994
1750,10870,1,0,1750,0,380000,1968
1440,1350,3.5,2,1440,0,435000,2005
1700,3264,1,0,1060,640,520000,1919
3920,41206,2,0,3920,0,965000,1988
1470,16728,1,0,1350,120,270000,1959
2520,4643,1.5,0,2120,400,1.10E+06,1916
2140,13286,1,0,1220,920,577500,1964
1550,5000,1,0,1250,300,650000,1911
3180,10319,2,0,3180,0,1.23E+06,1986
6510,16471,2,3,3250,3260,1.90E+06,1980
1440,3720,1.5,0,1440,0,475000,1983
1150,10132,1,0,1150,0,200000,1970
2320,11717,2,0,2320,0,397000,1997
1230,8450,1,0,1230,0,383610,1989
2060,5742,2,0,2060,0,275000,1999
2783,11177,2,0,2783,0,840000,1910
2140,7350,2,0,2140,0,365000,1985
1420,955,2,0,1160,260,362000,2004
2090,6258,1,0,1390,700,350000,1956
1320,13052,1.5,0,1320,0,200000,1980
2300,8100,1,0,1360,940,299000,1979
3050,82764,1,0,1650,1400,555000,1966
2960,8330,1,3,2260,700,1.33E+06,1953
2520,16100,1,3,1570,950,896000,1960
1740,7290,1,0,1280,460,550000,1950
1300,6617,1,0,1300,0,324500,1986
1170,7350,1,0,1170,0,312500,1960
1946,17786,2,1,1946,0,485000,1990
1250,5413,1,0,1250,0,511000,1923
1230,1561,2,0,1230,0,139500,1983
2180,7203,2,0,2180,0,464000,1989
1740,8800,1,0,1140,600,255000,1978
3830,4644,2,0,2900,930,679975,2004
2250,14274,1,0,1500,750,624800,1964
2590,223027,2,0,2590,0,920000,1983
2090,6000,1.5,0,2090,0,1.37E+06,1928
2400,10275,1,0,1540,860,510000,1964
2260,7200,2,0,2260,0,289659,1984
2910,6250,2,0,2910,0,585000,1999
3640,6930,2,0,3640,0,555000,2004
3770,24897,2,2,2550,1220,940000,1964
1600,7350,1,0,1600,0,460000,1979
2110,7434,2,0,2110,0,319000,1978
1720,1916,2,0,1720,0,280000,2005
1100,7470,1,0,1100,0,250000,1917
2620,8312,2,0,2620,0,749950,1990
3090,23265,1,0,2990,100,458000,1957
1890,4808,2,0,1890,0,465000,2000
1850,2797,1,0,1150,700,580000,1977
3100,36562,2,0,3100,0,700000,1994
2506,7206,2,0,2506,0,350000,2007
1700,7689,1,0,1080,620,456000,1977
1550,18958,1.5,0,1550,0,290000,1983
2200,16288,1,0,1290,910,475000,1980
1890,3629,2,0,1890,0,285000,2005
1140,6400,1,0,1140,0,309000,1962
3740,32417,2,0,3740,0,860000,2000
1940,6500,1,0,1440,500,219000,1979
2130,7199,2,0,2130,0,546500,1990
1470,5566,1,0,770,700,338000,1919
1070,8130,1,0,1070,0,505000,1942
1680,15084,1,0,840,840,340000,1979
2730,10675,2,0,2730,0,678000,1990
1890,10292,1,0,1890,0,800000,1969
1080,3230,1,0,1080,0,112000,1963
1440,16819,1.5,0,1440,0,252000,1925
2540,7210,1,0,1600,940,335000,1979
2300,13418,1,0,1430,870,610000,1955
1690,6790,1,0,1360,330,245000,1979
1800,16026,1,0,1390,410,493500,1972
1770,8505,2,0,1770,0,596500,1986
1190,4072,1.5,0,1190,0,245000,1907
1320,7200,1,0,1320,0,333500,1977
1290,8974,1,0,1290,0,373000,1976
3000,5639,2,0,3000,0,759900,2008
1358,1204,3,0,1358,0,317000,2007
1220,4080,1.5,0,1220,0,670000,1914
2720,26761,2,4,2720,0,985000,1990
1060,6954,1,0,1060,0,310000,1983
3020,13122,2,0,2540,480,750000,1997
1640,3440,2,0,1640,0,408000,1987
3870,8225,2,0,3870,0,900000,1998
2860,15054,1,0,1460,1400,460000,1957
1740,6000,1,0,1740,0,339000,1952
1140,6000,1,0,1140,0,660000,1909
3290,10783,2,0,3290,0,449950,1990
1210,6000,1,0,1210,0,235000,1930
3320,13138,1,2,1900,1420,769000,1964
1350,3900,1,0,1350,0,428000,2003
1990,7340,2,0,1990,0,445000,1984
2060,6958,1,0,1220,840,462000,1974
1460,6198,1.5,0,1460,0,775000,1916
2250,10108,1,0,2250,0,605000,1967
950,15996,1,0,950,0,193500,1946
3140,8060,2,0,3140,0,389950,1991
3560,6098,2,0,3560,0,790000,2006
1410,5000,1,2,940,470,442000,1918
2770,13500,2,0,2770,0,890000,1974
1864,6978,1,0,1864,0,235000,1958
1930,6720,1,2,1130,800,495000,1959
3870,50965,2,0,3870,0,600000,2007
2020,5500,1.5,3,1790,230,1.40E+06,1937
1300,8400,1,0,1300,0,251000,1967
3410,57063,2,0,2410,1000,471000,1978
2370,41338,2,0,2370,0,597000,1995
2770,9305,2,0,2770,0,804000,1985
1250,17493,1,0,1250,0,357000,1972
1690,1689,2,0,1150,540,419990,2014
3040,35201,2,0,3040,0,725000,1987
2710,5733,2,0,2710,0,275000,2003
1190,13630,1,0,1190,0,445000,1984
2300,27566,2,0,2300,0,510000,1995
1360,13372,1,0,1360,0,330000,1955
1500,5605,1,0,750,750,270000,1942
1610,4770,1,0,1230,380,495000,1941
1420,10300,2,0,1420,0,225000,1950
1750,5400,1,0,1050,700,716528,1952
1510,6095,2,0,1510,0,260000,1991
2330,9928,2,0,2330,0,471000,1998
2690,4800,2,2,1930,760,690000,1919
1700,7200,1.5,0,1700,0,548000,1937
1020,5410,1,0,880,140,505000,1928
1160,11799,1,0,1160,0,325000,1966
2450,34092,2,0,2450,0,682000,1980
2010,10760,2,0,2010,0,605000,1985
1370,4495,1,0,1370,0,276200,1975
1370,4040,1.5,0,1370,0,530000,1906
1990,9600,1,0,1440,550,245000,1988
2790,45902,2,0,2790,0,654950,1987
780,6727,1,0,780,0,221900,1939
2240,4508,1,2,1340,900,466000,1926
2210,6387,1,0,2210,0,383150,2003
1390,4240,1,0,1050,340,657100,1924
1800,43995,2,0,1800,0,539000,1988
3320,15600,1,0,1660,1660,400000,1977
1960,11600,1,0,980,980,215000,1931
850,2850,1,0,850,0,489000,1927
2980,12764,2,0,2980,0,649000,1994
1980,10800,1,0,1320,660,700000,1953
790,8424,1,0,790,0,268500,1953
1800,5001,2,0,1800,0,515000,1996
2260,10800,1,0,2260,0,685000,1978
800,2142,2,0,800,0,305000,2006
2490,4600,1.5,2,2090,400,950000,1926
1610,4568,2,0,1610,0,292500,2006
1850,7730,1,0,1100,750,270000,1956
1850,7730,1,0,1100,750,450000,1956
1920,6480,1.5,0,1920,0,535000,1920
1740,3082,2,0,1740,0,550000,2000
1430,2003,2,0,980,450,457500,1996
1420,8580,1,0,1420,0,136500,1962
1420,8580,1,0,1420,0,224097,1962
1560,10608,2,0,1560,0,254000,1994
2030,13500,1,0,1230,800,335000,1963
3280,6553,2,0,3280,0,594950,2012
1360,18123,1,0,1360,0,350000,1983
1180,9832,1,0,1180,0,169950,1970
1940,10800,1,0,1340,600,432500,1979
1300,4000,2,0,1300,0,440000,1948
1650,3788,2,0,1650,0,233703,1985
1140,3292,2,0,1140,0,310000,1988
2540,6762,2,0,2540,0,735000,1998
3440,8150,2,0,3440,0,730000,2014
1800,9000,1,0,1200,600,257000,1961
1260,1240,3,0,1260,0,485000,2004
2370,6000,1,2,1440,930,899000,1959
1520,8055,1.5,0,1520,0,279000,1952
1750,7245,1,0,1050,700,225000,1974
2680,4775,2,2,1880,800,1.36E+06,1913
1590,4242,2,0,1590,0,355000,2000
1560,8700,1,0,1560,0,382500,1967
2000,9669,2,0,2000,0,324360,1992
2380,10450,1.5,0,2380,0,315000,1966
2230,11472,2,0,2230,0,426000,1951
2820,6305,2,0,2820,0,395000,2003
1570,9650,1.5,0,1570,0,212644,1922
1845,5100,2,2,1845,0,510000,1947
830,9000,1,0,830,0,85000,1939
830,9000,1,0,830,0,235000,1939
2030,5754,2,0,2030,0,295000,2001
1430,2200,1.5,0,1430,0,720001,1910
1510,6083,1,0,860,650,313950,1940
1510,6083,1,0,860,650,415000,1940
1610,12247,1,0,1610,0,305000,1981
1600,4128,1.5,0,1250,350,625000,1906
1420,11040,1,0,1420,0,490000,1961
1660,8641,2,0,1660,0,269950,1987
4230,27295,2,4,3230,1000,2.70E+06,1949
3310,4500,2.5,0,2910,400,829000,1900
2470,77550,1,0,2470,0,635000,1987
1040,9750,1,0,1040,0,217500,1959
1850,7350,1,0,1050,800,270000,1965
4610,8400,2,2,2790,1820,1.25E+06,1947
2480,5100,2,0,2480,0,480000,2007
2130,6500,1,2,1170,960,575000,1954
2350,5589,2,0,2350,0,426950,2001
920,7314,1,0,920,0,125000,1960
920,7314,1,0,920,0,208000,1960
1780,10622,1,0,900,880,325000,1976
2690,10880,1,0,2690,0,597157,1960
3010,3120,2.5,2,3010,0,728725,2006
3180,10800,1,0,1910,1270,708000,1968
4120,14021,2,0,4120,0,1.30E+06,2005
1280,11625,1,0,1280,0,405000,1977
1690,6090,1.5,0,1400,290,550000,1945
2320,5375,2,0,2320,0,451000,2006
3090,7415,2,0,3090,0,540500,2014
5050,16500,2,2,5050,0,1.03E+06,2001
1640,10455,1,0,950,690,218000,1963
2170,7007,1,0,1540,630,562000,1974
3140,94525,2,0,2280,860,401500,1977
1090,9994,1,0,1090,0,196700,1954
1930,10183,1,0,1480,450,583000,1975
2100,17825,1,0,1400,700,309900,1974
3110,18843,2,0,3110,0,485000,1995
930,3348,1,0,930,0,465000,1926
2050,8372,2,0,2050,0,595000,1984
1160,7560,1,0,1160,0,254000,1958
1820,9490,2,0,1820,0,488500,1994
2110,8990,2,0,2110,0,260000,1977
870,8487,1,0,870,0,166000,1944
1080,6760,1,2,1080,0,440000,1923
1260,7560,2,0,1260,0,375000,1943
900,4800,1,0,780,120,529500,1944
750,6439,1,0,750,0,338000,1934
1800,15903,1,0,1340,460,335620,1986
2220,15232,1,0,1690,530,464000,1978
1390,7740,1,0,1390,0,354000,1925
2160,3600,2,0,1660,500,601000,1998
1840,9040,1,0,1370,470,285000,1979
1690,4200,2,0,1690,0,462500,1906
2650,10459,2,0,2650,0,350000,1989
1120,3844,1,0,1120,0,329000,1972
2500,11983,1,0,1320,1180,312500,1984
2220,5338,2,0,2220,0,370000,2001
1260,12750,1,0,1260,0,399900,1979
1480,6550,1.5,0,1480,0,398000,1925
930,7400,1,2,830,100,550500,1909
2780,7200,1.5,0,1870,910,709000,1913
2770,7620,1,0,1700,1070,402000,1965
1530,23660,1,0,1530,0,450000,1952
2140,6720,1,0,1440,700,524000,1961
4600,322188,1,4,2400,2200,800000,1989
1760,8906,1,0,1230,530,185000,1966
1760,8906,1,0,1230,530,365000,1966
3110,11422,2,0,3110,0,925000,1989
2260,11781,1,0,1520,740,714000,1968
1460,9759,1,0,1460,0,495000,1972
2050,6648,1,0,1230,820,535000,1990
2340,10800,1,0,2340,0,880000,1953
1230,8056,1,0,1230,0,150000,1949
1880,6565,1,0,1420,460,554500,1972
1280,3880,1.5,0,1280,0,520000,1916
3660,5637,2,0,3660,0,839990,2014
1650,5683,2,0,1650,0,500000,2003
1960,186872,1.5,0,1960,0,305000,1936
1580,2170,2,0,1580,0,247800,2003
2490,5812,2,0,2490,0,344200,2000
2000,6107,2,0,2000,0,459950,2003
1550,9899,1,0,1550,0,229900,1967
2820,9602,1,1,1950,870,750000,1974
2600,9355,1,0,1840,760,509000,1983
2200,12137,1,4,1640,560,680000,1956
2500,7200,1,0,1490,1010,661500,1977
1270,1399,3,0,1270,0,370000,2000
2900,17400,1,0,2410,490,785000,1978
840,6720,1,0,840,0,355000,1952
1940,6350,1,0,970,970,446000,1951
3490,21780,2,0,3490,0,830000,1996
1940,8347,2,0,1940,0,324000,1990
2490,23478,2,0,2490,0,500000,1981
1390,9112,1,0,1390,0,745000,1951
3940,4407,2,0,2620,1320,1.20E+06,1921
1760,3710,1,0,1130,630,385000,1988
2560,8040,1,0,1510,1050,565000,1958
2300,7314,1,0,1420,880,465000,1979
1770,1977,3,0,1770,0,401000,2001
2310,11200,1,0,1630,680,385000,1978
2310,4930,2,0,2310,0,395000,1989
2000,8100,1.5,0,2000,0,245000,1946
1540,3600,1,0,890,650,500000,1994
2590,6720,1,0,1750,840,334000,1979
980,10960,1,0,980,0,550000,1953
1730,7950,1,0,1180,550,216000,1961
3070,5871,3,0,2510,560,340500,1928
2100,12738,2,0,2100,0,375000,1975
2080,16740,1,3,1580,500,600000,1966
1890,8000,1,0,1250,640,375000,1960
2000,4000,1.5,0,1450,550,536500,1926
3030,35123,2,0,1760,1270,599900,1984
1110,3600,1,0,1110,0,750000,1904
1650,10075,1,0,1170,480,355000,1955
1410,6413,1,0,910,500,590000,1947
2140,6000,1,0,1070,1070,680000,1946
1860,11122,2,0,1860,0,429000,1994
1170,4080,1,0,1170,0,581000,1909
980,7770,1,0,980,0,463800,1968
7400,18898,2,3,6290,1110,2.98E+06,2001
1650,3000,1.5,0,1650,0,443000,1902
1480,7210,1,0,1180,300,276200,1986
4060,8309,2,0,2960,1100,630000,2001
1370,3300,2,0,1370,0,570000,1927
2480,6000,2,2,2380,100,979700,1929
2030,4080,1.5,0,1730,300,730000,1921
2200,9600,1,0,1100,1100,268450,1963
1770,7508,1,0,1270,500,490000,1962
2550,6240,1,3,1750,800,808000,1957
1250,9786,1,0,1250,0,350000,1969
2390,5880,1,2,1390,1000,695000,1957
5730,44947,2,4,4280,1450,1.23E+06,1991
1120,11800,1.5,0,1120,0,309950,1950
1270,8508,1,0,650,620,134000,1942
2390,9638,2,0,2390,0,645500,1988
1760,5488,1.5,0,1540,220,750000,1927
2560,3600,2,0,2110,450,1.40E+06,1967
1820,7700,1,0,1100,720,344900,1955
1840,1500,3,0,1840,0,601450,2001
1810,4400,2,0,1700,110,575000,1909
2470,9620,1,1,1570,900,405000,1962
2520,14021,2,0,2520,0,518000,1999
1600,7936,1,0,1600,0,265000,1947
1280,4875,1,0,1280,0,180000,1969
1590,9736,2,0,1590,0,285000,1985
2000,7200,1,0,1000,1000,433000,1954
1780,11440,1,0,1350,430,399000,1977
1700,7210,2,0,1700,0,565000,1966
1970,10080,1,0,1970,0,406500,1966
1940,11500,1,0,1090,850,420000,1955
3290,5559,1.5,0,2290,1000,965000,1906
3500,9523,2,0,2460,1040,1.38E+06,1996
3260,7969,2,0,3260,0,353950,1982
4230,10260,2,0,3860,370,847700,1996
1590,6700,1.5,0,1090,500,185000,1942
1010,6000,1,0,1010,0,269000,1923
1820,8400,1,0,1340,480,422800,1976
870,7500,1,0,870,0,379950,1947
1620,7800,1,0,1200,420,525000,1969
3980,209523,2,2,3980,0,810000,2006
1630,8400,1,0,1630,0,209950,1962
1230,1613,2,0,1010,220,439950,2003
3510,12905,1,2,2210,1300,554820,1965
2160,4500,2,0,2160,0,359000,2002
1020,5870,1,0,1020,0,242500,1941
1590,9417,1,0,1590,0,330000,1954
3440,44374,2,3,2190,1250,740000,1979
3020,4800,2,0,3020,0,630000,1901
2280,7800,1,3,1360,920,750000,1941
2790,6540,2,0,2790,0,695000,1999
580,6900,1,0,580,0,109000,1941
2030,10075,1,0,1080,950,389000,1961
850,2700,1,0,850,0,447000,1924
2480,13310,1,0,2480,0,1.20E+06,1955
1010,12000,1,0,1010,0,315000,1977
2420,8244,2,0,2420,0,640000,1988
2180,9246,2,0,2180,0,570000,1984
1830,208216,2,0,1830,0,495000,1997
2040,7488,1,0,1200,840,449500,1969
2640,5000,2,0,1840,800,1.08E+06,1943
1060,7868,1,0,1060,0,294950,1952
1640,13939,1,0,1040,600,170500,1960
1190,7620,1.5,0,1190,0,312000,1926
2180,15484,1,0,2180,0,350000,1992
2120,8448,2,0,2120,0,690000,1989
2210,9427,2,0,2210,0,375000,1999
2510,47044,2,0,2510,0,575000,1987
2500,8500,1,0,1600,900,646000,1978
1560,4800,2,0,1560,0,239950,1974
2510,7525,1.5,0,1710,800,400000,1929
3060,94089,1,0,3060,0,455000,1958
1310,8069,1,0,1310,0,240000,1990
4260,11765,2,0,3280,980,3.40E+06,1939
2500,4080,1.5,0,1680,820,695000,1922
670,6720,1,0,670,0,304950,1942
1840,2310,1,2,1140,700,650000,1914
1480,2211,2,0,1480,0,402500,1995
2420,7307,2,0,2420,0,482000,1998
1820,4480,1,0,1120,700,655000,1923
1940,5000,2,0,1940,0,577000,1951
1630,5996,2,0,1630,0,350000,1986
2520,8000,1,2,1680,840,415000,1970
2120,215186,2,0,2120,0,396400,1983
2490,8582,2,0,2490,0,654300,2000
3410,179419,2,0,3410,0,774950,2004
2380,10800,2,2,2380,0,855000,1925
2490,4000,2,0,1670,820,1.15E+06,1918
1240,1546,2,0,1240,0,330000,2007
1900,10950,1,0,1400,500,290000,1959
2390,19454,1.5,0,2390,0,519500,2008
1810,12600,1,0,1400,410,450000,1977
4490,56609,2,4,4490,0,3.12E+06,1993
1620,9450,1.5,0,1620,0,265000,1928
2640,7883,2,0,2640,0,359000,1990
2870,4500,2,3,2510,360,2.00E+06,2012
3250,48037,1,2,2030,1220,1.05E+06,1985
800,2280,1,0,800,0,402500,1946
1360,5445,1,0,1360,0,450000,1957
1950,8086,1,0,1130,820,262500,1980
1970,7200,2,0,1970,0,285000,1979
2020,4861,2,0,2020,0,290000,2005
2280,6230,1,0,2280,0,752500,2005
3540,13515,2,0,3540,0,820000,1998
1560,2740,2,0,1560,0,292000,1999
750,6089,1,2,750,0,213000,1937
2240,7035,2,0,2240,0,400000,1942
590,5650,1,0,590,0,202000,1944
690,23244,1,0,690,0,484000,1948
1580,14398,1,0,1080,500,617450,1981
1040,8000,1,0,1040,0,250000,1956
1880,10000,1,0,960,920,405000,1963
1070,8750,1,0,1070,0,325000,1951
1860,7440,1,0,1040,820,301350,1954
1550,7800,1,0,1050,500,425000,1940
1860,6360,1,0,1470,390,460000,1954
3090,10940,2,2,3090,0,938000,1992
1720,8867,1,0,1320,400,348000,1985
1260,4080,1.5,0,1260,0,435000,1926
1120,11430,1,0,1120,0,227950,1963
1250,5880,1,0,900,350,425000,1948
1810,4064,1.5,0,1810,0,550000,1925
1890,7053,2,0,1890,0,347500,1992
2020,6000,1,0,1620,400,397000,1959
1790,11875,1,0,1490,300,410000,1969
3190,6776,2,0,3190,0,780000,1998
3030,5164,1.5,0,2700,330,1.35E+06,1925
1630,3070,2,0,1630,0,476000,2004
1180,16552,1,0,1180,0,390000,1967
1560,7000,1,0,1560,0,226500,1968
1340,2550,2,0,1340,0,495000,1984
2590,11500,1,2,2590,0,1.50E+06,1968
1020,5950,1,0,880,140,385000,1950
2370,5344,2,0,2370,0,535950,2003
3170,32430,2.5,0,3170,0,910000,1989
1120,4000,1,0,1120,0,465000,1926
1440,11787,1,0,1440,0,495000,1983
2170,5404,1.5,0,1470,700,250000,1920
3490,6906,2,0,2280,1210,1.23E+06,1928
1970,8941,2,0,1970,0,400000,1973
2780,13521,2,0,2780,0,715000,1987
2250,7757,1,0,2250,0,342000,1992
1340,8400,1,0,1340,0,420000,1967
1400,7360,1,0,1400,0,148226,1968
1510,10369,1,0,1010,500,313000,1968
1320,8220,1,0,1320,0,150000,1959
820,10270,1,0,820,0,150000,1954
1080,9435,1,0,1080,0,230000,1958
840,5400,1,0,840,0,389100,1948
2070,8720,1,0,1360,710,645000,1974
1520,6500,1,0,990,530,310000,1958
1210,1189,2,0,1210,0,351358,2014
3810,9360,2,0,3810,0,1.70E+06,2014
5370,323215,2,0,5370,0,1.57E+06,2002
1540,3600,2,0,1540,0,850000,1900
2310,14023,2,0,2310,0,470000,1991
1870,1900,3,0,1870,0,770000,2008
1840,11440,1,0,1340,500,366000,1977
2060,7184,2,0,2060,0,545000,1987
1010,8800,1,0,1010,0,205000,1968
1020,8155,1,0,1020,0,405000,1948
2220,7210,1,0,1270,950,467000,1973
1050,4125,1,0,1050,0,392500,1909
3030,18400,1.5,3,2360,670,901000,1973
1800,7199,1,0,1300,500,500000,1972
1860,3690,2,0,1860,0,384950,2000
4070,336283,2,0,4070,0,1.70E+06,2006
860,6120,1,0,860,0,245000,1948
3080,10487,2,0,3080,0,1.17E+06,1968
1280,3640,2,0,1280,0,184500,1983
1540,5000,1.5,0,1540,0,269000,1986
1530,3296,2,0,1530,0,570000,1998
2350,11914,1,0,2350,0,850000,1961
920,5200,1,0,920,0,209000,1969
1840,5100,1,0,1840,0,327000,1933
1650,9957,1,0,1100,550,369500,1961
1760,8025,1,0,1230,530,440000,1976
3290,12329,1.5,0,3290,0,947500,1968
1270,4500,1.5,0,1270,0,510000,1919
1600,10318,1,0,930,670,385000,1941
2670,9920,1,0,1400,1270,370000,1990
1960,4500,1.5,2,1960,0,660000,1922
3300,308080,2,2,2520,780,729000,1976
2000,11880,2,0,2000,0,440000,1979
2360,81892,1,0,2360,0,445000,2000
1430,12092,1,0,1430,0,460000,1938
2330,7304,1,0,1300,1030,516000,1971
2060,5607,2,0,2060,0,343888,2002
2240,9886,1.5,0,2240,0,500000,1965
2330,6450,1,1,1330,1000,465000,1958
2180,7813,2,0,2180,0,302000,1986
1280,7861,1,0,1280,0,195000,1913
2140,8925,2,0,2140,0,640000,1991
2890,8122,1,0,1630,1260,502000,1977
1480,3851,2,0,1480,0,360000,1998
1680,3000,2,0,1680,0,290500,2003
2163,5883,2,0,2163,0,248000,2006
2280,7568,2,0,2280,0,433000,2001
820,4200,1,0,820,0,480000,1980
1330,5000,1,0,1120,210,410000,1957
2310,5000,2,0,2310,0,309950,2006
1290,7372,1,0,1290,0,253000,1990
1630,11800,1,0,1630,0,280000,1971
1410,8925,1,0,1410,0,440000,1958
1240,8936,1,0,1240,0,333000,1954
3100,23790,2,0,3100,0,759950,2002
2020,9000,2,0,2020,0,345000,1979
2500,5831,2,0,2500,0,350000,2007
790,14200,1,0,790,0,198000,1951
2040,11294,1,0,1340,700,730000,1952
1430,9600,1,0,1430,0,266200,1966
2250,10160,2,0,2250,0,1.06E+06,1967
1070,20450,1,0,1070,0,95000,1948
1300,12731,1,0,1300,0,430000,1981
2560,9731,2,0,2560,0,650000,1973
2190,5071,2,0,2190,0,379900,2004
940,1222,2,0,860,80,325000,2004
1740,8449,1,0,1170,570,455000,1958
2220,3797,1.5,0,1330,890,392000,1917
1310,7811,1,0,1310,0,373000,1976
2710,8227,1,2,1910,800,951250,1953
1300,14350,1,0,1300,0,502000,1955
1940,40588,1,0,1940,0,362500,2000
1080,3500,1,3,1080,0,525000,1924
2110,11680,1,0,1420,690,580000,1977
1590,9425,1,0,1170,420,278000,1985
910,4800,1,0,910,0,422500,1923
1590,5400,1,2,990,600,783200,1900
3290,6628,2,0,3290,0,715000,2003
2010,2212,2,0,1390,620,472217,2014
2060,4030,2,0,2060,0,244615,1999
1560,14288,1,0,780,780,385000,1944
1120,6600,1,0,1120,0,549995,1943
3550,15151,2,0,3550,0,959900,2004
3300,7200,2,0,3300,0,510000,1980
2000,12669,1,3,1200,800,367000,1965
2680,8410,2,0,1810,870,375000,1990
1290,1334,3,0,1290,0,500000,2007
1290,1334,3,0,1290,0,489000,2007
1150,700,2,0,800,350,340000,2000
1880,5978,1,0,940,940,562000,1957
2400,7478,2,0,2400,0,489950,2002
1920,9600,1,0,1560,360,652000,1968
4350,7090,2,0,2870,1480,472000,1999
1910,9244,1,0,1910,0,333000,1963
2000,7350,1,0,2000,0,560000,1953
3290,20107,2,4,2220,1070,799000,1990
3480,9200,2,0,3480,0,860000,1979
2410,55931,2,0,2410,0,449500,1989
2820,11500,2,0,2820,0,692500,1991
2710,11400,1,0,1430,1280,925000,1976
2080,2856,1.5,0,1550,530,267500,2003
2200,6018,2,0,2200,0,396800,2010
1180,8058,1,0,1180,0,220000,1969
2120,56192,1,1,1720,400,892500,1959
1460,10311,1,0,1460,0,455500,1975
2110,11250,1,0,2110,0,743000,1961
1790,17925,1,0,1790,0,338000,1951
1340,13115,1,0,1340,0,332000,1978
2460,4000,1.5,0,1370,1090,563225,1918
3760,20609,2,0,3760,0,1.15E+06,1990
1240,5000,1,0,1000,240,645000,1920
2750,16000,2,0,2560,190,739000,1981
2530,13446,2,0,2530,0,435000,1993
3200,3800,2,0,2650,550,995000,1914
2020,7357,1,0,1350,670,520000,1986
3030,180263,2,0,2030,1000,400000,1987
2350,7641,1,0,1510,840,440000,1978
1690,6010,1,0,1230,460,440000,1946
1280,3900,1,0,1280,0,738000,1921
1170,9848,1,0,1170,0,250000,1963
2700,8580,2,0,2700,0,338150,1992
1800,7371,1,0,1280,520,425000,1979
3670,54450,2,0,3670,0,883000,1999
2350,266151,1.5,0,2350,0,510000,1983
3100,21303,1,1,3100,0,950000,1962
1120,9656,1,0,1120,0,435000,1955
1900,10226,1,0,1130,770,415000,1961
1350,944,2,0,870,480,439000,2004
1410,6400,1,0,960,450,295832,1955
1560,9514,1,0,1560,0,285000,1967
1090,5003,1,0,1090,0,350000,1962
1465,972,2,0,1050,415,489000,2006
1790,6930,1,0,1390,400,304500,1974
1300,7313,1,0,1300,0,288000,1968
1920,9512,1,0,1440,480,417000,1980
1420,991,2,0,1040,380,615000,2005
3760,4857,2,3,2820,940,730000,2004
930,3447,1,0,930,0,178500,1978
1580,9600,1,0,1050,530,300000,1965
2170,8518,1,3,1350,820,415000,1955
2040,15695,1,0,2040,0,452500,1959
3430,15877,1,4,3430,0,1.01E+06,2005
2160,7000,2,0,2160,0,653000,1989
2060,5649,1,0,1360,700,715000,1941
1410,4080,1.5,0,1410,0,541000,1927
1850,7547,1.5,0,1850,0,245000,1960
1370,10038,1.5,0,1370,0,547000,1922
3330,12408,1,0,1740,1590,750000,1976
1970,12375,1,0,1570,400,575000,1959
1310,8670,1,0,1310,0,216000,1984
1640,4579,1,0,1640,0,443000,1916
1600,6202,2,0,1600,0,257700,1986
1230,9440,1,0,1230,0,278000,1978
2240,3691,2,0,2240,0,300000,2003
2190,7904,2,0,2190,0,269100,1995
990,10752,1.5,0,990,0,402500,1929
1010,7719,2,0,1010,0,306888,1981
2920,14210,2,0,2920,0,795000,1978
2310,5573,2,0,2310,0,525000,2003
3470,12076,2,3,2560,910,1.05E+06,1988
1220,6000,1,0,880,340,452000,1938
1550,5401,2,0,1550,0,350000,2000
2070,6180,2,0,2070,0,410000,2007
2060,3600,1.5,0,1180,880,595000,1905
1690,4851,2,0,1690,0,499000,2004
2550,7555,2,0,2550,0,340000,2001
3370,7947,2,0,3370,0,1.07E+06,2001
2230,52983,2,0,2230,0,460000,1991
2382,5899,2,0,2382,0,345000,2011
1620,7566,2,0,1620,0,280500,1990
1140,6120,1.5,0,1140,0,704000,1926
2140,40173,2,0,2140,0,545000,1990
1900,7584,1,0,1900,0,335000,1962
3370,7920,1,3,1860,1510,1.33E+06,1988
2300,8000,1,0,1430,870,420000,1965
2040,5050,1,0,1160,880,705000,1937
1840,10528,1,0,1210,630,274900,1990
2860,3345,2,0,2190,670,499950,2004
1400,7550,1,0,1400,0,415250,1953
990,7520,1,0,990,0,222000,1958
3120,42247,1,0,2150,970,375000,1980
1640,5707,2,0,1640,0,300000,1995
2820,8879,1,0,1540,1280,456700,1920
1970,5200,1.5,3,1970,0,925500,1915
2840,15598,1,0,1470,1370,375000,1975
2370,15375,2,2,2370,0,420000,1993
2610,7301,2,0,2610,0,575000,2004
1340,1951,1,0,670,670,335000,1915
1300,7200,1,0,1300,0,428000,1958
3340,34238,1,0,2060,1280,655000,1977
2630,4896,2,0,2630,0,738000,2006
1960,3748,1,0,980,980,415000,1965
1090,6125,1,0,790,300,392000,1945
1550,4600,1,0,1050,500,555000,1941
1770,2677,2,0,1770,0,260000,2005
1390,10500,1.5,0,1390,0,392500,1940
2979,17313,2,2,2979,0,912000,1993
830,7609,1,0,830,0,135000,1943
1560,77536,1,0,1400,160,500000,1978
1360,7488,1,0,1050,310,238000,1975
1650,5974,1,0,860,790,251000,1972
1510,5319,2,0,1510,0,406500,1978
3010,10925,2,0,3010,0,433495,1988
1510,6071,1,0,1150,360,265000,1985
1950,7260,1,0,1520,430,360000,1957
1800,12485,1,0,950,850,425000,1955
2810,11205,1,0,1510,1300,450000,1968
1760,8266,1,0,1760,0,449900,1954
2040,5875,2,0,2040,0,345000,2004
1690,35346,1,0,1690,0,612500,1967
1530,7650,1,0,1530,0,317000,1977
1810,3880,1.5,0,1310,500,585000,1929
1180,14292,1,0,1180,0,455000,1981
4090,51908,2,0,4090,0,1.04E+06,1991
2250,3463,2,0,2250,0,497000,1968
1070,6315,1,0,1070,0,226750,1992
1820,7102,1,0,1220,600,385000,1950
1080,5025,1,0,1080,0,205000,1948
2760,13093,2,0,2760,0,745000,1989
2550,4770,2,0,2550,0,371000,2005
2080,8504,2,0,2080,0,545000,1991
1280,5460,1.5,0,1280,0,443000,1931
950,6350,1,0,950,0,287000,1951
1050,7577,1,0,1050,0,194000,1983
1800,7650,1,0,1800,0,265000,1957
3840,10004,1,2,2110,1730,1.14E+06,1963
3674,12793,2,1,3674,0,699950,1987
1710,7000,1.5,0,1710,0,433000,1950
910,2693,1,0,910,0,200000,2003
1340,25160,1,0,1340,0,289571,1968
2340,11034,1,0,1720,620,440000,1967
1510,8360,1,0,1120,390,400000,1960
2630,15000,2,0,2630,0,589000,1962
3100,97661,2,0,3100,0,850000,1986
940,3000,1.5,0,940,0,520000,1903
1370,1248,2,0,1200,170,555000,2000
2480,5082,2,0,2480,0,470000,2004
1068,1158,2,0,1068,0,207000,1990
2390,9650,1,2,1620,770,379750,1976
2170,4600,1,0,1270,900,709000,1950
1520,9864,1,0,1160,360,240000,1993
2210,10497,1,0,1650,560,445500,1953
3200,7863,1,3,1600,1600,1.31E+06,1959
1160,10125,1,0,1160,0,210000,1959
2670,5895,2,0,2670,0,603000,1999
2520,10012,2,0,2520,0,720000,1987
760,5500,1.5,0,760,0,92000,1947
1310,5000,2,0,1310,0,600000,1901
2750,13950,1,3,1380,1370,725000,1948
1790,10300,1,0,1270,520,409950,1961
1790,7167,2,0,1790,0,515000,1989
2400,11640,1,0,1800,600,495000,1968
2420,10200,2,0,2420,0,998000,1973
1710,8767,1,0,1710,0,630000,1986
2000,7480,1,0,1320,680,410000,1972
1580,11580,1,0,1580,0,602000,1979
2310,10232,1,0,1310,1000,750000,1980
3580,9316,2.5,0,2370,1210,711600,1991
4320,8709,2,0,3190,1130,1.05E+06,2006
2560,35265,2,0,2560,0,700500,1981
3220,18618,2,1,3220,0,710000,1991
1660,13085,1,0,1010,650,250000,1985
2420,8400,1,0,1620,800,350000,1964
2870,29699,1,0,1520,1350,475000,1961
830,7200,1,0,830,0,200000,1920
1710,7000,1,0,1040,670,450000,1972
2600,4641,2,0,2600,0,316000,2005
670,4920,1,0,670,0,310000,1920
1500,11975,1,0,1500,0,392000,1970
1460,1254,3,0,1460,0,521000,2000
1540,7110,1,0,960,580,495000,1949
1250,8084,1,0,1250,0,209000,1967
2230,9900,1.5,0,2230,0,809950,1959
1800,224769,1,0,1420,380,400000,1950
2400,7292,1,0,1530,870,415000,1980
2370,76665,2,0,2370,0,411000,1978
1830,3600,1,0,1230,600,825000,1926
1480,1384,3,0,1480,0,436000,2008
2620,8331,2,0,2620,0,460000,1991
1300,5782,1,0,1300,0,281000,1959
3120,7680,1,3,1660,1460,976000,1956
2400,10364,2,0,2400,0,485000,1995
1430,9240,2,0,1430,0,429000,1984
2480,7428,2,0,2480,0,729000,1990
2280,4757,2,0,2280,0,625000,2003
1390,9328,1,0,1390,0,218500,1987
1030,8395,1,0,1030,0,175000,1960
1120,8200,1,0,1120,0,442500,1938
1300,3000,2,0,1300,0,480000,1986
2410,9668,1,1,1540,870,715500,1965
1470,7350,1,0,1470,0,432500,1963
4720,18741,2,0,3210,1510,875000,2005
2910,13332,2,0,2910,0,605000,1940
5000,12941,3,2,5000,0,1.69E+06,2002
1690,12662,1,0,1090,600,318000,1982
1000,7228,1,0,1000,0,311300,1947
2400,7904,1,0,1450,950,325000,1992
3330,3705,2,0,2610,720,795000,2008
2060,10358,1,0,1320,740,558000,1962
3090,18645,2,0,3090,0,370000,1995
2350,7245,2,0,2350,0,598850,1993
2180,9722,2,0,2180,0,515700,1994
1870,5013,2,0,1870,0,458000,2003
3530,13000,2.5,0,3530,0,583500,1985
2460,4166,2,0,2460,0,653750,2003
1650,4725,2,0,1650,0,299000,2011
3480,57499,1,0,2340,1140,532000,1976
3176,13391,2,3,2726,450,819000,1985
2420,9000,1,4,2000,420,945000,1967
2260,9696,1,0,2260,0,608700,1983
2380,6122,1,2,1310,1070,812000,1949
3400,8970,1,0,1700,1700,464000,1959
3770,35081,2,0,3770,0,950000,1989
2672,4297,2,0,2020,652,700000,2005
1180,4219,1,0,1060,120,435000,1939
1810,14400,1,0,1810,0,229500,1954
2610,22672,1.5,4,2610,0,1.58E+06,1952
1450,13439,1,0,1180,270,265000,1963
1600,64468,1,0,1600,0,995000,1950
2650,9380,1,0,1680,970,590000,1975
2490,17833,2,2,1490,1000,740000,1979
850,7710,1,2,550,300,360000,1909
1820,7200,1,0,1300,520,548500,1976
1960,4788,1,0,1090,870,599000,1920
2350,20820,1,0,1800,550,615000,1978
1320,6600,1,0,1320,0,292000,1988
3720,30649,2,0,3720,0,899000,1988
2210,6500,1,0,1030,1180,500000,1912
1910,11550,1.5,0,1910,0,580000,2003
2840,6268,2,0,2840,0,580000,1998
1320,5000,1,0,1090,230,594000,1920
2440,7600,1,0,1420,1020,500000,1981
2420,8056,1,0,1680,740,550000,1988
1180,6260,1,0,1180,0,275000,1993
1820,7420,2,0,1820,0,390000,1983
3760,8500,2.5,3,3060,700,1.25E+06,1910
1560,15340,2,0,1560,0,250000,1997
1790,5400,2,0,1790,0,405000,1979
1430,7000,1,0,1430,0,213950,1968
1390,11340,1,0,1390,0,232000,1963
990,10800,1,0,990,0,207000,1959
1880,30346,1,0,1880,0,310000,1988
2520,5000,3,0,2520,0,540000,1990
2060,4000,1.5,2,1580,480,750000,1920
2150,7303,2,0,2150,0,392500,2005
2500,12220,1,0,1690,810,305000,1962
2390,9157,2,0,2390,0,735000,1984
2400,6137,2,0,2400,0,575000,1990
660,5000,1,0,660,0,175000,1915
1580,6633,2,0,1580,0,291000,1984
3250,8970,2,0,3250,0,791500,1994
1880,9659,1,0,1180,700,475000,1951
1190,11400,1,0,1190,0,238950,1951
1280,1257,2,0,1040,240,470000,2000
2380,15324,1,0,1610,770,420000,1978
2040,7605,2,0,2040,0,440000,1996
1440,4300,1.5,0,1290,150,656000,1929
2120,4310,2,0,2120,0,559950,2001
990,5416,1,0,990,0,600000,1935
1710,12000,1,0,1710,0,255000,1972
1840,7076,1.5,0,1840,0,210750,1957
1150,2560,1.5,0,1150,0,485000,1909
2250,8076,2,0,2250,0,390000,1995
2460,12600,1,0,1810,650,405000,1970
1540,4500,1.5,0,1540,0,462500,1905
2210,14073,1,0,1630,580,435000,1978
1440,5434,2,0,1440,0,440000,2003
1790,7650,1,3,1790,0,299950,1978
1120,1024,2,0,1120,0,440000,1970
1260,11877,1,0,1260,0,312620,1975
1180,12324,1,0,800,380,372500,1981
1730,8076,2,0,1730,0,297262,1994
2250,7245,1,0,1250,1000,735000,1963
1550,5034,2,0,1550,0,430000,1922
1070,9750,1.5,0,1070,0,241000,1995
1460,9750,1,0,1460,0,201000,1969
1060,4000,1,0,1060,0,570000,1910
1840,9600,1,0,1220,620,538000,1967
2440,4244,2,0,2440,0,729000,2011
1700,14756,1,0,850,850,331500,1955
680,8064,1,0,680,0,110700,1941
1700,8448,1,0,1700,0,245000,1996
2000,7111,1,0,1360,640,427000,1956
2340,5940,1,0,1290,1050,650500,1953
1120,7440,1,0,1120,0,335900,1939
1510,5133,1.5,0,1510,0,535000,1939
2120,2400,1,0,1080,1040,360000,1906
1500,8100,1,0,1210,290,294900,1968
1030,5934,1,0,1030,0,460000,1928
5440,38900,2,0,5440,0,1.77E+06,1990
1150,4400,1,0,1150,0,463000,1905
2420,43560,1,2,1500,920,332000,1962
1750,8116,1,0,1750,0,199500,1943
1750,8116,1,0,1750,0,247000,1943
2170,14024,2,0,2170,0,442500,1992
2540,237402,1,0,2540,0,600000,2007
1690,3827,2,0,1690,0,449000,2005
1600,4500,1.5,0,1600,0,725000,1926
1060,7900,1,0,1060,0,215000,1961
1990,6549,1,0,1170,820,582500,1948
2210,9371,2,0,2210,0,305000,1968
3090,7650,2,2,2340,750,734000,1959
1050,10072,1,0,1050,0,300000,1986
2550,71874,1,0,1810,740,525888,1960
2095,4400,1.5,0,1295,800,711000,1910
1520,12282,1,0,1220,300,360000,1978
2750,12350,2,0,2750,0,357000,1987
1200,9266,1,0,1200,0,235000,1960
1830,9720,1,1,1150,680,550000,1928
1160,7202,1,0,1160,0,324000,1957
1750,9239,1,0,1410,340,420000,1989
2400,7693,2,0,2400,0,450000,2003
4140,6770,2,0,3030,1110,825000,2004
2115,6234,2,0,2115,0,272000,1998
2580,15653,1.5,0,2580,0,481000,1990
1220,3400,1,0,1060,160,500000,1927
1630,3780,1,0,890,740,448000,1940
1350,4220,1,0,1350,0,480000,2004
1690,2890,2,0,1690,0,475000,2004
1700,2383,2,0,1700,0,472500,2005
1890,7616,1,0,1260,630,291000,1979
850,5250,1,0,850,0,294000,1950
2480,12688,1,0,1820,660,1.01E+06,1967
1690,3129,2,0,1690,0,442500,2002
810,8424,1,0,810,0,170000,1959
3980,16304,1,1,2480,1500,1.58E+06,1968
2580,6000,2,0,1780,800,665000,1925
6085,142725,3,0,6085,0,1.61E+06,2000
2140,5000,1,0,1000,1140,675000,1930
1360,10000,1,0,1360,0,279900,1957
1800,3245,1.5,0,1800,0,875000,1929
1920,3867,2,0,1920,0,571000,2005
860,5060,1.5,0,860,0,320000,1927
2340,35021,1,0,2340,0,525000,1986
4040,20666,1,0,2020,2020,1.65E+06,1962
1160,5082,1,0,580,580,137900,1942
1680,57063,2,0,1680,0,440000,1989
1280,3870,1,0,640,640,360000,1945
1800,9576,1,0,1800,0,271000,1977
4250,23326,1,3,2150,2100,465000,1967
2400,4596,2,0,2400,0,280000,2004
940,6350,1,0,940,0,283000,1942
1110,7208,1,0,1110,0,411500,1980
2420,7548,1,0,1370,1050,282000,1967
1850,1499,2.5,0,1790,60,535000,2005
2020,4350,2,0,1730,290,554729,1943
2020,4350,2,0,1730,290,868000,1943
1830,65340,1,0,1520,310,427000,1991
1920,6000,1,0,960,960,455000,1954
1280,8500,1,0,1280,0,595000,1953
3130,5240,2,0,3130,0,400000,2004
3920,12415,2,0,3920,0,770000,1997
3100,3773,2,0,2000,1100,742500,1919
3220,15600,1,0,1680,1540,1.25E+06,1973
1670,13775,1,0,1670,0,375000,1968
2700,17853,2,0,2700,0,1.56E+06,1960
5461,22880,1,0,3265,2196,545000,1964
4400,16625,2,0,4400,0,1.05E+06,2003
2190,8500,1,0,2190,0,1.57E+06,1957
1200,11163,1.5,0,1200,0,178000,1970
1470,10390,1,0,1470,0,262500,1989
1650,5000,1.5,0,1650,0,730000,1900
1840,10453,1,2,1360,480,395000,1948
1210,6650,1,0,1210,0,355000,1959
1870,8541,2,0,1870,0,299990,1989
3890,422096,1.5,0,3150,740,1.13E+06,2001
2660,11200,2,0,2660,0,425000,1972
1150,7552,1,0,1150,0,349000,1951
1740,4816,1,0,870,870,554950,1942
2580,8064,1.5,0,1880,700,326000,1913
1720,6975,1,0,1420,300,580000,1975
2740,18455,2,1,1510,1230,699000,1977
2610,11290,1,0,1630,980,757000,1985
1400,7920,1,0,1400,0,335000,1965
2570,28500,1,0,1970,600,660000,1983
2830,7334,2,0,2830,0,540000,2005
2630,8625,2,0,2630,0,320000,1966
1580,7918,2,0,1580,0,280000,1994
1540,10931,1,3,1540,0,324000,1989
2120,7735,1,0,1060,1060,300000,1967
1830,10000,2,0,1830,0,360000,1913
2260,10153,2,0,2260,0,600000,1987
2500,92347,1,0,1500,1000,950000,1970
1830,1804,3,0,1830,0,599950,2014
1190,7920,1,0,890,300,190000,1951
2310,9002,1,0,1780,530,350000,1970
1230,4600,1.5,0,1230,0,522000,1929
2940,10809,2,0,2940,0,850000,1992
1010,8800,1,0,1010,0,308000,1954
2550,5000,2,0,2550,0,1.02E+06,1907
1480,5100,1.5,0,1480,0,397500,1938
1460,7967,1,0,1040,420,186000,1977
3110,12429,1,0,1790,1320,436500,1977
2140,4923,1,0,1070,1070,710000,1928
3450,6360,2,0,1860,1590,1.38E+06,1905
1960,10682,1,0,1960,0,450000,1957
1890,5240,1,0,980,910,375000,1981
2080,14659,1,0,1040,1040,315000,1960
1700,4165,1.5,0,1700,0,467500,1918
1140,7316,1,0,1140,0,330000,1959
3136,54450,1.5,0,3136,0,665000,1910
2590,3889,3,0,2590,0,760000,2013
1480,800,2,0,1000,480,469000,2014
1500,1473,2,0,1120,380,408000,2000
2660,10350,1,4,1330,1330,851000,1971
1350,3926,1,0,1350,0,410000,2007
860,10500,1,0,860,0,235000,1943
1000,4500,1,0,1000,0,207100,1916
2480,16360,1,0,1510,970,560000,1959
3860,12786,2,0,3860,0,903000,1984
2140,4800,2,0,1690,450,998500,1905
1820,13600,1.5,0,1120,700,268500,1959
2220,33000,1,0,2220,0,494950,1970
2660,11200,2,0,2660,0,1.13E+06,1999
1470,12096,1,0,1470,0,250000,1942
2350,54450,1,0,1250,1100,449000,1971
2980,7700,1,0,2530,450,1.23E+06,1964
1870,7700,1,0,1870,0,325000,1966
2430,8000,1,0,1370,1060,506000,1957
2790,6538,2,0,2790,0,751000,2003
1370,22326,2,0,1370,0,280000,1993
4470,60373,2,0,4470,0,1.12E+06,1988
2040,81021,1,0,2040,0,580000,1980
2340,5300,1,0,1700,640,665000,1963
2520,8515,2,0,2520,0,450000,1999
1710,117176,1.5,0,1710,0,389900,1942
1200,5252,1,0,1200,0,427000,1962
1330,12618,1,3,1330,0,265000,1983
1310,2996,2,0,1310,0,398000,1998
3020,4500,2,0,3020,0,354000,1941
2260,6086,2,0,2260,0,339950,1999
790,4000,1,0,790,0,399000,1948
970,5000,1,0,970,0,325000,1983
2250,8000,1,2,2250,0,998800,1955
1530,2248,1.5,0,1530,0,350000,1914
1780,11436,1,0,1780,0,1.00E+06,1967
2120,5277,2,0,2120,0,561000,2005
1500,6685,1,0,1190,310,245000,1926
1500,6685,1,0,1190,310,570000,1926
2390,4000,1.5,0,1460,930,845000,1931
2390,9600,2,0,2390,0,314500,1996
2920,9370,1,0,1620,1300,650000,1981
850,5000,1,0,850,0,298000,1907
930,3200,1,0,930,0,500000,1904
3340,12248,2,1,2470,870,870000,1998
710,6732,1,0,710,0,299000,1942
2240,6450,1,0,1440,800,527000,1979
1060,7638,1,0,1060,0,420000,1966
2360,8764,2,0,2360,0,290000,1991
3520,19200,1,4,1950,1570,1.66E+06,1951
1730,9334,1,0,1220,510,499990,1977
1170,4000,1,0,720,450,315000,1943
3680,26266,2,0,3680,0,425000,1981
2900,46609,2,0,2900,0,630000,1987
1290,7205,1.5,0,1290,0,365000,1971
2010,7000,2,0,2010,0,774000,1901
1490,12186,1,0,1490,0,368888,1950
1930,7862,2,0,1930,0,339500,1994
2240,7500,1,0,1120,1120,344950,1956
2320,17688,1,0,2320,0,450000,1952
2990,6626,2,0,2990,0,814950,2014
2200,5730,2,0,2200,0,299900,2003
1500,7828,1,0,1500,0,315000,1967
3860,9000,1,2,1930,1930,880000,1970
1430,5200,1,0,1030,400,195000,1977
3750,8279,2,0,3750,0,910000,2001
3100,10189,2,0,3100,0,540000,2002
1870,5874,2,0,1870,0,306000,2005
2040,7600,1,0,1580,460,272000,1978
3700,8504,2,0,2750,950,1.30E+06,1950
3150,9258,1,1,2370,780,450000,1970
1990,12793,2,0,1990,0,450000,1993
1740,11075,1.5,0,1740,0,310000,1965
2080,11285,1,0,1180,900,530000,1954
2060,10125,2,0,1560,500,435000,1979
1590,11222,1,0,1590,0,485000,1948
1760,4000,2,0,1760,0,690000,1922
1620,4000,2,0,1620,0,305000,2008
1210,7000,1,0,1210,0,300000,1975
2040,5050,1,0,1490,550,289950,1993
2270,9600,2,0,2270,0,575000,1990
6640,53330,2,0,6640,0,1.82E+06,1993
1060,9600,1,0,1060,0,219000,1962
1940,8170,1,0,1940,0,265000,1948
3070,5000,2,0,2050,1020,1.11E+06,2006
930,7590,1,0,820,110,200000,1943
2180,8480,1,3,1210,970,545000,1959
2130,8404,2,0,2130,0,378000,1991
800,4800,1,0,800,0,388000,1922
2200,8384,1,0,1250,950,425000,1959
1130,746,2,0,1030,100,536000,2009
1970,23180,1,4,1100,870,1.18E+06,1937
1680,1620,2,0,1120,560,629950,2014
1470,5350,1,0,980,490,465000,1955
2390,40510,1,0,2390,0,545000,1969
2300,11165,2,0,2300,0,592000,1979
2280,43692,1,0,1140,1140,446000,1957
1330,816,3,0,1330,0,375000,2004
2640,7096,2,0,2640,0,632500,2003
2430,9747,1,0,1780,650,459950,1974
2470,35073,2,0,2470,0,485000,1989
1440,11330,1,0,1440,0,255000,1965
1320,7200,1,0,1320,0,251750,1975
2810,6300,2,0,2810,0,725000,2001
1370,1194,3,0,1370,0,460000,2005
2000,6341,1,0,1040,960,625000,1981
1980,6760,1,0,1980,0,530000,1973
2050,8172,2,0,2050,0,394950,2002
2320,9240,1,0,1160,1160,324950,1959
1960,1985,2,0,1750,210,330000,2003
1910,8171,1,0,1910,0,220000,1986
2030,11070,2,0,2030,0,685000,1980
2210,7680,1,2,1730,480,500000,1972
2610,9426,1,0,1360,1250,368000,1965
2520,7975,2,0,1550,970,825000,1990
1840,2774,1,0,1060,780,660000,1900
1570,7416,1,0,1570,0,253000,1971
2400,19923,1,0,1320,1080,392500,1953
1930,5400,2,2,1930,0,605000,1978
1160,10384,1,0,1160,0,215000,1969
2820,15000,2,0,2820,0,650000,1985
3060,8000,2,0,2040,1020,877500,1922
1320,8450,1,0,880,440,232500,1961
1200,3624,2,0,1200,0,234000,2003
1560,104108,1,0,1250,310,380000,1970
3070,64033,1,0,2730,340,420000,1983
1040,9600,1,0,1040,0,399950,1978
1990,8991,1,0,1570,420,256750,1969
1690,9626,2,0,1690,0,535000,1984
1810,2738,2,0,1810,0,515000,1979
2520,8442,1,0,1640,880,770000,1953
1570,5113,1,0,1090,480,256000,1996
1680,8910,1,0,1680,0,489900,1940
1250,7200,1,0,1250,0,165000,1978
1280,7742,1,0,1280,0,220000,1962
4620,20793,2,0,4620,0,575000,1991
1580,5725,2,0,1580,0,375000,2004
1650,7145,2,0,1300,350,422250,1977
1660,9600,1,0,1380,280,420000,1981
2410,7140,2,0,2410,0,608000,1993
1720,4000,1.5,0,1450,270,620000,1921
3120,12406,2,2,1940,1180,850000,1983
2680,9928,1,0,1340,1340,463000,1974
2640,13290,1,4,1400,1240,750000,1954
3730,13264,2,0,3730,0,1.07E+06,1989
1700,6498,1,0,1700,0,290000,1986
2280,5959,1,0,1250,1030,525000,1947
1220,2980,2,0,1220,0,319000,1986
3500,8504,2,0,3500,0,592500,1980
2010,14298,2,0,2010,0,350000,1977
2130,9775,1,0,1430,700,454900,1973
1800,9018,2,0,1800,0,272000,1992
1070,10125,1,0,1070,0,357500,1961
1020,5000,1,0,1020,0,285000,1954
1600,6861,1,0,1600,0,280000,1994
1380,7800,1,0,1080,300,477000,1928
3270,168000,2,0,3270,0,750000,1982
2100,3125,2,2,1400,700,595000,1907
2110,2850,3,0,2110,0,525000,2001
1640,53400,1,0,1640,0,319000,1966
1320,5665,1,0,1320,0,225000,1986
2420,10603,1,0,1210,1210,485000,1958
1390,4814,1.5,0,1390,0,341000,1908
2320,6744,2,0,1930,390,674000,2014
2170,8169,2,0,2170,0,442250,2003
2710,38180,2,0,2710,0,591000,1977
1450,8928,1,0,1450,0,276000,1998
1370,4400,1,0,1370,0,394000,1988
1810,3192,1,0,1070,740,355000,2001
1420,14850,1,0,1020,400,260000,1963
2090,9620,1,0,1340,750,300000,1987
2090,9620,1,0,1340,750,310000,1987
1330,6900,1,0,1330,0,209000,1976
1330,7419,1,0,1330,0,344950,1985
1910,7200,1,0,1110,800,230000,1951
2310,7680,1,0,1410,900,336950,1978
2500,7378,1,0,1390,1110,700000,1948
1310,7332,1,0,1310,0,230000,1987
2040,21781,2,0,2040,0,443500,1994
2040,21781,2,0,2040,0,471000,1994
2400,16301,1,0,1400,1000,595000,1962
1400,4914,1.5,0,1400,0,470000,1929
1700,7800,1,0,1700,0,600000,1975
3160,9525,2.5,0,3160,0,1.38E+06,1997
1340,13241,1,2,1340,0,427800,1985
1470,8395,1,0,1470,0,445000,1965
1790,7679,1,0,1790,0,382000,1953
1560,20251,1,0,1200,360,577000,1989
2620,108464,2,0,2620,0,427000,1990
1580,8206,1,0,1100,480,255000,1962
1090,10000,1,0,1090,0,240000,1961
3240,6551,1.5,4,2500,740,1.23E+06,1939
2520,7200,1,2,1260,1260,435000,1955
2230,13529,1,0,2230,0,1.45E+06,1949
2430,5502,2,0,2430,0,425000,2002
1020,4200,1,0,1020,0,393000,1923
1810,7500,1,0,1410,400,264950,1959
3460,9699,2,0,3460,0,746500,1987
2020,8100,1,0,1170,850,450000,1956
1410,7466,1,0,1410,0,229950,1983
750,4000,1,0,750,0,425000,1933
5300,26211,2,2,4570,730,2.56E+06,1923
4380,66613,1.5,0,4380,0,1.40E+06,1993
2290,9047,2,0,2290,0,753000,1984
720,5750,1,0,720,0,310000,1943
1200,6014,1,0,600,600,395000,1949
2620,28703,1,0,2620,0,725000,1985
2120,7650,2,0,2120,0,295000,1964
1580,8820,1,0,1580,0,225000,1967
4160,35153,3,2,3690,470,1.70E+06,2001
1830,8831,1,0,1460,370,431000,1979
2000,8057,1,0,1360,640,358500,1998
980,3600,1,0,980,0,595000,1907
3040,20682,2,0,3040,0,468000,2000
1740,8100,1,0,1020,720,260000,1962
1450,7300,1.5,0,1450,0,375000,1955
1560,4200,2,0,1560,0,295000,2003
2050,8909,1,2,1690,360,403900,1986
1760,12823,1,0,1460,300,269950,1956
1740,1975,2,3,1310,430,640000,1998
910,8789,1,0,910,0,221000,1966
1700,7532,1,0,1700,0,255000,1987
2620,4469,2,0,2620,0,300000,2008
1500,7410,1,0,1500,0,270000,1973
1630,5750,1,0,1160,470,575000,1947
1370,9800,1,0,1370,0,246900,1968
1390,1132,2,0,1130,260,635000,2006
1540,67756,1,0,1540,0,450000,1900
1190,7500,1,0,1190,0,215000,1968
4500,21870,2,0,4500,0,785000,2004
2370,8154,1,0,1380,990,522500,1977
1360,1934,2,0,1360,0,150000,1978
870,18537,1,0,870,0,199950,1946
4850,12445,2,4,3850,1000,3.00E+06,1989
3110,44967,2,0,3020,90,379900,1999
3700,7051,2,0,3700,0,950000,2006
3500,5150,2,0,2430,1070,865000,1909
1670,9600,1,0,1670,0,785000,1961
1640,8400,1,0,1180,460,245700,1968
3400,12825,1,1,3400,0,951000,1961
2060,3500,1,0,1030,1030,499950,1951
1330,36537,1,0,1330,0,257000,1989
2330,3600,1.5,0,1580,750,549000,1900
3040,21052,2,0,3040,0,1.60E+06,1980
3700,7920,3,4,2900,800,1.40E+06,1983
1990,3000,1.5,2,1430,560,619000,1927
2020,5917,1,0,1220,800,311000,1993
2980,7781,1,0,1580,1400,600000,1960
3990,5267,2,0,3990,0,1.08E+06,2008
790,6600,1,0,790,0,436000,1949
1060,8000,1,0,1060,0,205000,1941
2260,54014,1,0,1450,810,514000,1962
1900,2983,2,0,1900,0,530000,2006
3361,6983,2,0,3361,0,511000,2006
3550,19865,2,0,3550,0,2.10E+06,1962
2740,5460,2,0,2740,0,370000,2005
2040,6000,1,0,1020,1020,500000,1943
4070,129808,2,0,4070,0,710000,1998
720,5196,1,0,720,0,270000,1911
2000,8400,1.5,0,2000,0,415000,1959
4400,15580,2,0,3390,1010,1.80E+06,2003
1300,8976,1,0,1300,0,236000,1967
1420,2229,2,0,1420,0,278000,2004
1540,5338,1,0,770,770,312000,1954
1540,5338,1,0,770,770,539000,1954
2360,2750,2,1,1780,580,498000,1983
3720,29043,2,0,3720,0,857000,1991
1690,13500,1,0,1690,0,780000,1978
2300,5000,1,0,1150,1150,650000,1938
1650,7088,1,0,1650,0,559500,1973
990,6448,1,0,990,0,219950,1948
2130,8410,2,0,2130,0,671500,1977
3320,52707,2,0,3320,0,813000,1999
1960,8875,1,0,1290,670,182000,1965
770,2500,1,0,770,0,203700,1913
2010,3600,1.5,0,2010,0,740000,1902
800,17965,1,0,800,0,230000,1942
910,11117,1,0,910,0,128000,1955
1200,6628,1,0,1200,0,345000,1952
3570,6246,2,0,3570,0,663000,2005
1820,8085,2,0,1820,0,329950,1983
2930,7005,3,2,2670,260,1.05E+06,1999
1480,4050,1,0,870,610,402300,1926
3305,16164,1.5,0,2245,1060,492000,1922
2230,5000,1,0,1650,580,448000,2006
1560,7800,1,0,1560,0,273000,1955
1030,7200,1,0,880,150,335000,1948
2380,3600,1.5,0,1690,690,695000,1927
1010,7903,1,0,1010,0,279000,1948
2060,2700,1,0,1030,1030,485000,1929
2370,10580,2,0,2370,0,383000,1966
2242,37451,2,0,2242,0,490000,1995
1078,1263,2,0,1078,0,240000,1990
890,7250,1,0,890,0,285000,1943
2700,24539,2,0,2120,580,524950,1977
2450,27081,2,0,2450,0,729000,1985
1420,8250,1,0,1420,0,460000,1960
1280,2114,1.5,0,1280,0,687500,1904
2910,15118,1,0,1780,1130,1.17E+06,1972
2430,10050,2,0,2430,0,825000,1979
1860,6359,2,0,1860,0,314950,2003
1800,12669,1,0,1800,0,470000,1956
1960,8815,1,0,1020,940,500000,1958
1550,7260,1.5,0,1550,0,313000,1925
840,3840,1,0,840,0,445000,1926
2080,8750,1,0,1330,750,300000,1967
2210,5077,1.5,0,1480,730,619500,1912
1210,5240,1,0,610,600,305000,1983
1350,941,3,0,1350,0,874000,2007
1860,5146,2,0,1860,0,477500,1991
1940,4500,1,3,1090,850,700000,1926
3400,5222,2,0,3400,0,515000,2005
2240,9385,2,0,2240,0,590000,1991
1170,8239,1,0,1170,0,205000,1981
3130,9302,2,0,2190,940,310000,1987
1510,7280,2,0,1510,0,442500,1987
3740,41458,2,2,3740,0,1.08E+06,2000
2690,46609,2,0,2690,0,530000,1980
1760,6204,1,2,1180,580,343500,1950
2180,4066,1.5,0,1270,910,334900,1911
1560,9000,1,0,1560,0,544300,1969
1780,4050,2,0,1780,0,370000,2001
1260,6908,1,0,1260,0,245000,1994
1570,3250,1.5,0,1570,0,535000,1928
740,6550,1,0,740,0,202000,1946
2020,4960,2,0,1710,310,490000,1938
1500,3075,2,0,1420,80,651500,1929
1670,8056,1,0,1170,500,270000,1961
3620,8072,2,0,2920,700,1.16E+06,1999
1010,1309,2,0,860,150,289000,2007
1460,13503,1,0,1460,0,240000,1977
1790,6117,1,2,1350,440,790000,1940
1760,9621,2,0,1760,0,350000,1995
1790,1682,2,0,1480,310,246950,2006
1050,6000,1,0,1050,0,400000,1952
2590,6394,2,0,2590,0,533000,2003
1040,8645,1,0,1040,0,198400,1962
4060,8547,2,0,2790,1270,495000,2007
3190,14565,2,0,3190,0,862000,1990
3190,14565,2,0,3190,0,870000,1990
2180,9726,1,0,2180,0,875000,1966
2120,5840,2,0,2120,0,317000,1979
2110,6838,2,0,2110,0,325000,1991
1210,5000,1.5,0,1210,0,615000,1907
2410,7846,2,0,2410,0,334950,1992
1980,7807,2,0,1980,0,775000,1989
2370,9135,1,0,1600,770,600000,1967
1720,2218,1.5,0,1270,450,565000,1931
750,5026,1,0,750,0,292500,1942
2510,10418,1,0,1810,700,825000,1968
2577,156816,2,0,2577,0,495000,2000
1540,4773,2,0,1540,0,525000,1941
720,2500,1,0,720,0,438600,1910
1810,8158,1,0,1450,360,507000,1984
1380,8400,1,0,1380,0,275900,1967
2570,6251,2,0,2570,0,1.17E+06,2000
1690,6000,1,0,1690,0,275000,1957
1420,3060,1,0,860,560,355000,1923
2130,9579,1,0,1250,880,233000,1968
3000,5000,1.5,0,2110,890,666000,1918
2150,9000,1,0,1360,790,317500,1979
2280,10319,1,3,1270,1010,420000,1989
1560,8800,2,0,1560,0,290000,1942
1880,10758,1,0,940,940,320000,1952
2320,5284,2,0,2320,0,650000,2004
1010,7171,1,0,1010,0,325000,1967
1120,5000,1,0,1120,0,165000,1917
1560,16194,1,0,1560,0,500000,1961
1860,12197,1,0,1860,0,443000,1964
1150,8686,1,0,1150,0,213400,1963
1920,9380,1,0,1920,0,480000,1964
2490,7233,1,0,1460,1030,275000,1978
1460,3044,2,0,1460,0,299880,2000
1820,1501,2,0,1430,390,499950,2014
4290,17100,1,3,2480,1810,1.71E+06,1972
2230,9460,1,0,1480,750,550000,1960
2070,7476,2,0,2070,0,300000,2003
2480,4000,1,0,1240,1240,920000,1948
4110,15929,2,4,2720,1390,2.30E+06,2001
2290,3060,1.5,0,1550,740,620000,1928
1220,20400,1,0,1220,0,253500,1959
2620,13777,1.5,2,1720,900,978000,1926
3190,9856,2,0,3190,0,387500,1979
850,6906,1,0,850,0,325000,1948
1740,1308,3,0,1740,0,568000,2008
2140,7754,2,0,2140,0,525000,1996
2070,12708,2,0,2070,0,560000,1996
1680,4075,2,0,1680,0,394000,2008
1000,4956,1,2,1000,0,484950,1916
3340,12690,1,0,2550,790,1.30E+06,1956
1260,2767,2,0,1260,0,315000,1999
2430,32496,1,0,2430,0,590000,1993
560,5700,1,0,560,0,106000,1947
3380,9528,2,0,3380,0,751000,1994
1100,3500,1,0,1100,0,474000,1908
1700,3171,1,0,850,850,189000,1927
1600,3172,2,0,1600,0,440500,2002
2605,2216,2,2,2090,515,1.02E+06,1979
1850,4667,1,0,1850,0,589000,2010
1830,7651,2,0,1830,0,273000,1986
3050,18892,1,4,1650,1400,950000,1962
1240,1055,2,0,1200,40,277700,1967
2100,8163,2,0,2100,0,299900,1984
1250,15603,1,0,1250,0,235000,1959
1230,4800,2,0,1230,0,464000,1952
1690,9826,1,0,1690,0,281000,1988
1520,8870,1.5,0,1520,0,320000,1951
1890,6302,2,0,1890,0,282000,1997
1990,8900,1,0,1990,0,745000,1972
1480,3900,1,0,1480,0,245000,1980
1480,3900,1,0,1480,0,250000,1980
2120,2374,2,0,1770,350,470000,2005
1480,1077,2,0,1300,180,216650,2007
1250,8412,1,0,1250,0,440000,1975
2010,7972,2,0,2010,0,590000,1989
3150,35283,1,0,1800,1350,935000,1975
3010,5717,2,0,3010,0,848000,2000
3920,5823,2,0,3000,920,827500,2000
2880,3192,2,0,2180,700,1.13E+06,1919
2550,5663,1,0,1720,830,630000,2011
1120,9022,1.5,0,1120,0,340000,1962
3140,10918,1,0,1900,1240,570000,1968
4130,5575,2,4,2860,1270,2.75E+06,1993
2990,9614,1,2,1740,1250,514500,1976
1120,12625,1,3,1120,0,360000,1940
1570,8775,1,0,1570,0,228900,1943
2210,4000,2,0,2210,0,660000,2008
2390,5800,2,0,2390,0,647000,2000
1520,8625,1,0,1520,0,366000,1976
1830,7986,1,0,1060,770,354000,1962
2640,5900,2,2,2640,0,850000,1937
1740,5782,2,0,1740,0,496700,1989
1550,8300,1,0,1550,0,300000,1965
1040,8075,1,0,1040,0,390000,1961
1640,7200,2,0,1640,0,350000,1985
1640,7200,2,0,1640,0,561000,1985
1260,10065,1,0,1260,0,475000,1954
1170,1174,2,0,840,330,275000,2007
1590,13500,1,0,1090,500,290000,1980
1750,6725,1,0,1330,420,199000,1993
1770,4338,2,0,1770,0,279900,2001
3530,5500,2,0,2860,670,1.66E+06,1940
2160,10200,1,0,1360,800,405000,1978
2360,15860,1,0,2360,0,615000,1977
1980,12543,1,0,1180,800,268000,1978
1620,5444,1.5,0,1620,0,451000,1955
2700,9854,1,0,2700,0,850000,2012
3270,16553,2,2,2470,800,1.18E+06,1968
870,6150,1,0,870,0,245000,1941
840,3340,1,0,700,140,450000,1912
1340,1168,2,2,1080,260,370350,2002
1540,1256,3,0,1540,0,543000,2004
1650,8975,1,0,1650,0,265000,1942
2630,4611,2,0,2630,0,497000,2001
1880,9727,1,0,1100,780,419000,1979
1980,4500,2,0,1980,0,545800,1989
1500,10730,1,0,1000,500,403000,1977
1230,8235,1.5,0,1230,0,195000,1959
2520,2600,2,0,1670,850,1.13E+06,1925
1970,8925,1,0,1170,800,255000,1977
1520,8040,1,0,1520,0,500000,1951
2600,5390,1,0,1300,1300,855000,1960
2290,9200,1.5,0,2290,0,390000,1920
1979,8470,1,2,1329,650,339000,1956
2170,3672,2,0,2170,0,1.33E+06,1905
1820,17918,1,0,1190,630,429900,1962
1200,8560,1,0,1200,0,370900,1975
1210,7636,1,0,1210,0,457500,1952
1970,2601,2,0,1440,530,499000,1999
1040,11500,1,0,1040,0,225000,1947
1920,4000,1,0,1070,850,615000,1950
1020,1146,3,0,1020,0,455000,2001
1660,7500,1,0,1060,600,458000,1940
1670,7416,1,0,1220,450,580000,1974
3810,8019,2,0,3810,0,966000,2008
2020,10332,1,0,1010,1010,240000,1954
420,3298,1,0,420,0,229050,1949
1390,1407,3,0,1390,0,328500,2004
2010,10100,1,0,1110,900,319000,1964
1820,5000,1.5,1,1640,180,650000,1945
1630,1971,2,0,1630,0,398500,1996
800,16306,1,0,680,120,250000,1931
2270,11989,1,0,2270,0,815000,1968
2290,5002,2,0,1950,340,1.07E+06,1995
2750,219542,2,0,1870,880,510000,1981
590,6138,1,0,590,0,156000,1947
2570,7264,2,0,1720,850,254500,1998
2050,15020,1,2,1600,450,760000,1960
1610,6732,2,0,1610,0,210000,1994
2140,7715,2,0,2140,0,349950,1991
1730,6784,2.5,0,1730,0,676000,1942
2440,3052,2,0,1940,500,475000,2006
3220,4392,1.5,0,2320,900,880000,1931
4330,26162,2,0,4330,0,1.21E+06,1997
1780,5000,1,4,1030,750,420000,1958
1230,8114,1,0,1230,0,607000,1951
2160,19283,2,0,2160,0,475000,1981
1400,2500,1,0,710,690,395000,1916
1900,10454,1,0,1180,720,650000,1954
2910,85377,1,0,1510,1400,625000,1966
2960,42159,2,0,2960,0,849000,1995
2010,9480,1,0,1570,440,429950,1951
3760,5260,2,0,3230,530,825000,2002
1020,5000,1,0,1020,0,505000,1916
1290,2828,2,0,1290,0,265000,2008
890,8400,1,0,890,0,283000,1954
1620,7500,1,0,1140,480,560000,1979
3360,13636,2,0,3360,0,765000,1987
2930,31411,1,0,1520,1410,610000,1975
2940,4799,1,0,1710,1230,589000,1996
1080,8580,1.5,0,1080,0,192500,1900
4560,13363,1,4,2760,1800,3.20E+06,1995
1010,6120,1,0,860,150,550000,1940
1790,3760,1.5,0,1280,510,460000,1928
2060,11385,1,0,1200,860,264500,1962
1150,2496,1,0,1010,140,339000,1947
4030,4200,3,0,4030,0,950000,1992
2020,9718,1,0,2020,0,677500,1956
2740,8120,2,0,2740,0,690000,1999
1930,7452,1,0,1430,500,312000,1984
2500,11617,1,0,1560,940,840000,1966
2080,5100,2,0,2080,0,357500,2004
1460,6480,1,2,980,480,675000,1940
3290,11441,2,0,3290,0,515000,1988
1540,1860,2,0,1540,0,491234,2014
1310,6265,1,0,1310,0,290000,1988
2120,7820,1,0,1280,840,490000,1975
2920,10424,1,0,1520,1400,810000,1964
1150,13200,1,0,1150,0,252000,1956
2380,9719,2,0,2380,0,299999,2001
2220,5000,2,0,2220,0,400000,1993
3020,6000,1.5,0,1860,1160,530000,1925
2460,53882,1,4,2460,0,357000,1955
1820,5555,1,0,1030,790,365000,1939
2620,5060,2,0,2620,0,804000,2005
1750,2640,1,0,1010,740,808250,1914
2020,7289,2,0,2020,0,360000,1994
1240,10956,1,0,1240,0,240000,1987
1380,5840,1,0,1380,0,335000,1988
1920,8775,1,0,1920,0,380000,1953
1680,250470,1,0,1070,610,350000,1940
1400,7955,1,0,1400,0,194000,1964
1240,7194,1,0,1090,150,310000,1936
1410,15134,1,0,1410,0,315000,1980
1440,8050,1,0,1440,0,258950,1985
1230,932,2,0,1020,210,479000,2004
1550,9750,1,0,1550,0,510000,1966
1760,6875,1,0,1760,0,400000,1967
5000,38012,2,0,3610,1390,1.45E+06,2004
2140,5000,1.5,0,2020,120,680000,1913
3510,5760,2.5,0,3510,0,1.75E+06,1906
2010,9417,1,0,1500,510,335000,1967
3390,9760,1,0,1750,1640,460000,1978
2160,8119,1,0,1080,1080,440000,1966
1300,2983,1,0,1300,0,412250,2006
1280,4031,2,0,1280,0,185000,1985
1840,8140,1,0,1040,800,286500,1975
3200,6691,2,0,3200,0,422000,2002
2800,35362,2,0,2800,0,408000,1985
1390,19988,1,2,1390,0,306500,1949
2600,5188,2,0,2600,0,359900,2005
1960,6058,2,0,1960,0,560000,2002
1250,21303,1,0,1250,0,259875,1970
1250,21303,1,0,1250,0,385000,1970
550,16345,1,0,550,0,188000,1945
2500,5801,1.5,0,1960,540,1.14E+06,1926
1250,10094,1,0,1250,0,255000,1927
3020,8622,2,0,3020,0,1.19E+06,1976
1640,4240,1,0,920,720,635200,1921
1870,8250,2,0,1870,0,355000,1956
1760,1755,3.5,0,1760,0,544000,1998
1320,3145,2,0,1320,0,402000,1998
1430,4163,1.5,0,1430,0,575000,1910
1580,9705,1,0,1580,0,216000,1977
4170,9748,2,0,4170,0,1.20E+06,2004
3090,6744,2,4,3090,0,850000,1923
1020,1204,2,0,720,300,238000,2004
2180,4431,1.5,0,2020,160,625000,1912
3350,4000,2,0,2510,840,1.11E+06,1997
2510,5503,2,2,2510,0,820000,1995
1880,5290,1,0,1250,630,355000,1974
1810,7998,1,0,1210,600,495000,1960
4170,33310,2,0,4170,0,1.30E+06,1991
2230,4000,2,0,2230,0,398750,1954
3650,7784,2,0,3650,0,835000,2006
2830,10579,1,0,1430,1400,705000,1967
2120,5000,2,0,2120,0,625000,1900
2090,6926,2,0,2090,0,550000,1990
2600,5085,1,0,1400,1200,540000,1940
830,2820,1,0,830,0,519000,1920
1975,8734,2,0,1975,0,311000,1996
1900,7000,1,0,1420,480,305000,1968
2640,35070,1.5,0,2640,0,395000,1963
1610,6923,1,0,1010,600,275000,1969
1770,1863,2,0,1430,340,450000,2003
1070,6000,1,0,1070,0,324000,1955
4590,12793,2,2,3590,1000,2.80E+06,1928
1540,2452,1.5,0,1540,0,565000,1906
1590,7920,2,0,1590,0,373000,1960
1170,1890,1.5,1,1170,0,613000,1927
2880,9996,1,0,1920,960,614000,1981
2510,8989,1,0,1680,830,595000,1964
1280,12086,1,0,850,430,440000,1983
1570,12412,1,3,1570,0,425000,1954
740,6380,1,0,740,0,407000,1912
1740,9038,1,0,1740,0,472000,1955
1180,1262,3,0,1180,0,472000,2010
2960,28300,1,3,2160,800,1.25E+06,1959
1880,5752,1,0,940,940,412000,1945
1150,5000,1,0,1150,0,717000,1959
1320,7076,1,0,1320,0,425000,1959
1640,7200,1,0,820,820,299999,1944
1470,7694,1,0,1470,0,254000,1992
900,10511,1,0,900,0,178500,1961
1510,3600,1,0,1230,280,800000,1910
1440,5623,1,0,720,720,420000,1922
1380,9251,1,0,1380,0,319900,1940
1150,7552,1,1,1150,0,350000,1944
3610,17580,1,4,2070,1540,968000,1959
1250,1306,3,0,1250,0,491000,2000
3510,9824,2,0,3510,0,948000,2002
2260,9577,2,0,1700,560,900000,1925
2840,9800,1,0,1420,1420,270000,1977
1430,7347,1,0,820,610,198000,1980
1420,21158,1,0,1420,0,250000,1953
2120,3720,2,0,2120,0,615000,2004
2080,7749,2,0,2080,0,550000,1988
1370,3438,2,0,1370,0,190000,1987
1900,11171,1,0,1280,620,629000,1984
1660,8301,1,0,1660,0,434000,1955
1310,4163,1,0,1310,0,415885,1964
1840,3035,1,0,920,920,550000,1926
1040,6034,1,1,580,460,272000,1991
2610,35000,2,0,2610,0,665000,1988
1990,7405,1,0,1990,0,510000,1971
3080,17700,1,0,1740,1340,530000,1965
1200,16000,1,0,1200,0,355000,1970
1250,9102,1,0,1250,0,255000,1955
2640,9000,2,0,2640,0,790000,1990
1790,9335,2,0,1790,0,695000,1952
1140,8400,1,0,1140,0,255000,1954
1790,5794,1.5,0,1380,410,410000,1985
1910,16532,1,0,1420,490,650000,1940
1530,3615,1.5,0,1530,0,675000,1913
1050,1029,2,0,950,100,332888,2007
1730,6900,1,0,1130,600,300000,1976
1100,11824,1,0,1100,0,320000,1954
2100,10726,1,0,1050,1050,342500,1963
2800,72309,2,0,2800,0,752875,1992
5000,26540,2,3,3410,1590,1.73E+06,2008
880,1642,1,0,500,380,255000,1910
1470,9337,2,0,1470,0,244000,1991
3950,11438,2,2,3430,520,1.42E+06,2006
980,12812,1,0,980,0,218000,1956
2180,10617,1.5,0,2180,0,359000,1950
3040,13559,2,0,3040,0,840000,2003
4130,226076,2,0,3170,960,900000,1985
1850,65340,1.5,0,1850,0,205000,1972
1600,7295,2,0,1600,0,205000,1993
2070,5432,2,0,1370,700,500000,1951
3180,5405,2,0,3180,0,510000,2001
6900,244716,2,0,4820,2080,1.14E+06,2002
2640,3000,2,0,2080,560,1.55E+06,1908
1920,61014,1,0,1920,0,210000,1953
2030,32565,1,0,1600,430,597500,1981
1140,101529,1.5,0,1140,0,400000,1932
1660,6992,1,0,1260,400,412000,1952
1390,1756,3,0,1390,0,299950,2005
2490,4325,1.5,0,1690,800,1.08E+06,1922
2550,8824,2,0,2550,0,422500,1990
1270,10227,1,0,1270,0,410000,1968
2980,7000,2,3,2140,840,1.40E+06,1900
1470,8000,1,0,1470,0,245000,1974
3550,12327,1.5,0,2180,1370,720000,1990
780,7200,1,0,780,0,315000,1935
1390,1302,2,0,1390,0,191950,1987
2440,5001,2,0,2440,0,455000,2005
1260,3135,1.5,0,1260,0,523000,1931
1640,4420,2,0,1640,0,250000,1918
1670,4120,1.5,0,1140,530,294000,1929
2380,6000,1,0,2040,340,490000,1961
1030,5750,1,0,1030,0,310000,1971
1560,10489,1,0,1560,0,265000,1961
1640,10500,1,0,1010,630,402000,1968
2200,188200,1,3,2200,0,705000,2007
3190,7941,2,0,3190,0,589450,2005
1200,8404,1,0,1200,0,219950,1964
2250,5301,2,0,1510,740,750000,1975
1960,6000,1,0,980,980,478000,1904
1250,7015,1,0,1250,0,170000,1958
2640,31941,1,0,2640,0,489950,1986
2460,16940,1.5,4,1930,530,1.37E+06,1936
1700,7000,2,0,1700,0,319950,1996
840,4200,1,0,840,0,208417,1938
1900,5100,1,0,950,950,410000,1914
2160,4205,1,3,1080,1080,590000,1969
1610,10229,1,0,1610,0,648000,1961
1720,6194,2,0,1720,0,255000,1998
2190,3267,2,0,2190,0,465000,2004
3020,10714,1,0,1510,1510,622000,1958
1980,9800,1,0,1980,0,306000,1991
1880,5500,2,0,1880,0,617000,1947
1610,6480,1,0,1610,0,438750,1947
3260,4500,2,0,2300,960,1.28E+06,1930
3970,8029,2,2,2970,1000,995000,1979
4570,74487,2,4,4570,0,1.58E+06,1948
2620,5500,1.5,0,1710,910,635000,1911
1180,9000,1,0,1180,0,215000,1970
1365,1090,3,0,1315,50,530000,2003
720,4125,1,0,720,0,295000,1943
1350,6775,1,0,930,420,245000,1981
3060,17112,1,0,1530,1530,400000,1967
1850,8820,2,0,1850,0,303000,1993
1320,9675,1.5,0,1320,0,330000,1970
1990,13000,2,3,1990,0,700000,1980
610,4400,1,0,610,0,126000,1922
2500,35802,1.5,0,2500,0,850000,1955
1440,7425,1,0,1440,0,405000,1965
2750,4400,2,0,1770,980,869900,1987
1790,6775,1,2,1790,0,485000,1951
1050,1173,2,0,720,330,400000,2004
1780,4650,2,0,1780,0,299950,2011
2200,9099,2,0,2200,0,585000,1994
1720,5413,2,0,1470,250,495000,1938
5840,17168,2,0,4570,1270,2.20E+06,2006
1520,14080,2,0,1520,0,447000,1984
1320,9239,1,0,1320,0,206000,1968
1070,4600,1,0,950,120,500000,1930
1990,5511,2,0,1990,0,302500,1994
4980,13000,2,3,3080,1900,1.25E+06,1982
890,5423,1,0,890,0,391000,1946
1440,5457,2,0,1440,0,250000,1986
2440,5350,2,0,2440,0,435000,2003
1800,14722,1,0,1440,360,160000,1962
2260,6508,1,0,1330,930,451000,2003
810,7158,1,0,810,0,206000,1944
2240,5400,2,0,1540,700,590000,1940
4560,17622,2,0,3800,760,695000,1986
1550,40752,1,0,1550,0,350000,1954
3180,4628,2,0,2420,760,1.24E+06,2001
2950,11200,1,0,1700,1250,395000,1970
2190,9652,2,0,2190,0,419000,1999
1570,4665,1,0,1570,0,592350,2006
3420,5669,2,0,2620,800,855000,2003
2420,7200,2,0,2420,0,771000,1991
1570,43350,1,3,1570,0,325000,1967
3680,6060,2,0,2630,1050,1.85E+06,1925
1910,6731,1,0,1210,700,545000,1953
1780,5175,1,0,990,790,615000,1927
2160,7439,1,0,1300,860,625500,1953
1460,15000,1,0,1460,0,232000,1966
1370,7439,1,0,1370,0,168000,1963
1370,7439,1,0,1370,0,238000,1963
1500,7401,2,0,1500,0,260000,1998
1210,7500,1,0,1210,0,460000,1951
2850,11535,1,1,1680,1170,900000,1952
1090,8280,1,0,1090,0,289950,1947
1450,5858,1,0,1450,0,265000,1991
1820,20349,1,0,1340,480,465000,1977
1320,7201,1,0,1320,0,370000,1971
1670,9880,1,0,1670,0,240000,1941
1440,5911,1,0,1440,0,232000,1943
980,7560,1,0,980,0,237502,1951
4340,5500,2,0,2850,1490,1.28E+06,2008
2860,11545,1,0,1430,1430,957000,1966
1140,4875,1,0,1140,0,218000,1970
1120,8366,1,0,1120,0,205000,1968
1460,1592,2,0,1130,330,350000,2006
2050,5787,2,0,2050,0,256000,2002
1250,7654,1,0,1000,250,275000,1952
2520,9604,2,0,2520,0,372000,1990
2580,9825,1.5,1,1760,820,688888,1978
1200,24792,2,0,1200,0,170000,1976
2140,7910,1,0,1070,1070,530000,1962
3440,7661,2,0,3440,0,905000,2006
1800,5070,1,0,1080,720,365000,1979
1790,10584,1,0,1290,500,312000,1981
1250,7680,1,0,1250,0,400000,1922
800,5765,1,0,800,0,278750,1936
1410,11995,1,0,1410,0,510000,1965
1330,806,3,0,1330,0,527700,2009
2890,4000,1.5,0,2190,700,740000,1931
2550,17209,2,0,2550,0,512000,1996
2880,8216,2,0,2880,0,362000,2001
660,6600,1,0,660,0,225000,1940
1470,4322,2,0,1470,0,491500,1985
1700,10230,1,0,1320,380,429950,1959
1040,9800,1,0,1040,0,375000,1955
880,4000,1,0,880,0,199400,1916
2490,9346,2,2,2490,0,364900,1996
1210,7560,1,0,1210,0,324950,1941
2080,4000,1,0,1040,1040,467000,1909
1380,5400,1,0,1380,0,380000,1954
1620,10850,1,0,1620,0,250000,1966
1680,4021,1.5,0,1680,0,700000,1921
1330,9620,1,0,1330,0,206990,1976
1730,3400,1,0,970,760,670000,1928
790,6969,1,0,790,0,315000,1955
2240,7500,2,0,2240,0,319950,1985
1500,8272,1,0,1500,0,419000,1958
1800,11419,1,0,1800,0,205000,1989
1980,4745,2,0,1980,0,335000,2004
1340,5100,1,0,1340,0,397000,1953
750,2020,1,0,750,0,370000,1908
1790,9920,1,0,1170,620,330000,1969
5490,14300,1,4,2910,2580,1.79E+06,1996
1940,16300,1,0,1140,800,399000,1978
2670,189486,2,4,2670,0,400000,1972
1220,6404,1,0,1220,0,249900,1994
1310,3880,1,0,1090,220,717000,1956
1930,8336,2,0,1930,0,319000,1995
2100,3800,2,0,2100,0,635000,1972
1180,7573,1,0,1180,0,355000,1977
4320,32840,2,0,4320,0,1.60E+06,1990
3140,12519,1,0,2320,820,585000,1951
2320,7800,1,0,1160,1160,320000,1960
2110,10200,2,0,2110,0,305495,1966
1790,14690,1,1,1670,120,240000,1960
1740,8750,1,0,1740,0,199950,1959
3820,8114,2,0,3820,0,1.62E+06,2005
2050,21744,2,4,1750,300,770000,1930
1680,3179,2,0,1680,0,255000,2002
1930,8925,1,0,1930,0,289000,1974
3760,8804,2,0,2470,1290,494500,2002
2370,9619,1,0,1650,720,746000,1973
2120,13000,2,0,2120,0,385000,1978
2370,10513,2,0,2370,0,688100,1987
2350,3150,1.5,0,1690,660,870300,1910
1180,8474,1.5,0,1180,0,310000,1956
2270,5654,2,0,2270,0,500000,1999
1830,7770,1,0,1400,430,255000,1977
3910,7080,1,0,1970,1940,1.48E+06,1949
890,9465,1,0,890,0,154500,1957
1820,8058,1,0,1260,560,425000,1974
2440,7491,2,0,2440,0,700000,1988
1110,3943,1,0,740,370,410500,1916
1870,7080,1,0,1210,660,432000,1969
1240,4080,1.5,0,1240,0,530000,1914
1560,8640,1,0,1560,0,465000,1967
1910,5600,2,0,1910,0,498688,1989
2200,21450,1,0,1600,600,573500,1952
2530,13474,2,0,2530,0,349900,1994
1130,12519,1,0,1130,0,220000,1958
820,6771,1,0,820,0,260000,1918
960,4000,1,0,960,0,290000,1918
1980,3240,1.5,0,1780,200,615000,1930
3370,5638,2,0,2250,1120,730000,2001
7420,167869,2,3,7420,0,1.95E+06,2002
1800,10500,2,0,1800,0,332500,1995
3990,10120,2,0,2820,1170,650000,1990
4070,7800,3,0,3390,680,1.40E+06,2002
1640,7194,1.5,0,1480,160,465000,1915
3730,11820,2,0,2460,1270,690000,1990
1220,7004,1,0,1220,0,289900,1966
3490,4000,2,0,2570,920,1.62E+06,2009
1730,4286,2,0,1730,0,339950,1999
3430,8000,1.5,0,3430,0,367999,1972
2320,10079,2,0,2320,0,380000,1994
2030,17100,1,0,2030,0,440000,1953
4850,36450,2,0,4850,0,975000,1977
1340,13560,1,0,1340,0,309500,1968
1130,8201,1,0,1130,0,350000,1948
1180,2521,2,0,1180,0,215000,2005
910,6000,1,0,910,0,254000,1943
1630,4275,1.5,3,1630,0,567000,1908
710,1173,2,0,710,0,402000,1943
1520,80150,1,0,1520,0,365000,1948
2820,8408,2,0,2820,0,625000,2014
1970,5160,1.5,0,1970,0,432000,1942
2240,19090,1,0,1700,540,335500,1968
1860,5940,1,2,1020,840,672500,1956
1780,4310,1.5,0,1780,0,336000,1919
1788,10183,2,0,1788,0,294400,1990
1880,3054,2,0,1880,0,541900,1988
2300,11400,1,0,1520,780,505000,1977
1610,6176,2,0,1610,0,255000,1994
2270,11970,1,0,1470,800,435000,1964
1230,3600,1.5,0,1230,0,636000,1925
3420,33106,2,0,3420,0,655000,2004
1670,6988,1,0,1370,300,280500,1953
1120,6141,1,0,900,220,520000,1946
2580,5476,2,0,2580,0,354000,2005
3847,17654,1,2,2299,1548,810000,1975
3630,42884,1.5,0,2300,1330,400000,1979
3580,12000,1,0,1840,1740,879900,1979
4050,11358,2,0,2780,1270,1.29E+06,1980
3240,23522,2,0,2130,1110,902500,1992
1540,8400,1.5,0,1540,0,900000,1902
2550,7200,2,2,2550,0,419500,2003
2340,6000,1,0,1270,1070,685000,1953
2320,4524,2,0,2320,0,429950,2004
1640,6000,2,0,1640,0,464950,2011
910,9000,1,0,910,0,239900,1983
2550,11524,2,0,2550,0,406250,1990
2660,8027,2,0,2660,0,447000,1997
1480,14250,2,0,1480,0,466800,1996
2810,11560,1,0,1740,1070,674000,1962
830,3200,1,0,830,0,525000,1924
3510,92347,2,0,3510,0,674950,1990
2480,4950,2,0,2480,0,374900,2004
3720,5000,2.5,0,2720,1000,1.44E+06,1905
2150,9250,2,0,2150,0,559500,1984
2370,7875,2,0,2370,0,522500,2003
4310,28008,2,0,4310,0,1.13E+06,1988
2990,7420,2,0,2990,0,498500,1996
1350,4000,1.5,0,1350,0,571000,1930
2370,217800,1.5,0,1600,770,543000,1992
1410,10248,1,0,1410,0,271920,1985
1170,8254,1,0,1170,0,104950,1949
1800,4500,2,0,1800,0,485500,1999
3650,6982,2,2,2530,1120,1.21E+06,1951
1490,8357,1,0,1490,0,260250,1993
3610,13292,2,0,3610,0,875909,1996
2050,94525,1,0,1250,800,455000,1959
1092,7500,1.5,0,1092,0,309000,1918
2010,7688,1,0,1170,840,229000,1979
1680,7900,2,0,1680,0,250000,1953
2510,38141,1,0,2510,0,600000,1960
2280,65836,2,0,2280,0,535000,2004
2510,5186,2,0,2510,0,571000,2001
3190,16920,1,3,1690,1500,1.03E+06,1976
4690,14930,2,2,3680,1010,600000,1995
1850,12000,1,0,1300,550,469500,1977
4160,13170,2,0,3040,1120,1.15E+06,2001
2220,4000,1.5,0,1970,250,785000,1925
2870,13695,2,0,2870,0,872750,1991
3950,10214,1,3,2050,1900,900000,1955
1740,6620,1.5,0,1740,0,350000,2002
4780,20440,1,0,3660,1120,2.58E+06,1975
3160,39960,1,0,3160,0,940000,1980
1990,27810,1,0,1990,0,185000,1955
3920,37122,2,0,3920,0,850000,1996
960,15273,1,0,960,0,201000,1963
1540,6549,2,0,1540,0,499000,1980
1970,5190,2,0,1970,0,315000,2002
1880,4668,2,0,1880,0,509950,1993
2000,6405,1,0,1260,740,286300,1964
1990,8325,2,0,1310,680,590000,1997
1400,9384,1.5,0,1400,0,325000,1948
3190,27806,2,0,3190,0,625000,1997
1000,6914,1,0,1000,0,378000,1947
1670,6900,1,0,1170,500,239950,1978
2100,4500,1,0,1060,1040,550000,1924
1010,6180,1,0,1010,0,325000,1903
2030,3905,1.5,0,1630,400,831000,1926
1090,10296,1,0,1090,0,249000,1950
2440,16730,1,0,1390,1050,484000,1976
2500,6278,2,0,2500,0,395000,2002
3420,7462,2,0,3420,0,839900,2002
2850,11000,2,0,2850,0,760000,1998
2030,3300,1.5,0,1530,500,750000,1927
4590,11265,2,0,3450,1140,3.00E+06,1927
2230,5800,2,0,2230,0,440000,2004
1810,7523,1,0,1170,640,501000,1962
4000,7500,2,0,4000,0,739000,1978
1490,16200,1,0,1490,0,685650,1958
4225,284011,2,0,4225,0,1.01E+06,1985
2120,4000,1.5,0,1920,200,980000,1929
1030,7184,1,0,1030,0,275000,1968
2310,8045,1,0,1650,660,319950,1976
1830,7943,2,0,1830,0,448500,1985
2120,137565,1.5,0,2120,0,437000,1913
2500,9448,1,0,1250,1250,330000,1966
2470,7700,2,0,2470,0,365000,1990
940,7700,1,0,940,0,329000,1916
3260,11700,1,0,1630,1630,681500,1964
1660,10140,1,0,1370,290,566000,1980
4370,217882,2,0,4370,0,897500,1984
2620,9112,2,0,2620,0,738000,1995
1500,7800,1,0,1500,0,185000,1968
910,7200,1,1,830,80,445000,1936
1430,4920,1,0,1430,0,175000,1957
900,8556,1,0,760,140,315000,1941
1250,7400,1,0,1250,0,445000,1959
3850,14990,1,0,2290,1560,1.40E+06,1964
3450,35100,2,0,3450,0,832500,1987
3950,12320,2,0,3950,0,771150,2001
1950,12559,1.5,0,1950,0,225000,1939
1700,6396,2,0,1700,0,389950,2003
2370,6082,2,0,2370,0,435000,2004
1600,2538,2,0,1600,0,845000,1929
4060,5500,2,0,2660,1400,1.30E+06,1924
1322,1796,2,0,1087,235,350000,2005
1140,10400,1,0,1140,0,250000,1983
1280,2096,2,0,1080,200,370000,2007
3080,4553,2.5,0,3080,0,750000,2008
1210,3000,1,0,910,300,439950,1906
1950,10219,1,0,1950,0,395000,1962
1450,6820,1.5,0,1450,0,375000,1947
1590,7748,2,0,1590,0,263000,1991
1240,9198,1.5,0,1240,0,185000,1959
1440,54315,1,0,790,650,500000,1974
3470,10045,2,0,3470,0,920000,1993
5100,21802,2,0,3640,1460,936000,2001
2430,12757,1,2,1340,1090,1.50E+06,1952
2420,7200,1,0,1420,1000,1.10E+06,1948
1510,10875,1,0,1150,360,247000,1990
1200,5525,1,0,1200,0,289500,1947
2240,6396,2,0,2240,0,432500,2002
1870,4320,1,0,970,900,680000,1920
1110,6000,1.5,0,1110,0,589000,1932
3210,8400,1.5,0,2040,1170,756450,1914
2090,8910,1,0,1230,860,536650,1975
1320,1800,2,0,1320,0,540000,1994
1340,3850,1,0,1340,0,385000,1960
1020,6120,1,0,1020,0,485000,1941
1220,17652,1,0,1220,0,240000,1980
1220,17652,1,0,1220,0,415500,1980
1390,2688,1.5,0,1390,0,550000,1915
2970,5400,2.5,0,2970,0,1.26E+06,1900
1440,213008,2,0,1440,0,430000,1990
1550,4257,1,3,830,720,415000,1953
1904,8200,2,0,1904,0,365000,1999
1400,8500,2,0,1400,0,257000,1975
2140,3821,2,0,2140,0,420000,2005
1320,9450,1,0,1320,0,338995,1943
2620,8280,1,0,1330,1290,615000,1948
2300,5570,2,0,2300,0,312500,1996
2000,5684,2,0,2000,0,513000,1996
2960,5040,2,3,2210,750,857500,1952
2700,22343,1.5,1,2700,0,1.06E+06,1977
1740,9500,1,3,1150,590,585000,1958
1770,4950,1,0,1770,0,350500,2003
1290,9312,1,0,1290,0,215000,1947
1450,8400,1.5,0,1450,0,440000,1962
1420,7800,1,0,1130,290,270000,1985
1330,7020,1,0,1330,0,385000,1924
1760,4125,1.5,3,1760,0,688500,1927
2010,4905,1,0,1230,780,700000,1912
2560,14467,1,0,1280,1280,585000,1960
1260,2625,2,0,1260,0,401000,1983
2420,7725,1,0,1890,530,655000,1972
1010,5400,1,0,1010,0,317000,1959
1770,8155,1.5,0,1770,0,500000,1970
890,6350,1,0,890,0,314963,1943
1670,5060,2,2,1670,0,715000,1925
1360,9600,2,0,1360,0,280000,1992
2120,9736,2,0,2120,0,531000,1988
1910,4488,2,0,1910,0,617000,1998
1480,7560,1.5,0,1480,0,440000,1940
1090,10114,1,0,1090,0,140000,1955
1670,13125,1,0,1670,0,661000,1973
1670,13125,1,0,1670,0,697000,1973
3650,13297,2,0,2750,900,1.20E+06,1969
1970,3515,1,0,1030,940,535000,1969
1320,3060,1.5,0,1320,0,404500,1910
1710,5110,1,0,1100,610,396500,1954
1740,9488,1,0,1180,560,450000,1977
2200,2400,2,0,1740,460,605000,1988
2010,4320,2,2,2010,0,699000,1999
3910,19023,2,0,3910,0,805000,1985
470,15000,1,0,470,0,156000,1947
2330,7064,1,0,1780,550,595000,1984
1930,7200,1.5,0,1930,0,285000,1929
3270,6055,2,0,3270,0,725000,2007
1650,5000,2,0,1650,0,216300,1985
2220,8450,1,0,1260,960,410000,1983
2470,4600,1,3,1140,1330,597000,1916
1300,9300,1,0,1300,0,325000,1977
2530,9375,1,0,1530,1000,355000,1966
2400,8215,1,0,1200,1200,338000,1961
1500,5393,2,0,1500,0,210000,1999
1700,9000,1,0,1700,0,423000,1967
2120,8554,1,0,1170,950,249500,1977
2240,5105,2,0,2240,0,325000,2002
1540,8223,1,0,1070,470,257000,1987
1890,100623,1,3,1890,0,550000,1978
1260,9638,2,0,1260,0,490000,1920
1160,3838,2,0,1160,0,299000,1983
1300,39639,1,0,1300,0,295000,1960
3220,14463,2,0,3220,0,630000,1978
2020,8474,1,0,1010,1010,320000,1962
2990,8640,1,0,2100,890,1.11E+06,1959
1420,6458,1,0,1420,0,398000,1953
1020,7874,1,0,1020,0,218000,1956
2400,104108,2,0,2400,0,590000,1988
3640,8239,2,3,2540,1100,1.60E+06,1982
1550,1824,2,0,1550,0,348500,2007
1870,4751,1,0,1870,0,592500,2006
2340,5957,2,0,2340,0,505000,1995
3350,3600,2,0,2260,1090,1.43E+06,2014
1710,5000,1,0,1140,570,502000,1921
1180,9265,1,0,1180,0,257500,1940
1600,7500,1,0,1600,0,405000,1966
1300,5111,1,0,1300,0,427000,1959
1040,9997,1,0,1040,0,290000,1955
1220,7695,1,0,1220,0,222000,1954
2240,6097,2,0,2240,0,315000,2002
1420,4500,1,0,1420,0,371000,1959
1580,6620,1,0,1580,0,279900,1988
2390,23522,1,0,1890,500,250000,1938
2260,29930,2,0,1400,860,599000,1977
1890,93218,1,0,1890,0,267300,1964
1830,7200,1,2,1070,760,585000,1949
1000,8268,1,0,1000,0,350000,1969
2180,7700,1,0,1480,700,506000,1961
2320,210830,2,0,2320,0,400000,1962
840,4495,1,0,840,0,151100,1921
840,4495,1,0,840,0,251000,1921
2350,8140,1,0,1430,920,555000,1977
2040,273556,1,0,2040,0,467500,1997
2370,30378,2,0,2370,0,479000,1996
1590,9350,1,0,1060,530,247000,1962
1380,10875,1,0,1380,0,299500,1977
1940,8970,1.5,0,1270,670,306888,1980
3320,244807,2,0,3320,0,675000,2001
1090,5265,1.5,0,1090,0,577000,1947
1650,9936,1,0,1090,560,219950,1967
1110,5500,1,0,1110,0,375000,1940
2110,6820,1,0,1530,580,650000,1942
1850,5000,1.5,0,1850,0,975000,1900
600,3720,1,0,600,0,229000,1920
2760,4000,1.5,0,1730,1030,575000,1926
2970,14880,1,4,1560,1410,815000,1962
2300,43560,1,0,1350,950,525000,1979
2030,2805,2,0,1720,310,471000,2001
2160,4333,1,0,1260,900,450000,1942
1650,6150,2,0,1650,0,590000,1926
3140,7260,2,0,2200,940,744000,2004
2690,36114,2,0,2690,0,460000,1986
1940,9389,1,0,1290,650,299000,1960
1220,5120,1.5,0,1220,0,231000,1940
1300,9600,1,0,1300,0,195000,1975
1660,11500,1,0,1130,530,305000,1979
3390,6200,2,0,2530,860,895000,1916
2310,13300,1,0,1890,420,1.11E+06,1950
950,7954,1,0,950,0,339000,1941
2400,3520,1,0,1370,1030,885000,1924
1780,5236,1.5,0,1050,730,375000,1944
1280,7400,1,0,1280,0,367400,1958
1930,5398,1,0,1430,500,700000,1953
2560,10360,1,0,1870,690,667000,1966
920,5250,1,0,920,0,200000,1906
1900,18414,2,0,1900,0,552775,1971
2270,148975,1,0,1270,1000,452000,1900
2080,16050,1,0,1360,720,418000,1978
1460,10128,1,0,1460,0,601500,1968
1670,39639,1,0,1670,0,600000,1976
2810,6481,2,0,2810,0,340000,1998
2370,6752,2,0,2370,0,310000,1994
1700,18000,1,0,1700,0,290000,1972
1630,9255,1,0,1630,0,438000,1941
2930,4408,1,0,1660,1270,718000,1939
860,6600,1,0,860,0,200000,1949
1980,12150,1,0,1980,0,479900,1994
2080,7877,2,0,2080,0,400000,1987
1060,10042,1,0,1060,0,219950,1957
1590,3381,2,0,1590,0,300000,2000
1980,8775,1,0,1290,690,437000,1959
1720,7210,1,0,860,860,350000,1971
1350,9293,1,0,1350,0,626000,1954
2080,12032,2,0,2080,0,490000,1978
2090,4700,2,0,2090,0,289000,2002
2030,5100,2,0,2030,0,595000,2008
2680,41804,1,0,2680,0,676000,1989
1820,8028,1,0,1220,600,389000,1980
1300,5000,1,0,1300,0,240000,1983
2210,7079,2,0,2210,0,382500,1993
1400,7293,1,0,1400,0,511555,1963
2040,4125,1.5,0,1540,500,710500,1917
2420,49928,2,0,1860,560,429000,1985
1920,7500,1,0,1920,0,170000,1962
3860,17820,1,4,2630,1230,2.14E+06,1975
2760,7200,1,0,1430,1330,480000,1979
3450,8395,2,4,2640,810,1.67E+06,1993
1040,6535,1,0,1040,0,225000,1947
2220,7224,1,2,2040,180,615000,1975
2470,385506,2,3,2470,0,438950,1991
1300,9856,1,0,1300,0,242000,1962
1960,9686,1,0,1460,500,560000,1989
2040,3960,2,2,2040,0,857500,1928
3030,7864,2,0,3030,0,685000,1999
2260,7336,2,0,2260,0,486000,1977
2670,10338,2,0,2670,0,749000,1987
1520,6298,2,0,1520,0,260000,1986
3610,8502,1.5,2,2610,1000,1.02E+06,1930
1130,5111,1,0,930,200,565000,1942
1480,2502,2,0,1480,0,355000,1991
3540,9970,2,3,3540,0,775000,1970
2100,7305,1,0,1050,1050,335000,1963
3366,7800,2.5,2,2966,400,1.30E+06,1937
1810,3000,1.5,0,1810,0,545000,1903
1680,4240,1.5,0,1680,0,540000,1926
2450,9377,1,2,1540,910,687500,1962
1150,9812,1,0,1150,0,115000,1962
1150,9812,1,0,1150,0,227000,1962
3240,7621,2,2,3240,0,870000,2003
3480,12164,1.5,0,3480,0,1.19E+06,1984
2800,5000,2,0,2800,0,375000,2006
3240,7200,1,2,1620,1620,902000,1960
1480,7276,1,0,940,540,269500,1978
1700,4750,1.5,0,1200,500,570000,1909
1240,7590,1,0,1040,200,359950,1939
3720,8301,2,0,2880,840,1.45E+06,2008
1910,3427,2,0,1910,0,615000,2001
2120,8701,1.5,0,2120,0,250000,1960
3020,6788,2,0,3020,0,530000,2002
2250,222156,1,0,2250,0,474950,1987
1650,6480,2,0,1650,0,490000,1947
880,1157,2,0,880,0,210000,2007
1860,9225,1,0,1860,0,265500,1957
3840,4800,3,3,2750,1090,1.46E+06,2008
2192,12128,2,0,2192,0,310000,2006
1590,4108,2,0,1590,0,324500,2003
3700,11000,1,0,1840,1860,599000,1962
3670,9958,2,0,3670,0,525000,2005
1630,10304,1,0,1630,0,400000,1953
4230,54977,2,3,3780,450,887500,1951
1060,3325,1.5,0,770,290,344000,1932
2700,7434,2,0,2700,0,525000,1991
2110,8000,2,0,2110,0,385000,1975
3720,8633,2,0,3720,0,820000,1999
3440,5000,2,0,2560,880,1.31E+06,2006
2420,59800,1,0,1350,1070,549000,1985
1090,6771,1.5,0,1090,0,180000,1929
2910,5776,2,2,2910,0,589000,1998
1050,5518,1,0,1050,0,350000,1948
1610,7575,1,0,1110,500,197400,1965
1760,6477,2,0,1760,0,267000,1986
1540,20281,1,0,1540,0,480000,1977
2580,9450,1,0,1660,920,650000,1959
1370,5000,1.5,0,1370,0,600000,1905
1440,6265,1,0,1440,0,490000,2005
1410,7700,1,0,980,430,225000,1962
1980,10115,1,0,1980,0,640000,1959
2440,3427,2,0,1990,450,710000,2000
1350,11805,1,0,1350,0,325000,1986
3130,28001,1,0,2210,920,595000,1985
880,7004,1,0,880,0,128750,1950
1920,7300,1,0,1240,680,465000,1961
2700,7625,1,0,1450,1250,710000,1937
1670,6000,1,0,840,830,605000,1917
3470,20445,2,0,3470,0,994000,1963
1820,7326,2,0,1820,0,489950,1983
1310,8160,1,0,1310,0,365000,1950
1790,7212,1,0,1790,0,359950,1998
2460,4774,2,0,2460,0,495000,2006
1060,9039,1,0,1060,0,255000,1973
1340,10276,1,0,1340,0,330000,1961
1480,8394,1,0,1480,0,450000,1971
3500,11306,2,2,3500,0,655000,2005
2910,16362,1,2,2120,790,485000,1969
1940,15909,1,0,970,970,375000,1974
2280,4534,2,0,2280,0,570000,2003
1190,1022,3,0,1190,0,350000,1998
1260,6000,1,3,1260,0,550000,1951
2270,8652,1,0,1150,1120,513000,1965
1990,7320,1,0,1030,960,450000,1965
1500,1856,1,0,750,750,432500,1901
2060,329903,1.5,3,2060,0,432000,1989
1950,8892,2,0,1950,0,480000,1983
1790,6980,1,0,1330,460,402200,1980
1520,10227,1,0,1520,0,650000,1951
3240,13044,2,0,3240,0,1.20E+06,1984
2440,13250,1,0,1440,1000,312000,1977
2220,5821,1.5,0,1380,840,610000,1916
2640,7722,1.5,0,1650,990,823000,1915
1450,3750,1,0,950,500,471000,1925
1550,5511,2,0,1550,0,481015,1987
6200,23373,3,1,5050,1150,1.96E+06,1988
2810,11250,1,0,1680,1130,624000,1980
2080,7966,1,0,1200,880,480000,1970
1370,8671,1,0,1370,0,815000,1955
2920,20400,1,0,2920,0,1.65E+06,1966
1000,18513,1,0,1000,0,180000,1940
1210,9750,1,0,1210,0,156601,1984
2790,4650,2,0,2790,0,374950,2004
1660,4680,1,0,830,830,368000,1908
1650,3952,2,0,1650,0,550000,1950
1300,6318,1,0,1300,0,198000,1980
1090,7200,1,0,1090,0,345000,1968
2660,6572,1,0,1960,700,1.71E+06,1959
940,10890,1,0,940,0,185900,1909
2750,18029,1,2,1810,940,950000,1978
3850,13551,2,2,3000,850,995000,1998
860,8250,1,0,860,0,345000,1940
2070,10125,1,0,1390,680,741000,1962
2290,9772,1,0,2290,0,737000,2007
2340,6420,1,2,1590,750,668750,1964
2680,8625,1,0,1590,1090,575000,1974
1710,5440,1,0,1030,680,280000,1976
1800,10050,1,0,1800,0,583000,1955
1510,9600,1,0,1090,420,196000,1966
1700,7496,2,0,1700,0,349950,1994
1350,3333,1.5,0,1350,0,429000,1912
2140,10320,1,0,1330,810,270000,1967
2700,7416,1,0,1350,1350,385000,1969
920,5000,1,3,920,0,535000,1906
1500,10269,1,0,1030,470,352500,1958
1510,5200,1,0,860,650,624000,1922
1980,7958,1.5,0,1980,0,215000,1962
4500,21780,2,2,3040,1460,870000,1980
3220,8256,2,0,2610,610,440000,2006
1140,1149,2,0,940,200,518000,2001
1490,7589,2,0,1490,0,259500,1993
4360,91158,1,0,3360,1000,795127,1993
960,9000,1,0,960,0,290000,1955
2253,7700,2,0,2253,0,385000,1957
770,6542,1,0,770,0,259950,1948
1310,2915,2,0,1310,0,330000,1999
980,7480,1,0,830,150,280000,1948
1820,20011,2,0,1820,0,595000,1987
3980,7828,2,0,3980,0,925900,2001
3010,9600,2,0,2410,600,499000,1978
1830,7762,2,0,1830,0,325000,1993
2550,20875,1,0,1610,940,895000,1953
800,8960,1,0,800,0,162248,1944
2890,21480,2,4,1790,1100,1.07E+06,1941
1810,5080,1,0,1030,780,430000,1958
1810,5080,1,0,1030,780,615500,1958
940,5650,1,0,940,0,260000,1949
1810,42981,1,0,1810,0,295000,1973
2550,6117,2,0,1650,900,1.19E+06,1951
2370,2971,2,2,2080,290,749950,2008
1370,5080,1.5,0,1120,250,175000,1931
1370,5080,1.5,0,1120,250,415000,1931
1200,8316,1,0,1200,0,190000,1953
2100,3264,1.5,0,1350,750,625000,1912
2020,21010,2,0,2020,0,420000,1995
1570,9210,1,2,1400,170,339900,1965
1140,23030,1,0,1140,0,160000,1980
1830,5331,2,0,1830,0,353000,2002
1010,14183,1,0,1010,0,390000,1982
1770,9858,1,2,1770,0,675000,1971
2120,3757,2,0,2120,0,400000,2006
3190,5040,2,3,2160,1030,1.34E+06,2003
2780,11904,1,1,1730,1050,1.65E+06,1951
3350,9450,2,0,2180,1170,1.00E+06,1912
3450,28324,1,0,2350,1100,850000,1972
1060,6954,1,0,1060,0,275000,1983
1670,2589,2,0,1670,0,450000,2000
2251,12731,1,1,1390,861,305000,1957
1770,3744,1.5,0,1270,500,643002,1929
1510,4500,1,0,1510,0,468000,1978
1770,5000,2,0,1770,0,324950,2004
1260,7346,1,0,1260,0,290000,1987
1710,10959,1,0,1030,680,488500,1981
2290,8234,1,0,1250,1040,367950,1950
790,6555,1,0,790,0,285000,1956
1820,52889,2,0,1820,0,417000,1991
3180,31931,1,0,2390,790,1.12E+06,1978
5280,17677,2,3,3220,2060,1.55E+06,1978
3240,33151,2,2,3240,0,604000,1995
2390,8102,2,0,2390,0,380000,1986
2500,5264,2,0,2500,0,336500,2003
2290,6000,1.5,3,2290,0,685000,1900
7440,21540,2,0,5550,1890,4.21E+06,2003
1600,16868,1,1,990,610,670000,1946
1120,2000,1.5,0,1120,0,524000,1910
1340,10260,1,0,1340,0,172000,1968
1670,3000,1,0,900,770,680000,1911
2830,213879,2,0,2830,0,549900,1987
2700,49428,1,0,2700,0,357000,1988
910,5120,1,0,910,0,107000,1973
910,5120,1,0,910,0,232900,1973
2370,3302,2,0,1610,760,800000,1926
880,1498,2,0,880,0,248500,1999
2050,6420,1,3,1730,320,670000,1956
1180,21275,1,0,1180,0,207000,1958
1070,8250,1,0,1070,0,164000,1961
1380,1800,2,0,1080,300,570500,1954
2680,9162,1,0,1570,1110,599990,1978
2100,9599,1,0,1060,1040,395000,1961
4133,361548,2,0,4133,0,979500,2000
920,5546,1,0,920,0,207000,1928
920,5546,1,0,920,0,237000,1928
1750,60872,1,0,1180,570,650100,1973
1950,7350,1,0,1150,800,385000,1963
1660,11437,2,0,1660,0,335000,1958
2670,10026,2,0,2670,0,347000,1996
980,8000,1,0,980,0,204000,1954
1780,10260,2,0,1780,0,615000,1971
2370,10890,2,0,2370,0,943500,1980
1640,7333,1,0,1020,620,560000,1941
2610,7254,1,0,1610,1000,547500,1975
2030,7210,1,0,1450,580,359500,1968
2590,35640,1,0,2590,0,660000,1987
1620,7540,1,0,1310,310,258000,1988
2040,22693,1,0,2040,0,355000,1980
810,4800,1,0,810,0,253500,1948
1270,8920,1,0,1270,0,422500,1969
1470,2052,1.5,0,1470,0,239000,1986
1720,8521,1,0,1140,580,628000,1984
1320,1957,1,0,660,660,352000,2004
1358,1196,3,0,1358,0,311600,2007
2070,7245,1,0,1060,1010,235000,1964
2910,9525,2,0,2910,0,870000,1968
1370,7904,1,0,900,470,190848,1970
2340,5080,1,0,1170,1170,570000,1924
2290,6250,1.5,0,1690,600,661254,1940
1650,5000,1,0,1650,0,575000,1955
650,5360,1,0,650,0,230000,1931
2300,9914,2,0,2300,0,680000,1980
620,8261,1,0,620,0,148000,1939
620,8261,1,0,620,0,244900,1939
1400,6600,1,0,1280,120,214950,1954
1800,6250,1,0,1420,380,580000,1947
1300,7885,1,0,1300,0,263000,1968
2360,11375,1,0,1180,1180,317000,1962
3320,13500,1,0,1750,1570,302000,1963
1480,6978,2,0,1480,0,899000,1949
2190,11394,1,0,1550,640,1.29E+06,1956
3740,136915,2.5,0,3100,640,710000,1990
1360,9310,1,0,1020,340,230000,1980
1210,5200,1,0,1210,0,430000,1941
4610,13252,2,4,4610,0,1.17E+06,2004
860,6380,1.5,0,860,0,397000,1927
2250,8300,2,0,2250,0,595000,2003
2030,10089,1,0,1330,700,485000,1976
3260,24300,1.5,1,2310,950,755000,1950
1840,8100,1,0,920,920,185000,1953
1840,8100,1,0,920,920,340000,1953
2000,5827,2,0,2000,0,236000,1997
2810,7549,2,0,2810,0,550000,1992
1780,5720,1,0,980,800,680000,1925
2540,8706,2,0,2540,0,630000,1997
2340,3477,1,1,1170,1170,560000,1971
1480,6600,1,2,740,740,385000,1943
1358,1141,3,0,1358,0,280000,2007
1750,7490,1,0,1180,570,225000,1979
1830,29110,2,0,1230,600,610000,1990
1170,6750,1,0,800,370,592500,1947
3170,7634,2,0,3170,0,750000,1992
1530,4875,2,0,1530,0,164000,1977
1100,8281,1,0,1100,0,320000,1947
2030,3974,2,0,2030,0,544000,1994
1870,7500,1,0,1320,550,344950,1978
3080,12476,2,0,3080,0,539500,1990
2480,60548,1,0,1600,880,420000,1968
910,22725,1,0,910,0,305000,1926
810,5100,1,0,810,0,229000,1955
3990,9938,2,0,3990,0,1.07E+06,2001
1430,1383,3,0,1430,0,397500,2005
2190,8402,2,0,2190,0,540000,1928
2290,10186,2,0,2290,0,650000,1985
3020,13237,2,4,2840,180,1.90E+06,1942
2260,280962,2,2,1890,370,649000,2005
2020,67953,1.5,0,1620,400,287500,1936
2620,4743,1,2,1310,1310,815000,1949
2830,8630,2,0,2830,0,795000,2001
1700,9840,1,0,1200,500,502775,1976
1110,6411,1,0,1110,0,222900,1944
2150,64694,1,0,1450,700,399950,1969
2650,13684,2,0,2650,0,728000,1994
3870,65556,2,0,3870,0,850000,1994
2530,17856,2,0,2530,0,525000,1998
1450,7850,1.5,0,1450,0,257000,1910
2200,3360,2,0,2200,0,433500,2009
1890,9623,1,0,1290,600,314950,1969
1530,14633,1,0,1100,430,500000,1977
1590,8911,1,0,1590,0,300000,1956
2690,18653,2,0,2690,0,645000,1985
990,10125,1,0,990,0,222500,1972
1300,8099,1,0,1080,220,275000,1976
1720,6570,1.5,0,1720,0,498000,1909
2080,75794,1,0,2080,0,800000,1958
1840,8234,2,0,1840,0,297000,1994
4010,6000,2,3,2560,1450,625000,1997
3560,6187,2,0,3560,0,770000,2003
1640,4635,1.5,0,1540,100,517000,1930
530,6350,1,0,530,0,238000,1941
1990,15375,1,0,1140,850,234550,1946
1690,7245,1,1,1160,530,230500,1973
2670,16777,1.5,0,1620,1050,585000,1920
1930,3876,1.5,0,1450,480,733000,1924
810,3880,1,0,810,0,357950,1952
1550,3680,1,0,1050,500,530000,1927
2640,10720,2,0,2640,0,377500,1999
2320,10046,2,0,2320,0,475000,2006
2170,73616,1,0,2170,0,399000,2008
2080,5750,1,0,1040,1040,660000,1926
2070,10488,1,0,1080,990,400000,1958
800,4850,1,0,800,0,440000,1944
2040,14383,1,0,1270,770,366400,1977
2830,10677,2,0,2830,0,627250,1993
1480,7560,1,0,1100,380,375950,1920
1810,6750,1,0,1280,530,162000,1978
1970,2600,2.5,0,1970,0,780000,1924
2650,4316,1.5,0,1520,1130,705000,1905
2820,15233,1,2,1820,1000,450000,1972
1400,7880,1,0,1000,400,311000,1981
1580,6065,2,0,1580,0,485000,1985
1800,11034,2,0,1800,0,485000,1987
3360,6000,2,0,2640,720,725000,1963
1510,17040,1,0,1510,0,185000,1975
4285,9345,2,0,4285,0,1.89E+06,2013
1610,7423,2,0,1610,0,260000,1990
2470,5074,2,0,2470,0,356000,2004
1200,7220,1,0,1200,0,225205,1977
1260,8910,1,0,1260,0,445000,1949
920,4095,1,0,920,0,356000,1914
2540,8250,1,0,1440,1100,760250,1953
1870,5143,1,0,1870,0,572000,2005
3060,9950,1.5,2,1810,1250,970000,1930
1950,8628,2,0,1950,0,348450,1994
1730,40250,2,0,1730,0,535500,1983
2570,9600,1,2,1620,950,710000,1956
1490,9800,1,0,1140,350,745000,1947
2040,8265,2,0,2040,0,355000,1996
2690,5505,2,0,2690,0,333000,2004
1610,6000,2,0,1610,0,282000,1993
2520,5400,1.5,0,1410,1110,840500,1906
1550,8134,1,0,1550,0,432000,1959
1800,4800,1,2,900,900,625000,1927
1170,6134,1,0,1170,0,209977,1948
900,13531,1,0,900,0,174000,1979
2800,8540,1,0,1730,1070,740000,1977
1830,4500,1.5,0,1830,0,518000,1909
1380,3225,1,0,940,440,539000,1915
1990,9600,1,0,1530,460,575000,1978
1170,976,2,0,780,390,530000,2010
1400,54014,1.5,0,1400,0,242025,1935
2620,11200,1,0,1770,850,1.03E+06,1962
880,7500,1,0,880,0,230000,1978
2260,7500,1,0,1460,800,350000,1965
1300,11520,1,0,1300,0,595000,1958
1450,6829,1,0,1450,0,440000,1983
1110,6000,1,0,1110,0,550000,1904
1890,5940,1,1,1470,420,940000,1963
1100,1751,2,0,940,160,375000,2007
1350,4592,1,0,1070,280,567500,1939
3020,50800,1,0,1510,1510,735000,1968
730,5200,1,0,730,0,114000,1928
1390,3600,1,0,1010,380,608000,1913
2710,47419,1.5,0,2170,540,442500,1980
1530,5250,1,0,1110,420,381800,1981
2170,3978,1,0,1340,830,330000,1919
790,2640,1,0,790,0,90000,1973
1160,8625,1,0,1160,0,312000,1941
1080,8100,1,0,1080,0,339000,1955
2190,8000,1,0,2190,0,313000,1967
2030,6500,2,0,2030,0,618080,1988
2480,8755,2,0,2480,0,325000,1979
2240,7620,1,0,1120,1120,242000,1966
1650,7311,1,0,860,790,364000,1978
1700,5750,1.5,2,1450,250,545000,1925
2790,16173,2,0,2790,0,445000,1988
3010,10830,2,3,3010,0,1.09E+06,1980
2550,10000,1,0,1290,1260,660000,1964
2880,35610,1,0,2880,0,845000,1989
2090,4000,1,0,1060,1030,417000,1907
740,5200,1,0,740,0,213800,1952
960,6200,1,0,960,0,400000,1946
2100,7560,2,0,2100,0,759950,2005
2540,5930,2,0,2540,0,990000,2003
1650,10250,1,0,1650,0,710000,1963
770,4600,1,0,770,0,315000,1910
2280,14810,1,0,1500,780,515000,1977
1660,3729,1,0,970,690,638000,1922
2020,8100,1.5,0,1160,860,370000,1946
970,14850,1,0,970,0,184000,1968
2480,6600,2,0,2480,0,583800,2002
1250,7320,1,0,1250,0,309500,1968
4430,31353,2,0,4430,0,1.96E+06,1998
740,5000,1,0,740,0,299000,1923
710,7200,1,0,710,0,215000,1943
1970,10500,1,0,1820,150,410000,1961
820,6000,1,0,820,0,478000,1939
1000,6500,1,0,1000,0,431000,1918
3080,35430,2,0,3080,0,635000,1997
2410,12000,2,0,2410,0,648000,1973
2370,11172,2,0,2370,0,640000,1993
4690,6705,2,0,3450,1240,932808,1995
2280,6815,1,0,2280,0,835000,2002
1530,7020,1,0,1030,500,469775,1942
3610,52595,2,0,3610,0,587000,1989
1740,3600,1,0,990,750,677915,1923
3600,9200,1,4,2100,1500,1.08E+06,1976
3130,5700,1.5,0,1750,1380,671000,1953
3940,9780,2,0,3940,0,695000,2007
2200,13320,1,0,1100,1100,205000,1944
1510,7200,1.5,0,1510,0,350000,1955
1560,7930,2,0,1560,0,360000,1980
1870,4198,2,0,1870,0,313999,2008
2070,7225,1,0,1690,380,300000,1979
1660,11747,1,0,830,830,452000,1981
2010,57934,1,0,2010,0,495500,1978
1410,40500,1,0,1410,0,288000,1961
1820,7194,1,0,1820,0,227490,1967
2560,16420,2,0,2560,0,470950,1989
2450,4187,2,2,2450,0,735000,2010
3110,4400,1.5,0,2010,1100,730000,1914
2210,7000,2,0,2210,0,412000,1985
2630,6326,2,0,2630,0,589500,2008
2350,8636,1,0,1550,800,291000,1962
4450,7680,2,0,3460,990,1.30E+06,2010
1200,10458,1,0,1200,0,190000,1961
1210,7733,1,0,1210,0,456200,1904
1290,8470,1,0,970,320,225000,1966
3490,21064,1,4,2290,1200,2.00E+06,1968
3360,15091,2,0,3360,0,740000,1997
2660,5511,1,0,1330,1330,467000,1948
770,7554,1,0,770,0,385000,1946
1800,4763,2,0,1240,560,670000,1985
2900,5760,1,0,1660,1240,500000,1959
1430,6000,1,0,1430,0,352450,1945
2550,7591,2,0,2550,0,669888,1989
1310,7300,1,0,1310,0,405000,1957
1430,8000,1,0,1430,0,518000,1956
1880,6288,1,0,1120,760,280000,1974
1600,2375,2,0,1600,0,435000,2005
1760,9732,1,0,1760,0,314950,1996
1180,3003,2,0,1180,0,209900,2005
2330,31705,2,0,2330,0,630000,1980
1960,12688,1.5,0,1960,0,442000,1962
1140,13440,1,0,1140,0,340000,1944
1400,6956,1,0,1400,0,230000,1957
2710,22120,1,0,1410,1300,495200,1955
3510,6745,2,0,3510,0,900000,1998
910,4600,1,0,910,0,265000,1917
2090,65558,1,0,1330,760,489500,1977
1410,44866,1,0,1410,0,335000,1985
3050,12700,2,0,2240,810,585000,1990
2010,7200,1,1,1010,1000,800000,1950
2120,53578,2,2,2120,0,379500,1985
1270,8000,1,0,1270,0,475000,1959
1670,8800,1,0,1150,520,520000,1961
1800,4338,2,0,1800,0,515000,2001
1640,5515,1,0,940,700,577500,1926
1740,9672,1,0,1110,630,269900,1963
1600,5952,1,0,1150,450,329000,1964
1280,1920,1.5,0,1280,0,458500,1905
1480,11171,1.5,0,1480,0,890000,1947
1980,7334,2,0,1980,0,361500,2003
3730,10626,1,4,3730,0,2.54E+06,1963
900,8374,1,0,900,0,325000,1984
3480,6000,3,0,3480,0,1.85E+06,2014
2840,13367,1,0,1420,1420,945000,1952
2490,4244,2,0,2490,0,370000,2005
1490,7111,2,0,1490,0,320000,1999
1510,4908,1,0,1510,0,450000,2006
2900,18303,2,0,2900,0,800000,1994
2240,3825,2,0,2240,0,676000,1995
2040,5000,2,0,2040,0,1.27E+06,1921
1460,7980,1,0,1460,0,290000,1972
990,8925,1,0,990,0,158000,1962
1970,9389,1,0,1140,830,379950,1960
2660,4000,2,0,2660,0,583000,2001
870,5700,1,0,870,0,150000,1957
1740,6992,2,0,1740,0,261500,1990
2290,3777,2,0,2290,0,278000,2004
2170,7140,1,0,1290,880,555000,1977
2040,8173,1,0,1470,570,355000,1958
1770,6650,1,0,1770,0,375000,1958
2380,12681,1,0,1380,1000,227000,1918
2030,103672,1,0,2030,0,335000,1969
2270,23900,1,0,1820,450,680000,1975
1390,5025,1.5,0,1390,0,686500,1928
1530,26642,1,0,1180,350,410000,1988
1430,13300,1.5,0,1230,200,425000,1921
2030,7549,1,0,2030,0,562500,1988
2390,6976,2,0,2390,0,345000,2003
2540,11500,1,0,1640,900,627500,1979
1890,36300,1,0,1890,0,355000,1962
1870,5876,2,0,1870,0,335000,1986
1780,4228,1,0,1780,0,350000,1953
1610,58370,1,0,1610,0,590000,1978
1420,6788,2,0,1420,0,252000,1990
4440,9270,1,0,2220,2220,1.30E+06,1968
1820,5001,2,0,1820,0,705000,1947
1620,8400,1,0,1180,440,498000,1968
870,7227,1,0,870,0,312500,1948
1830,5375,1,0,1060,770,260000,1962
2290,9600,1,0,2290,0,209950,1967
1110,10402,1,0,1110,0,610000,1967
1440,7100,1.5,0,1440,0,500000,1906
3070,7050,1,3,1570,1500,850000,1928
2440,11700,1,0,1480,960,689000,1961
2410,4680,2,0,2410,0,470000,1974
2270,5175,2,0,2130,140,640000,2002
2340,7200,1,0,1590,750,290000,1960
1800,9000,2,0,1800,0,258500,1983
2210,7597,1,0,1550,660,1.10E+06,1977
1820,22320,1,0,1250,570,420000,1977
1190,9083,1,0,1190,0,230000,1955
1400,6865,1,0,1400,0,252000,1986
2600,4506,2,0,2600,0,515000,2003
910,4635,1,0,910,0,425000,1905
1760,2320,2,2,1760,0,575000,1994
860,5160,1,0,860,0,390000,1909
2310,9800,1,0,1780,530,561500,1968
2000,3728,1.5,0,1820,180,1.35E+06,1926
2460,7830,1,0,1490,970,835000,1955
1020,15000,1.5,0,1020,0,245000,1933
1670,3980,2,0,1670,0,475200,2000
790,5024,1,0,790,0,425000,1941
2010,7755,2,0,2010,0,218000,1952
2600,6536,2,0,2600,0,600000,1999
1890,7210,1,0,1890,0,545000,1967
4600,23250,1.5,2,3600,1000,2.41E+06,1918
2008,5050,1,0,1216,792,460000,1992
880,6413,1,0,880,0,425000,1950
1700,8360,1,0,850,850,455000,1955
1730,12821,1,0,1730,0,313100,1994
3910,59863,2,0,2490,1420,780000,1987
2160,9682,2,0,2160,0,345500,1999
1200,8034,1,0,1200,0,243000,1975
3860,9600,1,3,2660,1200,670000,1973
1320,7560,1,0,840,480,325000,1983
1280,12500,1,0,1060,220,281000,1951
1100,5100,1,0,1100,0,130000,1913
2170,9798,2,0,2170,0,340000,1995
2720,51396,2,0,2720,0,485000,1977
2520,6398,2,0,2520,0,642860,2014
2560,4800,1,0,1280,1280,747000,1911
2650,7200,2,0,2250,400,559950,1979
2870,7200,2,0,2870,0,577288,2008
1230,2726,1.5,0,880,350,575000,1920
1450,6000,1,0,1450,0,287000,1953
3180,9889,2,0,2500,680,1.15E+06,2012
1800,8900,1,0,900,900,335000,1945
2020,12500,2,0,2020,0,375000,1966
620,14823,1,0,620,0,325000,1926
2190,220414,1,0,1330,860,530000,1976
1980,7081,1,0,1470,510,287000,1977
2970,7000,1,0,1810,1160,320000,1979
2270,4400,2,0,2270,0,425000,2006
1630,6009,1,3,1630,0,550000,1954
1520,8450,1,0,1120,400,135000,1961
2080,5687,1.5,0,2080,0,695000,1924
3020,9648,1,2,1980,1040,975000,1977
2180,28710,1,0,1180,1000,210000,1950
1780,8768,1,0,1050,730,518000,1951
1370,6780,2,0,1370,0,335500,1930
3050,7020,2,3,2050,1000,750000,1984
1490,12000,1,0,1490,0,515000,1956
1800,5453,1,0,1050,750,344500,2002
1760,6723,1,0,1160,600,470000,1958
1770,9848,1,0,1370,400,606150,1967
2910,7712,1,0,1600,1310,292000,1998
2880,426452,2,3,2880,0,450000,1979
2520,5043,1,0,1260,1260,429000,1957
3190,38119,2,0,3190,0,765000,1988
540,2500,1,0,540,0,425000,1905
3170,5340,2,0,3170,0,505000,2000
1830,7371,1,0,1830,0,544950,1957
1360,4840,1.5,0,1360,0,382000,1936
1870,25157,2,0,1870,0,475000,1978
1370,4790,2,0,1370,0,355000,1982
1700,9000,1,0,1700,0,410000,1972
1960,5008,1,0,980,980,450000,1900
4140,9066,1,0,2070,2070,565000,1978
1290,6528,1.5,0,1290,0,529100,1941
2460,6454,2,0,2460,0,452500,2006
1580,8000,1,0,1040,540,245000,1967
700,2550,1,0,700,0,415000,1954
2410,15899,2,3,2410,0,610000,1990
2180,9702,1,0,1090,1090,363500,1962
1950,12630,1,0,1230,720,510000,1969
2630,28298,2,0,2630,0,650000,1996
2050,9015,2,0,2050,0,290000,1973
790,6750,1,0,790,0,170000,1944
1070,5280,1,0,1070,0,510000,1900
13540,307752,3,4,9410,4130,2.28E+06,1999
2320,7379,2,0,2320,0,316000,1987
2670,13463,2,0,2670,0,690000,1989
700,5200,1,0,700,0,199950,1952
860,7740,1,0,860,0,207000,1960
3490,8400,1.5,0,3490,0,449950,1976
1160,257875,1,0,1160,0,361550,1980
3650,57538,2,0,3650,0,824000,1996
1550,10050,1,0,1550,0,537000,1957
2620,9525,2.5,0,2620,0,838400,1974
720,4758,1,0,720,0,225000,1947
1380,5198,1,0,1380,0,329900,1982
1170,34925,1,0,1170,0,282500,1942
1170,11960,1,0,1170,0,229950,1969
1630,12059,1,0,1270,360,500000,1947
1890,6557,1,0,1890,0,495000,1967
1010,9450,1,0,1010,0,149500,1959
2040,10033,1,0,1420,620,726000,1974
4080,10295,2,0,4080,0,899000,1998
1270,8925,1,0,1270,0,317000,1955
790,3000,1,0,790,0,395000,1953
2580,6740,2,0,2580,0,360000,1999
2290,6738,2,0,2290,0,570000,1996
3490,5000,2,0,3490,0,320000,2003
1510,30185,1.5,0,1510,0,320000,1976
2400,4564,2,0,2400,0,268000,2004
900,3400,1,0,900,0,191000,1905
1270,7440,1,0,910,360,400000,1949
1050,5000,1,0,1050,0,515000,1907
2950,9010,2,0,2950,0,610000,2004
1850,3060,1,0,1060,790,538000,1929
1970,4036,2,0,1970,0,432000,2003
2400,8592,2,0,2400,0,335000,1978
2360,8642,1.5,0,2060,300,302000,1926
1580,9382,1,0,1080,500,787500,1963
1790,7055,1,0,1520,270,420000,1937
2840,216493,2,0,2840,0,560000,1991
1970,6634,2,0,1970,0,535000,1989
1780,6771,1,0,1230,550,310000,1990
3920,5250,1.5,0,2560,1360,760000,1910
1550,1905,2,0,1550,0,242500,2005
2980,7200,1.5,2,2980,0,1.31E+06,1911
1270,7153,1,0,1270,0,235000,1949
3040,12160,1,0,1520,1520,598780,1963
2075,16200,2,0,2075,0,433200,2002
1110,9920,1,0,700,410,343000,1942
800,8125,1,0,800,0,145000,1964
680,21727,1,0,680,0,291970,1952
1680,7910,1,0,1680,0,599950,1949
3910,22710,1.5,0,3910,0,1.75E+06,1908
2780,11000,1,0,1560,1220,870000,1964
2000,9083,2,0,2000,0,323000,1992
3150,9703,2,0,3150,0,727000,2001
1120,17332,1,0,1120,0,166000,1988
1740,12204,1,0,1270,470,450000,1961
2970,23100,1,0,1510,1460,400000,1967
2970,23100,1,0,1510,1460,599000,1967
1150,19200,1,0,1150,0,165000,1908
1190,7408,1,0,830,360,229000,1941
900,7500,1,0,900,0,305000,1946
2950,4446,2,0,2450,500,930000,2001
1990,15985,1,0,1540,450,542000,1964
1020,9147,1,0,1020,0,214000,1900
2070,7200,2,0,2070,0,718000,2001
1430,1002,3,0,1430,0,349000,2002
2030,8000,2,0,2030,0,305000,1997
1620,2640,2,0,1620,0,498000,1900
4220,196817,2,0,4220,0,799950,1993
2300,7800,2,2,2300,0,737000,1997
3830,10005,2,0,3830,0,860000,2001
2390,34041,1,0,1840,550,339950,1984
1440,7673,1,0,940,500,249000,1982
910,5525,1,0,910,0,370000,1910
1550,12262,1,0,1550,0,725000,1964
2380,91476,1,0,1580,800,529000,1976
2060,8100,1,0,1310,750,310000,1988
1880,9163,2,0,1880,0,315000,1981
3470,4160,2,0,2480,990,1.30E+06,1927
2360,12744,2,0,2360,0,435000,1964
1970,10800,1,0,1300,670,350000,1979
1040,7800,1,0,1040,0,240000,1948
1420,3750,2,0,1420,0,410000,1987
2290,5249,2,0,2290,0,430000,2003
1530,8375,1,0,1020,510,446000,1974
1360,9760,1.5,0,1360,0,240000,1984
3680,35736,1.5,0,2320,1360,595000,1970
920,4770,1,0,920,0,215150,1969
1070,5824,1,2,1070,0,319950,1949
1590,9912,2,0,1590,0,385000,2000
1600,6700,2,0,1600,0,280000,1991
1510,7300,1,0,1040,470,399950,1974
1080,10500,1,0,1080,0,132500,1967
1330,2856,1,0,930,400,399950,1916
850,6800,1,0,850,0,290000,1948
1960,8592,1,0,1290,670,860000,1958
6980,15682,3,4,5330,1650,3.10E+06,1999
1530,7200,1.5,0,1400,130,245000,1948
1320,7980,1,0,1320,0,255000,1956
2320,7200,2,0,2320,0,310000,1976
960,8100,1,0,960,0,299000,1955
2040,5508,2,0,2040,0,575000,1996
1080,8214,1,0,1080,0,284000,1944
2020,4800,1,0,1090,930,840000,1926
1780,7567,1,0,1290,490,442573,1980
1140,7028,1,0,1140,0,560000,1931
1610,4160,1,0,1010,600,485000,1917
1440,8536,1,0,1440,0,472500,1961
4270,25807,2,0,4270,0,1.61E+06,1996
3460,4600,2,0,2860,600,808000,1987
1890,16001,1.5,0,1890,0,398000,1950
2240,6000,2,0,2240,0,340000,2003
760,4000,1.5,0,760,0,380000,1910
1020,6173,1,0,780,240,235000,1948
1330,9900,1,0,1330,0,400000,1956
2780,12335,1,0,1590,1190,582000,1968
1070,6120,1,0,1070,0,209000,1962
2660,7700,1.5,0,1670,990,335000,1962
710,7120,1,0,710,0,285950,1942
3340,52476,2,0,3340,0,645000,1975
1160,7500,1.5,0,1160,0,312000,1916
2840,59677,1,0,1580,1260,663000,1967
2000,36000,1,0,2000,0,443950,1946
1060,5750,1,0,1060,0,315000,1981
1730,10396,1,0,1730,0,302200,1964
2190,2658,2,3,2190,0,770000,1979
1660,8160,1,0,1660,0,374950,1974
2210,7557,2,0,2210,0,330000,1989
870,7020,1,0,570,300,230000,1942
3100,7250,2,0,3100,0,967000,2010
1720,3515,2,2,1470,250,536500,2000
3120,4240,2,2,2090,1030,315000,1993
1040,4240,1,0,860,180,626000,1924
1650,9305,1,0,1650,0,334009,1960
1010,5000,1,0,1010,0,429000,1924
4020,44431,2,0,4020,0,818000,1987
2166,6342,2,0,2166,0,326000,2013
1880,5000,1,0,1100,780,310000,1997
2260,7680,1,0,1130,1130,525000,1947
2010,4400,1.5,0,2010,0,350000,1986
3330,8897,2,0,3330,0,936000,2001
1520,7200,1,0,1030,490,226000,1954
3510,4798,2,0,2700,810,1.25E+06,2008
1580,507038,1,2,1580,0,428000,1985
1460,5040,1,0,1100,360,329932,1971
1460,5040,1,0,1100,360,539000,1971
1650,7700,1,0,1650,0,275000,1977
2660,35010,2,2,2660,0,590000,1993
3510,24604,2,0,3510,0,782000,1997
2120,9603,2,0,2120,0,575000,1985
1780,9315,2,0,1780,0,509000,1996
2000,13300,1,0,1200,800,290000,1968
1300,9000,1,0,1300,0,305240,1956
2180,4976,1.5,2,1680,500,555000,1930
1790,8228,1,0,1390,400,317000,1980
1910,5040,1.5,0,1910,0,430000,1971
1800,4144,1,4,900,900,850000,1962
2620,10659,1,0,1660,960,469000,1976
1440,8425,1,0,1440,0,327200,1942
2790,12523,2,4,1600,1190,835000,1977
2340,13445,2,0,2340,0,360000,1990
2070,8658,2,0,2070,0,372000,1999
2160,11484,1.5,0,2160,0,453000,1968
2090,11317,1,0,1090,1000,275000,1931
2040,7260,2,0,2040,0,475000,1963
1950,9720,1,0,1400,550,310000,1986
1200,8460,1,0,1200,0,173000,1957
2240,94960,1,0,2240,0,313500,1985
1360,1489,2,0,1360,0,345000,2007
1500,10200,1,0,1300,200,436000,1955
1300,14500,1,0,650,650,244500,1939
1140,9800,1,0,1140,0,206000,1968
2930,9158,2,0,2930,0,890000,2005
2140,8874,2,0,2140,0,329950,1986
1628,286355,1,0,1628,0,250000,1996
1990,203861,1,0,1990,0,246000,1949
1950,19747,1,0,1150,800,440000,1979
1910,8117,1,0,1460,450,395000,1975
820,5150,1,0,820,0,305000,1918
1470,8682,1,0,1160,310,160000,1985
1470,8682,1,0,1160,310,269000,1985
1060,10023,1,0,1060,0,169500,1962
3130,8920,2,0,3130,0,690500,2014
1260,9693,1,0,1260,0,245560,1957
2200,13498,2,0,2200,0,345000,1987
2580,19607,1,2,1290,1290,383000,1958
1350,944,2,0,1050,300,388500,2007
1350,8548,1,0,1350,0,250000,1985
2290,19000,1,0,1650,640,455500,1973
1220,8573,1,0,1220,0,672000,1954
2750,128502,1,0,1500,1250,550000,1958
1430,12632,1,0,1430,0,487000,1959
2220,6233,2,0,2220,0,291375,2001
1490,15850,1,0,1490,0,225000,1946
2440,10200,2,0,2440,0,519950,1974
2070,8400,2,0,2070,0,250000,1990
1500,2400,1.5,0,1500,0,614950,1900
2020,10260,2,0,2020,0,599500,1984
2190,13660,1,3,2190,0,625000,1952
780,10064,1,0,780,0,248500,1958
1220,4200,1,0,1090,130,469950,1921
1840,10956,1,0,1840,0,525000,1970
2390,6928,2,3,1810,580,787500,1949
3710,15935,1,0,2130,1580,485000,2005
750,5379,1,0,750,0,310000,1919
2110,7919,1,0,1110,1000,280000,1966
1020,42966,1.5,0,1020,0,200000,1922
3080,7363,2,0,3080,0,490000,2006
900,4770,1,0,900,0,146000,1969
3720,25474,2,4,2090,1630,500000,1986
940,7380,1,0,940,0,242500,1959
1040,7288,1,0,1040,0,324950,1959
1000,7615,1,0,1000,0,231500,1943
2080,9827,2,0,2080,0,300000,1989
2500,50595,2,0,2500,0,545000,1997
1050,8583,1,0,1050,0,350000,1955
1620,8645,1,0,1190,430,467100,1973
1610,8500,1.5,0,1610,0,180000,1959
2130,5000,2,0,2130,0,749000,1920
1460,11593,2,0,1460,0,245000,1989
1600,7350,1,0,1600,0,260000,1962
1730,2940,3,0,1730,0,490000,1985
2280,4602,2,0,2280,0,565000,2003
2430,7490,2,0,2430,0,330000,1983
1380,7575,1,0,1380,0,295000,1963
1790,6000,1.5,0,1790,0,725000,1903
3370,10602,2,0,3370,0,1.14E+06,1999
2920,6300,1,0,1710,1210,680000,1956
2180,9300,1,0,1090,1090,490000,1947
1480,6985,1.5,0,1200,280,635000,1926
2350,715690,1.5,0,2350,0,750000,1979
2440,8098,2,0,2440,0,330000,1983
1350,1189,2,0,1080,270,270000,2007
1970,3716,2,0,1970,0,340000,1997
1110,3960,1,0,1110,0,413252,1951
2950,5803,2,0,2950,0,600000,2007
2970,7261,2,0,2970,0,726888,1999
720,6400,1,0,720,0,285000,1943
770,5680,1,0,770,0,365000,1929
1650,7200,1,0,1650,0,295000,1964
1620,7350,1,0,1170,450,460000,1969
1510,10588,1.5,0,1510,0,230000,1947
1070,6109,1,0,1070,0,337000,1951
1010,6300,1,0,1010,0,300000,1957
3370,8402,1,0,2240,1130,2.30E+06,1962
2000,5500,2,0,2000,0,360000,2003
2060,10839,2,0,2060,0,585000,1987
1740,6650,1,0,1240,500,182700,1978
1740,6650,1,0,1240,500,305000,1978
1880,7838,2,0,1880,0,309950,1994
960,12527,1,0,960,0,550000,1972
3280,26413,1,3,2670,610,825000,1985
1570,4400,1.5,0,1570,0,998500,1914
2990,5342,2,0,2990,0,644500,2004
1250,8636,1,0,1250,0,320000,1968
1920,4803,2,0,1920,0,266950,2005
2470,33305,2,0,2470,0,633100,1993
960,6700,1,0,960,0,395000,1951
940,5904,1,0,940,0,259250,1947
1260,5000,1,0,1260,0,300000,1968
2280,139392,1,0,2280,0,413000,1977
1740,8491,1,0,1240,500,435000,1958
2630,15000,1,0,1690,940,500000,1976
2430,5481,1,0,1430,1000,402000,1953
2260,251460,1.5,0,2260,0,777700,1995
1220,5000,1,2,1220,0,580000,1938
2580,40392,1,0,1390,1190,570000,1986
730,6000,1,0,730,0,174950,1950
760,3001,1,0,760,0,300000,1913
1740,6988,1,0,1600,140,435000,1950
3420,8405,2,0,3420,0,840000,2000
2240,7543,1,0,1140,1100,469000,1966
1920,3600,2,0,1920,0,870000,1907
2020,7029,1,0,1430,590,532000,1979
1880,11400,1,0,1280,600,455000,1955
1010,25277,1,0,1010,0,201000,1961
3990,13087,2,0,2400,1590,649000,1991
1390,6670,1,0,720,670,445500,1941
1230,11502,1,0,1230,0,475000,1984
2940,29013,2,0,2940,0,590000,1992
2190,8296,2,0,2190,0,565000,1935
640,10280,1,0,640,0,110000,1920
1670,7740,1,0,1130,540,375000,1974
1240,8528,1,0,1240,0,255000,1967
1850,14800,1.5,0,1760,90,315000,1937
2020,8400,1,0,1350,670,496600,1961
1020,4800,1,0,1020,0,380000,1944
1610,22496,1,0,1610,0,338950,1974
2730,42500,1,0,1530,1200,542500,1989
2840,5000,1,0,1620,1220,739000,1913
1290,3060,2,0,1290,0,549000,1906
1670,7881,1,0,1190,480,252000,1977
3860,15246,2,4,2940,920,1.70E+06,2004
2460,5100,1.5,0,1450,1010,735000,1909
1660,8063,1,0,1660,0,270000,1978
3420,8700,1,0,2890,530,2.25E+06,1951
1010,43056,1.5,0,1010,0,155000,1990
2240,5624,1,0,1520,720,469000,1961
2340,5250,2,0,2340,0,305000,1965
1920,4500,1,0,960,960,675000,1924
2460,6600,1.5,0,1560,900,931000,1929
1470,11398,1,0,1470,0,385000,1950
3400,12442,2,0,3400,0,815000,2001
1910,8390,1,0,1910,0,531000,1979
1400,3600,1,0,700,700,386500,1901
1520,11085,1,0,1520,0,475580,1983
930,5077,1,0,930,0,358000,1939
2340,4730,2,0,1810,530,677500,1918
2920,3942,3,0,2920,0,868500,2008
1270,7350,1,0,1270,0,599380,1967
2450,11960,1,0,2450,0,712000,1979
1380,7620,1,0,1180,200,350000,1955
2520,6000,1,0,1400,1120,875000,1921
2290,7350,2,0,2290,0,365000,1988
1660,6150,1,0,850,810,452000,1945
2800,9750,1,0,1400,1400,915000,1957
1690,3068,2,0,1690,0,482500,2005
1180,7200,1.5,0,1180,0,425000,1949
1390,4160,1,0,790,600,460000,1916
2320,7400,1.5,0,1620,700,666570,1913
2270,32112,1,0,1740,530,390000,1980
2640,8215,1,0,1500,1140,650000,1966
1680,8487,1,0,1680,0,305000,1993
990,8100,1,0,990,0,250000,1949
2770,4432,2,0,2770,0,438800,2004
950,5650,1,0,950,0,290000,1943
2160,4800,2,0,1290,870,324950,1929
1650,1838,2,0,1270,380,453000,1991
1800,4005,1.5,0,1160,640,556000,1929
1660,11135,1,0,1660,0,315000,1971
1870,5449,2,0,1870,0,445830,2003
3220,3960,2,4,2760,460,1.26E+06,1991
1850,19966,1,0,1090,760,287200,1992
1580,6360,1.5,0,1290,290,525000,1945
4590,17621,2,0,3160,1430,1.14E+06,2003
2700,18246,1,0,1510,1190,381000,1967
1020,7020,1.5,0,1020,0,360000,1953
2950,2932,3,0,2950,0,619000,2004
1780,224769,1,0,1780,0,535000,1976
710,5100,1,0,710,0,402000,1905
4300,70407,2,0,2710,1590,600000,1992
2080,8690,1,0,1430,650,549950,1974
2360,7440,1,0,1180,1180,300000,1955
2210,9870,2,0,2210,0,360000,1969
4340,8521,2,0,2550,1790,419000,1986
1320,1012,3,0,1320,0,510000,2009
1980,9907,2,0,1980,0,319950,1991
3960,94089,2,0,3960,0,1.18E+06,1998
2130,6003,2,0,2130,0,381000,2003
1720,3951,2,0,1720,0,256900,1992
1790,30456,1,0,1350,440,346000,1964
1390,1222,3,0,1340,50,465000,2009
1900,9975,1,0,1500,400,545000,1973
1640,3090,1,0,910,730,516000,1925
2700,5100,1,0,1440,1260,550000,1968
2200,7150,2,0,2200,0,339950,1990
1310,8514,1,0,1310,0,417000,1953
2480,5000,1,3,1480,1000,906000,1951
3010,9800,2,0,3010,0,980000,1973
2450,5079,2,0,2450,0,555000,2001
1250,7029,1,0,1250,0,468000,1986
2610,117176,1,0,1390,1220,378000,1981
2010,16020,1.5,0,2010,0,430000,1962
3120,14300,2,0,3120,0,730100,2003
1370,7944,1.5,0,1370,0,219000,1961
2420,11953,1,0,2420,0,570000,1990
1500,7036,1,0,1060,440,262500,1979
2630,9216,2,0,2630,0,525000,2003
950,3880,1,0,950,0,520000,1919
2680,12285,1,0,2680,0,417400,1970
3680,5759,2,0,2840,840,788000,2003
1270,7400,1,2,1270,0,320000,1956
2330,5000,1.5,0,2330,0,950000,1920
960,8100,1,0,960,0,255000,1955
1990,6671,2,0,1990,0,260000,1989
1450,7930,1,0,1150,300,394000,1923
2280,27441,2,0,2280,0,575000,1996
1830,7200,2,2,1750,80,1.25E+06,1923
1650,7800,1,0,1260,390,385000,1969
2720,193406,1,4,1700,1020,456000,1968
1710,5000,1,0,1110,600,637000,1979
1420,9900,1,0,1050,370,485000,1964
1440,8040,1,0,960,480,315275,1951
1280,8710,1,0,1280,0,252500,1967
1320,24319,1,0,1320,0,240000,1966
2560,12760,1,0,1760,800,790000,1949
1480,7830,1,0,1480,0,310000,1952
2960,20240,2,4,2960,0,1.25E+06,1985
1160,5038,1,0,740,420,425000,1942
2110,4099,2,0,2110,0,548000,2001
1650,14054,1,0,1130,520,379880,1986
1950,9906,2,0,1950,0,530000,1988
2600,220300,1.5,0,2120,480,695000,1977
1270,4000,1.5,2,1270,0,435000,1928
1300,62290,1,0,1300,0,540000,1983
1790,10209,1,0,1290,500,425000,1967
1930,7266,2,0,1930,0,490000,2005
1200,6000,1.5,0,1200,0,220000,1923
2050,3784,2,0,2050,0,540000,2001
1710,6195,1,0,1410,300,670000,1946
2130,20423,1,0,2130,0,667500,1953
1700,2197,2,0,1260,440,585000,2010
1390,12500,1,0,1390,0,225000,1976
1230,9877,1,0,1230,0,375000,1954
1490,8847,1,0,1490,0,335000,1967
2440,15815,2,0,1990,450,680000,2014
970,4800,1,0,970,0,600000,1950
1700,8043,1,0,850,850,161000,1954
1700,8043,1,0,850,850,220000,1954
1720,5000,1.5,0,1720,0,420000,1932
1400,2250,1.5,0,1400,0,710000,1909
2570,7221,1,0,1570,1000,626000,1958
1200,8040,1,0,1200,0,279500,1959
4390,11600,2,3,3060,1330,1.61E+06,1990
1080,5000,1,0,1080,0,325000,1954
1860,7980,1,0,1860,0,380000,1966
2150,9820,1,0,1220,930,470000,1979
2250,12142,2,0,2250,0,363000,1986
2050,7700,2,0,2050,0,245000,1977
1010,3520,1,0,1010,0,525000,1902
5850,22885,2,2,4670,1180,1.70E+06,1978
1900,5000,1,0,1400,500,658500,1963
1020,8442,1,4,920,100,680000,1941
3390,16025,2,0,3390,0,835000,1987
1990,2175,2,0,1680,310,595000,2005
3190,4980,2,0,3190,0,419000,2005
1210,18700,1,0,1210,0,198900,1940
3740,12080,1,0,2000,1740,1.09E+06,1988
2150,4368,2,0,1610,540,500000,1998
2440,8100,1,0,1620,820,575000,1960
1230,1516,3,0,1230,0,324950,2000
2740,7980,2,0,2740,0,259000,1964
2260,9604,1,0,2260,0,551000,1990
1000,5125,1,0,1000,0,488000,1942
2350,46173,2,0,2350,0,635000,1980
2300,8938,2,0,2300,0,395000,1989
1440,8287,1.5,0,1440,0,370000,1928
2780,5000,1.5,0,1710,1070,675000,1919
1200,6825,1,0,1200,0,402000,1954
3040,24192,2,0,3040,0,825000,1987
2660,223027,1,0,1330,1330,579000,1962
1510,3000,2,0,1510,0,455000,1983
1780,6527,2,0,1780,0,265000,1989
2920,9163,1,0,1520,1400,713500,1976
1550,12670,1,0,1550,0,240000,1962
2710,217800,2.5,0,2710,0,570000,2006
1140,27760,1,0,1140,0,243800,1981
940,3864,1,0,940,0,543000,1918
2160,7500,2,0,2160,0,1.01E+06,1982
2470,17008,2,0,2470,0,625000,1979
2800,6567,2,0,2800,0,459950,2006
2420,39704,1,0,2420,0,370000,1985
1460,7254,1,0,1460,0,150000,1959
1820,5756,1.5,0,1640,180,683500,1946
1520,2208,2,0,1040,480,499950,2007
1320,9967,1,0,940,380,255000,1919
1920,7779,2,0,1920,0,279000,1989
2640,5096,2,0,2640,0,910000,2009
2650,7945,2,0,2650,0,699000,2006
3640,13530,1,0,2570,1070,1.65E+06,1924
1420,8800,1,0,1090,330,248000,1981
1540,37950,1,0,1090,450,429000,1959
1550,15239,1.5,4,1370,180,685000,1930
730,5040,1,0,730,0,316000,1927
2020,7540,1,0,1010,1010,410000,1921
1200,15843,1,2,1200,0,299000,1955
1240,6400,1,1,1060,180,559000,1938
2680,100188,2,0,1580,1100,575000,1978
1640,3804,2,0,1640,0,602000,1998
1640,5000,2,0,1640,0,492000,1907
1610,5024,2,0,1610,0,293500,2004
2290,14810,1,0,1400,890,481000,1967
2130,8078,1,0,1380,750,311100,1977
2140,13598,1.5,0,1620,520,375000,1970
4020,435600,1.5,2,4020,0,1.08E+06,1999
2030,8400,1,0,1330,700,500000,1968
1380,6250,1,0,1380,0,553000,1918
1780,1750,1,2,1400,380,760000,1927
1440,3200,1,1,960,480,589500,1960
2790,20824,1,0,1680,1110,840000,1959
4190,8805,2.5,2,3490,700,2.55E+06,1928
3870,46609,2,3,3870,0,1.28E+06,1997
1850,7875,1,0,1250,600,260000,1968
1550,1469,3,0,1550,0,430000,2004
1920,1896,3,3,1920,0,781000,2000
790,13170,1,0,790,0,280000,1947
3740,32481,1.5,0,2240,1500,392000,1958
1340,8856,1,0,1340,0,466200,1959
1620,3975,1,0,940,680,641000,1926
1680,8010,1,0,840,840,350000,1951
1610,4364,2,0,1610,0,450000,1996
4460,16953,1,0,2550,1910,1.80E+06,1962
1200,1848,2,0,1200,0,185000,1966
1250,12507,1,0,1250,0,290000,1958
3630,9475,2,0,3630,0,964000,1999
4260,18000,2,2,4260,0,2.00E+06,2000
2180,15693,1,0,1850,330,545000,1979
1760,10350,1,0,1330,430,609950,1979
1820,7626,1,0,990,830,605000,1941
2120,9163,1,0,1450,670,550000,1961
2730,4268,2,1,2730,0,905000,2009
2430,7613,2,0,2430,0,384200,1986
1170,1105,1,0,1170,0,370000,1965
2090,4000,1.5,2,1890,200,717500,1931
3910,7500,2,2,2550,1360,2.00E+06,1933
1140,15624,1,0,1140,0,365500,1909
1460,5700,1.5,0,1460,0,580000,1912
2700,14760,1.5,0,2700,0,415000,1940
670,6300,1,0,670,0,272000,1942
1880,6360,1,0,1040,840,600000,1945
1980,5352,2.5,0,1980,0,744000,1941
2080,10521,1.5,0,2080,0,830000,2004
1380,1225,3,0,1380,0,322000,2000
1808,19200,1,0,1808,0,270000,2005
1350,7973,1.5,0,1350,0,272450,1954
1760,2114,2,0,1400,360,605000,2008
1950,8325,1,0,1950,0,510000,1962
3170,4000,2,0,2340,830,1.13E+06,1999
3000,7500,2,0,3000,0,1.69E+06,1937
1460,16638,1,0,1460,0,162000,1975
1350,5850,1,0,1050,300,337500,1973
1470,7857,1,0,1180,290,312000,1973
3350,199253,2,0,3350,0,740000,2004
3350,199253,2,0,3350,0,700000,2004
1360,8136,1,0,1360,0,328000,1948
1020,7538,1,0,1020,0,241000,1981
1840,6750,1,0,1270,570,265000,1980
2030,10200,1,0,2030,0,246000,1958
1490,9112,1,0,970,520,271000,1940
2060,8398,1,0,1260,800,270000,1962
2240,7085,1.5,0,2240,0,395000,1944
1460,5715,1,0,1460,0,340000,1957
2140,13260,1,0,1240,900,340000,1948
1420,1246,2,0,1420,0,335000,2007
1060,3036,1.5,0,1060,0,435000,1943
1760,3600,1,0,880,880,527950,1926
2320,18919,2,4,2320,0,600000,1976
1770,3880,1,0,1300,470,667000,1963
4590,10920,1,2,2500,2090,1.15E+06,2008
2040,11211,2,0,2040,0,417000,2000
1260,7250,1,0,1260,0,451000,1943
1650,9780,1,0,950,700,580000,1943
2380,36446,2,0,2380,0,570000,1977
2750,7500,2,1,2150,600,750000,1937
2810,7700,2,0,2810,0,685000,2001
1340,9764,1,0,1340,0,275000,1944
2420,43177,2,4,1690,730,739888,1989
2160,5581,1,0,2160,0,715000,2002
2450,4400,1,0,1450,1000,800000,1913
1870,9000,1,0,1120,750,350000,1923
1000,223462,1,2,1000,0,220000,1933
2240,7791,2,0,2240,0,452500,2002
2200,5893,2,0,2200,0,280000,2008
790,12000,1,0,790,0,248000,1918
890,7200,1,0,740,150,305000,1949
1270,4000,1,0,1120,150,435010,1954
1850,2860,1.5,0,1210,640,678100,1931
1352,1694,3,0,1352,0,325000,2007
1540,8400,1,0,1180,360,529950,1968
1640,8529,1,0,1640,0,440000,1951
1350,4800,1.5,0,1350,0,585000,1928
2010,2778,2,0,1390,620,462608,2014
2080,5200,1,0,1040,1040,350500,1974
1040,8125,1,0,1040,0,210000,1956
1890,5929,2,0,1890,0,510000,1993
1810,7630,1,0,1810,0,280000,1959
1930,14389,1,0,1130,800,385000,1963
1010,8184,1,0,1010,0,349000,1947
1740,10836,1,0,910,830,252000,1981
2910,8881,2,1,1940,970,1.10E+06,1932
1330,8004,2,0,1330,0,375000,1985
2210,11700,2,0,2210,0,336000,1967
2670,6517,2.5,4,2020,650,732000,1977
1000,6227,1,0,1000,0,200000,1949
3150,7277,2,0,3150,0,681716,2006
1520,12246,1,0,1520,0,235000,1971
1690,13825,1,0,1210,480,257500,1955
1070,9497,1,0,1070,0,315000,1955
910,8000,1,0,740,170,299950,1950
2130,8640,1,0,1430,700,530000,1969
2230,6930,1,0,1530,700,766500,1947
3560,11119,1,2,2290,1270,860000,1986
2590,4961,2,0,2590,0,690000,1944
2040,6348,1,0,1020,1020,551000,1962
2100,20150,1,0,2100,0,530000,1955
1340,7260,1.5,0,1340,0,568000,1953
2770,10773,2,2,2770,0,749950,1992
2400,12546,1,0,2400,0,535000,1983
1140,9779,1,0,1140,0,234300,1963
930,11450,1,0,930,0,190000,1946
1820,6600,1,0,1820,0,525000,1960
1390,3708,1.5,0,1390,0,610000,1926
1480,1165,3,0,1480,0,520000,2006
760,6000,1,0,760,0,375000,1942
1580,7416,1,0,1150,430,600000,1967
1870,16200,1,0,1250,620,664000,1974
1510,4080,1,0,1010,500,698000,1923
1250,1306,3,0,1250,0,418000,2001
2140,13068,1,0,1460,680,271675,1974
1540,9028,1,0,1540,0,450000,1968
2950,78843,1.5,0,2950,0,759000,2006
2020,4129,1,0,1230,790,599950,1994
2820,5000,1.5,0,2170,650,810000,1927
1660,10000,1,0,1660,0,331292,1972
1830,2417,1,0,930,900,348000,1919
720,5600,1,0,720,0,435000,1920
2160,9063,2,0,2160,0,530000,1992
1510,9837,2,0,1510,0,227000,1989
1870,42070,1,0,1870,0,285000,1953
2860,26136,1,0,1640,1220,740000,1977
990,9145,1.5,0,990,0,246000,1939
1910,8710,1,0,1080,830,260000,1954
1350,10200,1,0,1350,0,366000,1977
2557,9480,2,2,2557,0,594950,1948
2610,5000,2,0,1710,900,608000,1946
1720,11875,1,0,1720,0,313100,1905
1170,9085,1,0,1170,0,185000,1967
1140,11480,1,0,1140,0,455000,1907
2350,9051,1,0,1570,780,235000,1966
1020,12289,1,0,1020,0,230000,1967
2730,5000,1,0,1460,1270,770000,1955
1830,7614,2,0,1830,0,240000,1991
1690,3026,2,0,1690,0,461000,2002
2900,10500,1,3,1450,1450,1.58E+06,1963
6380,88714,2,0,6380,0,1.82E+06,2006
1690,4000,2,0,1690,0,452000,2004
2660,5043,2,2,2660,0,765000,2003
4550,54013,1,1,2300,2250,1.05E+06,1989
1530,9999,1,0,1150,380,546000,1983
2070,4463,1.5,0,1780,290,781000,1931
1880,7953,1,0,1880,0,538000,1965
2240,8664,1,0,1470,770,790000,1975
2540,4400,1.5,0,1630,910,696500,1925
1370,8137,1,0,1370,0,276000,1988
770,8612,1,0,770,0,269000,1953
7880,24250,2,2,7880,0,2.42E+06,1996
2970,59677,1,2,1610,1360,829000,1973
740,6840,1,0,740,0,122000,1942
1360,7680,1,0,1360,0,352500,1955
1280,7560,1,0,1280,0,249000,1959
1920,7803,1,0,1080,840,360000,1962
2020,10584,1,0,2020,0,629500,1994
3310,127631,2,0,3310,0,1.14E+06,1924
2950,15593,1,0,1560,1390,1.55E+06,1942
1320,7695,1,0,1320,0,275000,1959
3160,6961,2,0,3160,0,697000,2005
1640,17335,1,0,840,800,379500,1978
2440,76531,1,0,1640,800,720000,1980
3000,5548,2,0,3000,0,675000,2006
2810,6000,2.5,0,2810,0,1.17E+06,1907
2390,6888,2,1,2390,0,1.10E+06,1939
2080,3500,1.5,0,1260,820,520000,1926
2650,7500,1.5,0,1590,1060,415000,1962
1060,1536,2,0,1060,0,415000,2000
1940,8312,1,1,1220,720,450000,1963
1080,4080,1,0,1080,0,485000,1948
1700,9600,2,0,1700,0,294000,1984
4440,10660,2,0,4440,0,1.04E+06,2003
1580,4000,2,0,1580,0,690000,1905
3630,38461,2,0,3630,0,716500,2000
1290,1137,3,0,1290,0,481000,2007
1960,4635,1,0,1000,960,575000,1968
2090,5015,1.5,0,2090,0,785000,1920
1960,43995,1,0,1960,0,480000,1970
2120,9297,2,0,2120,0,720000,1981
2290,34548,2,3,2290,0,536000,1984
1880,7965,2,0,1880,0,324900,2000
770,5160,1,0,770,0,265000,1943
1530,3210,1.5,0,1010,520,545000,1928
1450,27075,1,0,1450,0,465000,1940
1690,7320,2,0,1690,0,292500,1987
1880,3720,1.5,0,1880,0,860000,1924
4160,47480,2,0,4160,0,1.05E+06,1995
2140,7245,2,0,2140,0,495000,2003
1320,1462,3,0,1320,0,342000,1997
2000,10051,2,0,2000,0,320000,1997
1460,2610,2,0,1460,0,444000,1987
3070,8086,2,0,3070,0,804100,2005
1660,15000,1,0,1660,0,432000,1970
1810,4838,1.5,0,1050,760,230000,1905
3510,11200,2,0,3510,0,935000,2001
2180,2650,1.5,0,1410,770,634950,1930
3300,5720,1,0,1960,1340,780000,1963
2460,4200,2,0,2460,0,611000,1998
1880,4175,1.5,0,1090,790,475999,1944
2290,9450,1,0,1670,620,565000,1979
2290,26720,2,0,2290,0,630000,1977
3860,18334,2,0,3120,740,840000,1996
2640,432036,1.5,3,2640,0,790000,1996
2850,209523,1,0,1930,920,450000,1925
3020,4000,1.5,0,1920,1100,1.27E+06,1927
1510,3760,1,0,930,580,520000,1925
2410,8712,1,0,1260,1150,446800,1958
1470,6122,1,0,1200,270,652000,1948
2890,12130,2,3,2830,60,1.17E+06,1987
3490,7024,2,0,3490,0,745000,2006
1270,1406,2,0,1060,210,594000,2014
1000,3700,1,0,800,200,257000,1929
1430,4096,2,0,1430,0,485000,1900
1060,20040,1,0,1060,0,330000,1943
1680,8946,1,0,940,740,381000,1996
2280,641203,2,0,2280,0,849900,1990
2450,4080,1.5,0,1490,960,793000,1930
3650,5353,2,4,2200,1450,920000,1947
830,4000,1,0,830,0,455000,1947
3490,7494,2,3,3490,0,975000,2000
1050,1046,2,0,960,90,375000,2007
1170,1811,2,0,1170,0,400000,2001
1220,7200,1,0,1220,0,447000,1965
1310,8600,1,0,1310,0,470000,1987
3130,7582,2,0,3130,0,665000,2004
1590,41550,1.5,0,1290,300,295500,1933
1720,8638,2,0,1720,0,200000,1994
2520,212137,2,0,1590,930,620000,2005
1520,11067,1,0,1140,380,434900,1983
3260,4640,2,0,2360,900,1.33E+06,1907
3910,7500,2,0,3910,0,1.65E+06,2006
3480,6315,2,0,2360,1120,852500,2000
3040,34670,2,0,3040,0,790000,1983
2030,7350,1,0,2030,0,565000,1966
3870,24700,2,0,2520,1350,1.13E+06,1989
1870,1436,2,0,1870,0,289950,2004
2640,13939,1,1,1640,1000,850000,1963
1940,4800,1,0,1030,910,505000,1922
1710,5633,2,0,1710,0,372000,1981
1690,7728,1.5,0,1690,0,207000,1967
2340,10495,1,0,2340,0,780000,1967
1700,20283,1.5,0,1340,360,400000,1965
1850,8124,1,0,1850,0,440250,1948
1370,7920,1,0,950,420,585000,1949
2900,9972,2,0,2900,0,850000,1993
2400,3192,2,0,2400,0,570000,1991
3740,30884,2,0,3060,680,869000,1988
2170,5988,2,0,2170,0,551000,2014
970,8378,1,0,970,0,172380,1962
2620,78843,1,3,1310,1310,355000,1964
2980,10194,2,0,2980,0,728935,1993
2340,1919,2,2,2340,0,850000,1981
1880,48787,2,0,1880,0,515000,1922
1480,5325,1,0,1120,360,215000,1925
2240,9826,1,0,1370,870,220000,1988
2940,7675,2,0,2940,0,845000,2004
710,4000,1,0,610,100,390000,1928
1460,18599,1.5,0,1460,0,135000,1940
1530,19007,1,0,1290,240,439000,1949
2630,6185,2,0,2630,0,585000,1999
2230,16800,1.5,3,1700,530,620000,1923
960,3600,1,0,960,0,477000,1906
1180,1722,2,0,1180,0,399500,2006
1760,27332,1,4,1300,460,500000,1951
1340,8867,2,0,1340,0,432500,1984
2800,18673,1,0,1650,1150,940000,1965
4330,11979,1,4,2090,2240,3.17E+06,2008
3720,11610,2,0,3720,0,1.08E+06,1982
1670,5200,1,0,1030,640,229999,1977
1100,7657,1,0,1100,0,233000,1955
3240,8016,2,0,2910,330,600000,2004
1680,7620,1,0,1180,500,334000,1965
1030,8164,1,0,1030,0,332500,1950
1630,7700,1,0,1120,510,249900,1978
2610,12180,1,0,1670,940,310000,1918
1250,8520,1,0,1250,0,200000,1928
1480,11200,1,0,1480,0,310000,1969
1390,6000,1,0,1390,0,230000,1954
1940,5414,2,0,1940,0,420000,1997
2960,4750,2,0,2960,0,785000,2005
4320,19225,1,0,2160,2160,1.78E+06,1972
1500,7112,1,0,760,740,265000,1920
840,10465,1,0,840,0,295000,1951
3560,46644,2,0,3560,0,896000,1992
2390,9968,1,0,1390,1000,415000,1989
1200,5478,1,0,1200,0,250000,1955
2570,5000,2,0,2570,0,1.48E+06,1984
2180,6000,1,0,1430,750,635000,1966
3450,48787,2,0,3450,0,905000,1987
2020,5613,2,0,2020,0,528000,2003
2480,7480,2,0,2480,0,530000,1992
1140,3104,2,0,1140,0,310000,1988
1530,9465,1,0,1530,0,252000,1960
1700,8160,1,0,1120,580,334500,1961
2150,8480,1,0,1610,540,370000,1951
1190,7840,1.5,0,1190,0,311000,1918
1730,4131,2,2,1480,250,260000,1975
1400,9546,1,0,1400,0,217500,1984
2200,4240,2,0,2200,0,290000,2003
960,4600,1,0,960,0,500000,1944
1770,6000,1,3,1100,670,423500,1984
2970,5722,2,0,2970,0,715000,2005
1590,3121,2,0,1590,0,299000,1994
3350,4007,2,0,2550,800,635000,2005
3370,9629,2,0,3370,0,806000,1999
1960,3480,2,0,1960,0,289950,2004
1360,6603,1,0,1360,0,280000,1981
2780,6000,2,0,2780,0,479950,2004
3000,9793,2,0,3000,0,394000,2002
3600,203425,2,0,3400,200,682000,1979
990,3000,1,0,990,0,409950,1918
2990,4200,2,4,2000,990,1.00E+06,1925
1200,6600,1.5,2,1200,0,436000,1908
1530,15975,1,0,970,560,279000,1952
1440,4920,1,0,720,720,390000,1923
1940,167125,1,1,1480,460,635000,1955
2140,8100,2,0,2140,0,304400,1990
2330,3800,1.5,0,1360,970,780000,1927
2734,210201,2,0,2734,0,520000,1974
1950,10633,1,0,1250,700,580000,1978
1440,7198,1,0,990,450,274000,1981
1530,7906,1,0,1150,380,315000,1980
1910,77574,1,0,1910,0,390000,1971
1750,8220,1,0,1750,0,340000,1956
1600,45613,2,0,1600,0,502000,1983
1750,11180,1,0,1750,0,260000,1968
940,4800,1,0,940,0,399000,1911
880,6345,1,0,880,0,312500,1919
1650,8254,1,0,1060,590,370000,1951
3820,13224,2,0,3280,540,1.24E+06,1990
1900,9630,1,0,1900,0,230000,1967
3720,8448,1,3,1960,1760,1.28E+06,1947
1410,5120,1.5,0,1210,200,294350,1925
960,5700,1,0,960,0,208950,1956
1930,5570,1,0,1930,0,515000,2005
3420,9575,2,0,3420,0,965000,1994
3010,3400,2,2,2240,770,925000,1923
1780,5000,1.5,0,1780,0,654500,1947
2080,11050,1,0,2080,0,364000,1969
1250,5208,1,0,1050,200,150000,1951
2257,10117,1,0,1363,894,349950,2005
1670,5000,1.5,0,1670,0,585000,1912
2250,13500,2,0,2250,0,801501,1980
1650,221720,1,0,1650,0,610000,1992
2880,11965,2,0,2880,0,382000,1990
3620,403693,2,2,3620,0,495000,1980
1950,6504,1,0,1530,420,447500,1953
2280,9491,1,0,1290,990,575000,1966
1740,4736,1.5,2,1040,700,565000,1907
1220,7876,1,0,1220,0,348580,1966
2260,9703,1,0,1660,600,459000,1978
1790,61419,2,2,1790,0,375000,1988
2440,7093,2,0,2440,0,310000,1999
1400,9600,1,0,1400,0,210000,1964
1810,3292,2,0,1810,0,384205,2014
1400,4500,1,0,900,500,180000,1922
1400,4500,1,0,900,500,310000,1922
2010,6294,2,0,2010,0,427500,2000
2520,2152,1.5,0,1560,960,780000,1925
3060,16000,2,0,3060,0,1.76E+06,1988
2150,4000,2,0,2150,0,339950,2010
2880,9750,2,0,2880,0,820000,1989
1300,3865,1,0,1300,0,398000,2006
2770,39927,1,0,1580,1190,492000,1978
1780,14810,1,0,1180,600,240000,1950
3730,15029,2,2,2440,1290,599950,1991
930,7740,1,0,930,0,105500,1932
930,7740,1,0,930,0,445000,1932
1460,426450,1,0,960,500,390500,1966
1310,8454,1,0,1310,0,255000,1994
2770,10274,2,0,2770,0,675750,1989
3140,5445,2,3,2240,900,1.64E+06,1913
1770,9239,2,0,1770,0,353500,2004
1220,7585,1,0,1220,0,765000,1954
2190,4944,2,0,2190,0,563500,1999
1800,5465,1,0,900,900,439000,1942
3100,10014,1,2,1660,1440,975000,1973
2270,4399,2,0,2270,0,469900,2007
1300,8184,2,0,1300,0,252000,1947
1769,9300,1,0,1769,0,495000,1955
3370,15625,1,0,1770,1600,570000,1964
1630,5361,2,0,1630,0,327000,1999
2470,7658,1,0,1480,990,898000,1954
2600,8572,2,0,2600,0,300000,2003
1800,12440,1,0,1220,580,418500,1978
2240,4616,2,0,1840,400,450000,2001
1960,13100,1,2,1650,310,403000,1957
1710,6556,1.5,0,1200,510,440000,1926
2140,4959,1,0,1080,1060,350000,1965
1400,6200,1,0,700,700,240000,1948
890,2100,1,0,760,130,460000,1919
1820,4000,2,0,1820,0,825000,1923
1860,12000,1,0,1860,0,267500,1976
1220,22443,1,0,1220,0,201000,1972
2300,4637,2,0,2300,0,479500,2008
1520,4700,2,0,1520,0,210000,1978
1440,3225,1,0,960,480,445000,1915
1170,8148,1,0,1170,0,265000,1952
1170,8148,1,0,1170,0,399000,1952
3200,53357,2,0,3200,0,785000,1972
4470,35124,2.5,0,4470,0,831500,1984
2570,4557,2,0,2570,0,360000,2009
2370,7916,2,0,2370,0,655000,1990
1800,10150,1.5,0,1800,0,449950,1958
2300,7000,1,0,1290,1010,612000,1975
3240,33661,2,0,3240,0,575000,2001
2280,18241,1,0,960,1320,557000,1995
1870,12500,1,1,1030,840,375000,1943
1820,99752,1,0,1820,0,369000,1969
2390,6282,1,0,1290,1100,330000,1966
2110,6708,1,3,1410,700,1.03E+06,1941
980,4800,1,0,980,0,550000,1910
1250,7710,1,0,1250,0,338000,1947
3680,13351,2,2,3680,0,1.90E+06,1946
2230,8163,1,0,1230,1000,235000,1966
1230,9300,1.5,0,1230,0,349950,1918
2093,10350,1.5,0,2093,0,300000,1963
1660,12865,1,0,1660,0,431000,1967
1630,20750,1,0,1100,530,280000,1975
1677,7209,2,0,1677,0,295000,2011
2990,6383,2,0,2990,0,445000,2003
2150,262231,1.5,0,2150,0,550000,1900
2890,15067,2,0,2890,0,515000,2003
3050,158558,1,0,3050,0,555000,1987
1410,2500,2,0,1410,0,265000,2006
2280,2432,2,0,1520,760,597000,1921
1260,5800,1,0,1260,0,661000,1939
1460,4350,2,0,1460,0,362764,2008
1600,14000,1,0,1310,290,427000,1950
2020,8531,1,0,2020,0,405000,1965
1170,11530,1,0,1170,0,157000,1960
1170,11530,1,0,1170,0,246500,1960
1280,11071,1,0,850,430,386500,1984
2680,15508,2,0,2680,0,300000,1999
1770,8571,1,0,1270,500,240000,1978
4790,12957,2,1,3110,1680,818500,2005
1300,8500,1,0,1300,0,249000,1964
2610,7700,1,0,1700,910,580000,1977
4500,35200,1,0,4500,0,2.34E+06,1988
2100,7366,2,0,2100,0,333000,1997
1340,7605,1,0,1340,0,230000,1992
970,6180,1,3,970,0,360500,1974
2200,7200,1,0,1270,930,265000,1962
990,5000,1,0,990,0,490000,1941
1180,5000,1,0,880,300,600000,1925
980,6530,1,0,980,0,307500,1969
2370,9636,1,0,1660,710,670000,1976
1910,10583,1.5,0,1910,0,247200,1922
5270,12195,2,4,3400,1870,2.60E+06,1979
1430,8400,1,0,1430,0,440000,1961
2490,7694,2,0,2490,0,700000,1987
2000,8317,1.5,0,2000,0,756100,1917
2600,19275,1,0,1620,980,555000,1978
2880,3750,2,2,2270,610,830000,2001
1010,8863,1,0,1010,0,180000,1990
3290,5600,2,0,2670,620,775000,2004
1530,18400,1.5,0,1530,0,220000,1938
2020,15810,1,0,1620,400,650000,1967
1340,9975,1,0,1340,0,410000,1961
2180,5367,2,0,2180,0,339995,2000
2870,9680,1,4,1440,1430,1.16E+06,1966
2070,9697,2,0,1330,740,440000,1929
930,7080,1,0,930,0,275000,1923
2270,9822,2,0,2270,0,766000,1988
1630,7900,1,0,1130,500,231500,1973
2770,89298,2,0,2770,0,472000,2004
4010,37076,2,0,4010,0,1.33E+06,1990
1970,8390,1,0,1140,830,265000,1955
790,6000,1,0,790,0,325000,1948
1740,8424,1,0,1040,700,364500,1954
1130,8184,1,0,1130,0,322500,1947
1180,4000,1,0,1040,140,338900,1929
2350,4000,2,0,2350,0,910000,1993
2350,4000,2,0,2350,0,1.02E+06,1993
1850,6869,1,2,1100,750,459950,1919
3220,6224,1.5,0,3220,0,584950,2009
2050,11313,1,0,1520,530,252000,1987
1430,8470,1,0,1190,240,270000,1992
3210,8938,2,0,3210,0,750000,2005
3520,12350,1,4,1530,1990,775000,1960
2260,8120,2,0,2260,0,325000,2004
3290,6422,2,0,3290,0,810000,2012
1640,2128,2,0,1640,0,409000,1974
1580,5340,1,0,1130,450,400000,1947
1940,8270,2,0,1940,0,530000,1962
1580,8506,2,0,1580,0,580000,1987
1750,11340,1,1,1300,450,491300,1987
1810,7350,1,0,1200,610,272000,1980
1970,106722,1,4,1970,0,599950,1985
1770,5146,2,0,1770,0,464000,1992
1800,6000,1,0,900,900,471001,1905
1500,11616,1,0,1100,400,230000,1980
940,6695,1,0,940,0,358000,1959
2340,6183,1,0,1210,1130,510000,1929
840,9480,1,0,840,0,86500,1960
840,9480,1,0,840,0,199950,1960
2940,5432,3,3,2440,500,1.71E+06,1978
3180,3680,2,0,2190,990,850000,1918
2020,3440,1.5,0,1480,540,542000,1928
820,4320,1,0,820,0,102500,1937
4060,136290,1,0,2810,1250,718000,1995
2660,22194,1,0,2180,480,625000,1977
1010,11244,1,0,1010,0,350000,1947
710,5120,1,0,710,0,216000,1918
980,7228,1.5,0,980,0,340000,1946
1100,5400,1.5,0,1100,0,505000,1908
2840,6010,2,0,2840,0,372000,2003
2300,7524,2,0,2300,0,263850,1978
5370,20388,2,4,5370,0,1.35E+06,1990
2280,9899,2,0,2280,0,325000,1987
1010,7740,1,0,890,120,289000,1924
1420,6600,1,0,1160,260,364000,1987
2100,8800,1,0,1250,850,610000,1980
3110,49765,1,0,3110,0,531500,1958
2160,9540,2,0,2160,0,402500,1979
820,6250,1,0,820,0,375000,1922
4340,9108,1,0,2170,2170,537500,1979
2100,9066,1,0,1440,660,375000,1962
1250,8840,1,0,910,340,293550,1979
3870,43787,2,0,2700,1170,585000,1976
1360,2693,2,0,1360,0,225000,2003
1400,8684,1.5,0,1400,0,185000,1957
1450,7375,1,0,1010,440,402000,1968
1880,16617,1,0,960,920,585000,1963
1380,953,3,0,1380,0,549000,2006
2910,15626,1.5,0,2510,400,1.81E+06,1923
1380,10529,1,0,1380,0,345000,1967
3100,11985,1,0,1790,1310,302500,1963
1400,25500,1,0,1400,0,218500,1964
1650,6840,1.5,0,1650,0,705000,1916
840,5525,1,0,840,0,191000,1969
2550,45254,2,0,2550,0,695000,2001
2820,11770,2,0,1630,1190,350000,1947
1710,4080,1,0,1130,580,480000,1979
820,5200,1,0,820,0,220000,1977
2620,33578,2,0,2620,0,535000,1977
2430,23400,1,4,2430,0,1.00E+06,1951
1560,7424,1,0,1560,0,592000,1940
3060,6826,2,0,3060,0,775000,2004
1680,4584,2,0,1680,0,320000,2003
3320,15022,2,0,3320,0,760000,1989
2390,8315,2,0,2390,0,640000,1990
1360,5840,1,0,1360,0,253200,1953
1800,9236,1,0,1800,0,228000,1954
1160,9525,1,0,1160,0,325000,1968
4160,35654,2,0,2760,1400,530000,1973
1660,3200,2,0,1660,0,300000,2011
1410,6030,1.5,0,1410,0,418000,1930
2230,9625,1,4,1180,1050,415000,1955
1700,4000,2,0,1700,0,384000,2003
2070,8337,2,0,2070,0,325000,1997
2300,12682,1,2,2300,0,600000,1955
3040,9690,1,0,1940,1100,760000,1978
1220,3568,1.5,0,1220,0,168000,1976
960,3960,1,0,960,0,405000,1943
1480,10094,1,0,1480,0,479000,1956
1560,5130,1,0,1150,410,549000,1915
1100,33600,1,0,1100,0,215000,1967
900,5750,1,2,900,0,550000,1940
2400,7700,1.5,0,1500,900,389000,1927
2320,15024,2,0,2320,0,447500,1990
2570,5590,1,0,1580,990,540000,2009
1300,9638,1,0,1300,0,273500,1983
2930,10148,2,0,2930,0,257000,2002
720,7200,1,0,720,0,199000,1943
2350,10655,2,0,2350,0,339100,1992
2940,7590,2,0,2940,0,435000,1991
2020,3000,1,0,1010,1010,400000,1910
1430,365904,1,0,1010,420,356000,1991
950,6951,1,0,950,0,395000,1950
1250,4320,1,0,850,400,575000,1911
1300,5120,1.5,0,1300,0,515000,1925
2520,3360,1.5,0,1550,970,618250,1931
1330,7125,2,0,1330,0,245000,1968
2480,3240,1.5,0,1890,590,690000,1929
3020,10010,1,0,1510,1510,465000,1959
1770,8240,1,0,1240,530,280000,1978
1930,6533,1,0,1230,700,285000,1960
1650,7047,2,0,1650,0,320000,1994
2580,9601,2,0,2130,450,355000,1992
2570,10078,1.5,0,2570,0,670000,1965
2880,7560,1,0,1440,1440,550000,1925
2660,4500,1.5,0,1860,800,765000,1909
1560,5225,1.5,0,1260,300,430000,1927
3080,8448,2,2,3080,0,950000,2000
2540,7200,1,0,1270,1270,525000,1947
3080,8163,1,0,1580,1500,300000,1985
2190,7258,2,0,2190,0,345000,2000
2930,150945,2,0,2930,0,838000,1972
2880,20274,1,3,1660,1220,1.80E+06,1959
2160,98445,2,0,2160,0,390000,1978
2110,18815,2,0,2110,0,1.15E+06,1979
1830,5720,2,0,1830,0,295000,2003
3180,7650,2,0,2530,650,775000,1920
1880,6047,2,0,1880,0,380000,1993
1140,8180,1,0,1140,0,550000,1959
1798,11232,1,0,1798,0,199900,1967
1670,5209,1.5,0,1670,0,329900,1908
2580,11060,1,0,2580,0,898000,1964
3720,12384,1,2,1860,1860,875000,1970
2790,7956,2,0,2790,0,375000,2005
2190,5091,2,0,2190,0,365000,2004
2280,2850,1.5,0,1540,740,530000,1930
1100,5200,1,0,1100,0,225500,1969
2180,7000,1,0,1680,500,318000,1969
2770,9798,2,0,2770,0,910000,1986
1980,18730,1,0,1280,700,207000,1943
4180,17935,2,0,4180,0,1.89E+06,2004
3030,31920,1,0,1670,1360,624500,1980
1690,1553,2.5,0,1690,0,640000,2007
1990,65340,2,0,1990,0,500000,1986
2250,8970,1,0,1500,750,390000,1966
2080,2050,1.5,0,1550,530,284000,2003
2460,41343,1,0,2460,0,620000,1988
2588,5702,2,0,2588,0,306000,2008
2570,12039,1,0,1910,660,495000,1978
2370,12753,2,0,2370,0,499950,2001
1070,10563,1,0,1070,0,330000,1969
1940,5820,1.5,0,1150,790,665000,1944
2650,2387,2,0,1830,820,850000,1920
2290,6318,2,0,2290,0,599950,1988
2050,9143,2,0,2050,0,360000,1992
2680,5497,2,0,2680,0,699000,2001
1520,8100,1,0,760,760,475000,1945
2690,435600,2,0,2690,0,575000,1992
1180,844,2,0,990,190,345000,2005
3030,9500,2,0,3030,0,367950,1989
1400,11400,2,0,1400,0,374500,1984
3000,8100,2,0,3000,0,607500,1992
1200,9800,1,0,1200,0,374000,1971
1000,6947,1,0,1000,0,390000,1947
2740,5339,2.5,0,2740,0,705000,2004
1990,4978,2,0,1990,0,467000,2004
2110,7794,1,0,2110,0,243500,1981
1830,1850,2,0,1690,140,593000,2011
940,7980,1,0,940,0,223000,1961
2980,10179,2,2,2980,0,574000,2003
2260,11305,1,0,1130,1130,400000,1986
3470,70131,1,0,1750,1720,772000,1962
1510,10450,1,0,1510,0,593777,1964
2710,5722,2,0,2040,670,539500,1997
2080,2625,2,0,2080,0,550000,2006
1860,10856,1,0,1260,600,265000,1952
2120,9350,1,0,1280,840,428000,1979
1110,8375,1,0,1110,0,505000,1951
5190,12637,2,2,5190,0,925000,2001
1520,15344,1,0,1520,0,230000,1968
2650,9990,2,0,2650,0,695000,1990
3350,7857,2,2,3350,0,700000,2004
1770,2800,1.5,0,1770,0,712500,1914
2200,4692,2,0,2200,0,480000,2005
2000,8424,1,0,1300,700,470000,1968
1730,15003,1,0,1150,580,335000,1980
1300,7907,1,0,900,400,270000,1970
2950,67475,1,0,2530,420,810000,1981
1720,954,3,0,1460,260,589000,2006
880,4558,1,0,880,0,415000,1951
1790,13200,1,0,1220,570,197000,1979
1380,7600,1,0,790,590,235500,1971
1530,1840,2,0,1240,290,460000,2008
2330,4947,1,0,1380,950,572500,1955
1540,9629,1,0,1540,0,302000,1960
3210,8630,2,0,2530,680,870000,1990
1130,5758,1,0,960,170,485000,1939
1460,7526,1,0,1460,0,240000,1968
1410,7215,1,0,1410,0,383000,1967
1750,5080,1.5,0,1750,0,750000,1903
1370,5125,1,0,1370,0,409950,1944
1780,23819,1,0,1780,0,246000,1953
1890,4500,2,0,1490,400,860000,1937
1630,12295,2,0,1630,0,339950,1985
2320,8100,1,0,1160,1160,315000,1956
2580,4636,2,0,2580,0,698000,2006
1470,2034,2,0,1470,0,419000,1985
2298,10140,1,0,2298,0,372000,1969
1960,4709,2,0,1960,0,425000,2003
2950,8036,1.5,0,1950,1000,386500,1963
670,7312,1,0,670,0,348000,1942
3020,15305,2,0,2230,790,754000,1978
2390,7309,2,0,2390,0,269950,1944
3090,20785,2,0,3090,0,891500,1991
1780,5000,1,0,890,890,349950,1903
1420,81892,1,0,1180,240,360000,1956
2420,15482,2,0,2420,0,975000,1925
1480,3844,1.5,0,1480,0,449250,1928
2190,3850,2,0,2190,0,350000,2006
1820,6137,1.5,3,1690,130,790000,1911
1810,24586,1,4,930,880,990000,1983
2550,4089,2,0,2550,0,834000,1983
1360,3880,1,0,1060,300,466950,1963
2259,26831,1.5,3,1491,768,262500,1908
3880,14550,2,0,3880,0,762300,1987
2730,5000,1,0,1780,950,733000,1962
2800,17279,1,2,1560,1240,439000,1957
4290,7019,2.5,0,3590,700,1.16E+06,1927
1770,3993,2,0,1770,0,420000,1999
1920,10961,2,0,1920,0,549000,1981
2320,4000,1.5,0,1510,810,518000,1905
2961,12146,2,0,2961,0,695000,1998
1680,7385,2,0,1680,0,485000,1988
1590,27200,1.5,0,1590,0,280000,1926
1420,16400,1.5,0,1420,0,306500,1943
1370,9460,1,0,1370,0,720000,1950
2620,4558,2,3,2620,0,277500,2010
1810,17006,2,4,1810,0,649000,1913
4730,47870,1,4,2940,1790,3.40E+06,1954
700,6000,1,0,700,0,267800,1949
2390,6979,2,0,2390,0,625000,1993
2070,8127,1.5,0,1590,480,600000,1924
1780,8149,1.5,0,1780,0,395000,1948
1900,21780,1.5,0,1900,0,212000,1940
1040,4040,1,0,940,100,425000,1928
2370,5000,1.5,2,1770,600,870000,1919
1970,3667,2,0,1970,0,420000,2004
2120,9921,2,0,2120,0,800000,1981
1960,9535,2,0,1960,0,575000,1989
2660,4000,2,0,2170,490,915000,2003
1180,14258,2,0,1180,0,400000,1987
2390,6550,1,2,1440,950,750000,1955
1250,7592,1,0,1250,0,235000,1961
2600,13674,1,0,1300,1300,599950,1967
940,3800,1,0,940,0,481203,1929
3880,13000,2,0,3880,0,1.82E+06,1972
1530,2913,2,0,1530,0,379000,1986
2430,5000,2,0,1760,670,626000,1945
1030,4841,1,0,920,110,535000,1939
2740,16007,2,0,2740,0,1.23E+06,1984
1180,1034,2,0,1120,60,410000,2001
3090,9238,1,3,1680,1410,940000,1967
1060,9663,1,0,1060,0,326250,1967
790,5985,1,0,790,0,200000,1944
3070,8250,1,0,2100,970,880000,1958
2100,58488,2,0,2100,0,370000,2005
1100,1737,2,0,1100,0,190000,2006
1070,4200,1,0,1070,0,160000,1983
2190,12825,1,0,1520,670,625000,1989
3450,6873,2,0,2750,700,590000,2004
2070,3599,2,0,2070,0,575000,1999
1190,5200,1,0,1190,0,470000,1912
600,1500,1,0,600,0,130000,1900
940,8400,1,0,940,0,229000,1958
1280,12928,1.5,0,1280,0,279900,1942
1370,7500,1,0,1370,0,307000,1960
2450,15001,1,0,1980,470,399950,1989
1970,15743,1,0,1370,600,405000,1962
2910,9000,1,0,2130,780,539950,1966
760,5240,1,0,760,0,129000,1949
1270,8422,1,0,1270,0,340000,1967
1570,4875,1,0,1310,260,214950,1977
2310,5650,1,2,1330,980,450000,1952
1900,5000,1,0,950,950,515000,1925
3780,5160,2,0,2510,1270,1.40E+06,1907
1060,9946,1,0,1060,0,230000,1956
1880,10032,1,0,1880,0,681000,1984
1160,8636,1,0,1160,0,255000,1923
860,4013,1,0,860,0,580000,1925
1590,8000,1,0,910,680,295000,1984
1170,6543,1,0,1170,0,286000,1913
1190,8100,1,0,830,360,425000,1947
1300,11400,1,0,1300,0,170000,1961
1660,8281,1,0,1660,0,380000,1949
1160,6120,1,0,1160,0,506000,1947
1950,9618,2,0,1950,0,315000,1992
2470,3811,2,0,2470,0,449950,1999
1430,12420,1,0,1430,0,255000,1964
1970,9607,2,0,1090,880,289000,1988
1400,10018,1,0,1400,0,389000,1962
1510,344124,1,2,1510,0,327000,1964
5350,14400,2.5,0,5020,330,2.89E+06,1910
920,6612,1,0,920,0,210000,1948
7620,29536,2,3,5980,1640,1.68E+06,2005
2490,4751,2,0,2490,0,360000,2001
3030,16000,2,0,3030,0,875000,1990
1650,7200,1,0,1650,0,550000,1967
1210,12500,1,0,1210,0,257500,1962
2990,7389,1.5,0,2090,900,1.08E+06,1923
1060,5144,1,0,1060,0,202950,1969
2680,6120,1,0,1340,1340,622000,1959
1790,45738,1,0,1410,380,455000,1976
2690,17461,2,3,2690,0,805000,1997
770,9497,1,0,770,0,257000,1950
2700,16570,1,0,1750,950,744500,1967
2620,9157,2,0,2620,0,885000,1996
930,747,2,0,630,300,355000,2007
1340,7000,1,0,1340,0,240000,1978
1470,18459,2,0,1470,0,169000,1916
2330,4160,2,0,2330,0,639900,1992
1730,11325,1,0,1730,0,292000,1972
2780,7838,2,3,2780,0,563500,2004
1200,7131,1,0,1200,0,389000,2006
4430,21000,2,0,4430,0,2.75E+06,1952
1820,4418,2,0,1820,0,661000,1994
1300,4659,1,0,1300,0,344000,2005
680,6600,1,0,480,200,510000,1916
780,4132,1,0,780,0,289000,1942
2430,7614,1.5,0,1900,530,365000,1979
1750,32500,1,0,1750,0,410000,1966
1610,5100,1.5,0,1010,600,535610,1901
2120,7620,2,0,2120,0,397950,1971
1430,4850,1,0,930,500,284000,1978
1360,8100,1.5,0,1360,0,201000,1962
2530,5000,1.5,0,1690,840,734000,1925
3270,9146,2,0,3270,0,357500,2002
2620,8050,1,0,1520,1100,550120,1975
1810,8232,1,0,1810,0,300000,1988
2120,9653,2,0,2120,0,374950,1992
2190,41000,2,0,2190,0,602500,1980
980,7606,1,0,980,0,221000,1954
2230,4400,2,0,1730,500,920000,1913
1540,9279,1,0,1540,0,235000,1955
980,7296,1,0,980,0,375000,1967
2120,3640,2,0,2120,0,599000,2005
2090,12112,2,0,2090,0,562100,1983
1620,1377,2,0,1100,520,640000,2009
1650,11256,1,0,1250,400,294000,1957
3230,7766,2,0,3230,0,714000,2005
2790,5420,1,3,1130,1660,970000,1963
1600,7916,2,0,1600,0,280000,1991
1790,4358,2,0,1790,0,260000,1993
2060,15050,1.5,0,2060,0,294000,1938
1370,41194,1.5,2,1370,0,255500,1900
6200,13873,2,4,4440,1760,3.30E+06,1989
1510,43560,1,0,1510,0,450000,1954
1280,9898,1,0,1280,0,368000,1968
2180,11056,1,0,1370,810,830000,1963
1440,11210,1,0,1130,310,282500,1935
1580,16215,1,0,1580,0,335000,1978
1580,5750,1,0,790,790,558000,1910
1730,8505,1.5,0,1730,0,270000,1961
700,13500,1,0,700,0,152000,1920
2030,18295,1.5,0,2030,0,493000,1975
2500,10330,2,0,2500,0,740000,1992
2605,2216,2,2,2090,515,789800,1979
910,4191,1,0,910,0,275000,1910
3560,6480,2.5,0,3560,0,1.50E+06,1914
1140,3395,1,0,620,520,424000,1925
1000,3513,1,4,1000,0,715000,1914
3010,7953,2,0,3010,0,600000,2000
2110,8700,1,4,1760,350,802000,1960
910,8700,1,0,910,0,165000,1943
2050,5000,2,0,1370,680,750000,1987
1090,10481,1,0,780,310,405000,1981
2100,12338,2,0,2100,0,521900,1997
1000,8018,1,0,1000,0,275000,1969
4410,58157,2,0,2330,2080,600000,2001
1800,10200,1,0,1800,0,442500,1967
920,7716,1,0,920,0,229950,1944
1410,7265,1,0,1410,0,274950,1983
1860,48076,1.5,0,1860,0,407185,1929
2100,8400,1,0,1240,860,468000,1976
1030,4365,1,0,1030,0,450000,1942
940,8997,1,0,940,0,219950,1955
1340,5995,2,0,1340,0,275000,1989
850,6000,1,0,850,0,229950,1924
2130,4400,1,0,1430,700,675000,1922
2430,6796,2,0,2430,0,412950,1993
2290,39000,2,0,2290,0,670000,1979
1230,10005,1,0,1230,0,420000,1963
1150,27319,1,0,1150,0,358000,1976
2120,3600,2,0,2120,0,680000,2005
980,3400,1,0,980,0,380000,1923
2130,219978,2,0,2130,0,515000,1986
1050,4800,1,0,1050,0,325000,1969
1820,6848,1,0,1820,0,875000,1953
2210,5750,2,0,1710,500,426000,1914
2490,9639,1,0,1610,880,868500,1959
4140,24190,2,0,4140,0,657500,2002
1210,3090,1,0,860,350,366000,1926
1010,4000,1,0,1010,0,385000,1911
2050,8750,1,0,1300,750,300000,1967
2060,3300,2,0,1500,560,810000,1918
1560,7200,1,0,860,700,460000,1943
1780,4000,2,0,1780,0,459000,1995
1460,10000,1,0,1460,0,260000,1967
3030,6813,2,0,3030,0,557865,1987
980,3000,1.5,0,980,0,295000,1914
1450,7245,1,0,1450,0,375000,1950
3230,17833,2,0,3230,0,2.11E+06,1973
1520,1020,3,0,1520,0,307300,1999
1410,7000,1.5,0,1410,0,225000,1963
1390,13200,2,0,1390,0,290000,1979
2230,5000,1.5,0,1510,720,690000,1922
2110,12653,2,0,2110,0,825000,1972
2270,11472,1,0,1370,900,645000,1956
2530,10611,1,0,1320,1210,590000,1977
1900,5470,1,0,1180,720,667000,1930
2390,8432,2,0,2390,0,664000,1998
3160,6540,1,3,1580,1580,452100,1959
900,2728,2,0,900,0,290000,1998
3610,17483,2,2,3610,0,950000,1954
2070,4200,1.5,0,1670,400,662500,1906
1850,5444,2,0,1850,0,475000,1981
1440,9711,1,0,1140,300,450000,1956
2590,15229,2,3,2590,0,538250,1984
1140,5250,1.5,0,1140,0,329950,1949
2760,5040,2,2,2760,0,1.10E+06,1955
1310,4800,1.5,0,1110,200,307000,1929
1870,7189,1,0,1270,600,433000,1959
1900,18000,1,0,1280,620,212000,1968
2860,6000,2.5,0,2380,480,750000,1902
1640,5650,1,0,1640,0,279000,2003
1140,5500,1.5,0,1140,0,476000,1908
2590,9394,1,0,1390,1200,368000,1963
2160,5200,1,0,1320,840,228950,1978
3260,58806,2,0,3260,0,568450,1969
1660,3800,1.5,0,1660,0,619000,1926
1640,6044,2,0,1640,0,275000,1996
2620,5457,2,0,2620,0,321500,2003
950,6000,1,0,790,160,230000,1939
900,8100,1,0,900,0,179500,1959
1650,7313,1,0,1220,430,460000,1975
1800,3980,2,0,1800,0,286000,2006
1480,4200,1.5,0,1480,0,427500,1925
1040,6250,1,0,1040,0,400000,1942
2300,5611,1,0,2300,0,675000,2004
2480,8906,1,0,1240,1240,350000,1969
1970,10358,1,0,1540,430,385000,1977
1530,3503,1,1,830,700,525000,1916
970,18557,1,0,970,0,315000,1939
2920,252648,2,0,2920,0,820000,2002
970,7700,1,0,970,0,205000,1959
680,5250,1,0,680,0,500000,1922
2640,6738,2,0,2640,0,599000,1989
4200,30120,2,2,3600,600,2.23E+06,1933
1980,7521,1,0,1180,800,299000,1979
2980,27144,1.5,2,2180,800,947500,1917
1630,1677,3,0,1630,0,385000,2007
1780,4520,1,0,890,890,639950,1925
1210,8400,1,0,780,430,824000,2000
1010,7245,1,0,1010,0,199950,1969
2570,5000,1,0,1480,1090,1.01E+06,1940
2770,5320,2,1,2440,330,950000,2013
2290,9158,2,0,2290,0,822000,1984
1780,8400,1,0,1080,700,473600,1969
2150,4500,1.5,0,2150,0,490000,1938
1920,9306,1,0,1000,920,245000,1984
1220,11730,1,0,1220,0,199000,1960
2960,5500,2,2,2440,520,1.34E+06,1937
1500,19113,1,0,1500,0,418000,1984
2830,8625,1,0,1830,1000,450000,1957
1580,7000,2,0,1580,0,280000,1992
1230,11601,1,0,910,320,273000,1992
2910,6338,2,0,2910,0,549000,2008
2370,15512,2,0,2370,0,913888,1981
1930,3500,1.5,0,1540,390,689888,1916
1780,5043,1,0,870,910,305000,1993
2760,6850,2,0,2760,0,602500,1999
1620,3640,1,0,900,720,355000,1929
2160,7525,2,0,2160,0,756000,1986
2190,6906,1,0,1040,1150,289950,1977
3240,7857,2,0,3240,0,800000,1994
720,3255,1,0,720,0,403000,1905
1410,1340,2,0,1370,40,350000,1967
2980,5100,2,0,2370,610,1.29E+06,2015
1950,8025,1,2,1150,800,525126,1960
1100,8138,1,0,1100,0,241450,1949
1400,9087,1,0,1400,0,320000,1954
1710,7455,1,0,1030,680,234000,1975
2000,3600,1,0,1150,850,441000,1987
2000,3600,1,0,1150,850,474500,1987
1440,2618,1.5,0,1440,0,705000,1906
1520,3370,2,0,1520,0,517500,1994
1440,13300,1,0,1440,0,142500,1948
1010,10005,2,0,1010,0,310000,1981
2440,9727,2,0,2440,0,749500,1987
2480,7200,1,0,1560,920,360000,1999
1090,22080,1,0,1090,0,267500,1967
1480,32700,1,0,1380,100,290000,1942
2800,11325,1,0,1400,1400,850000,1970
1820,4500,1.5,0,1820,0,815000,1921
5840,11652,2,1,4410,1430,2.20E+06,1988
2980,3600,2,0,2150,830,1.63E+06,1999
1220,7300,1,0,1220,0,175000,1973
1830,9758,1,0,1300,530,429950,1977
2900,5505,2,0,2900,0,675000,2002
1940,5980,1,0,1520,420,580000,1987
1750,7800,1,0,1750,0,240000,1944
1850,17808,1,0,1210,640,374000,1982
3220,4400,2,2,2180,1040,862500,1937
1080,6052,1,0,1080,0,140000,1908
3990,18897,2,0,3090,900,740000,1937
920,3600,1,0,820,100,589000,1904
1290,9760,1,0,1290,0,275000,1979
2090,4196,2,0,2090,0,489900,2006
1900,3366,2,0,1900,0,545000,1996
1360,7132,1.5,0,1360,0,235000,1941
1000,4000,1.5,0,1000,0,230000,1915
2170,4080,2,0,1920,250,655000,1980
820,16030,1,0,820,0,185000,1923
1090,7400,1,0,1090,0,196000,1962
1830,7897,1,0,1290,540,572000,1986
3010,6903,2,0,3010,0,615000,2001
4150,17424,1,0,3130,1020,1.95E+06,1963
2930,4320,2,0,2130,800,1.23E+06,1913
1520,5649,2,0,1520,0,375000,1989
1250,9486,1,0,1250,0,295000,1971
2760,6000,2,0,2230,530,760000,1942
1330,7848,1,0,1330,0,347000,1978
1700,5100,1.5,0,1500,200,712000,1924
2050,4000,1.5,0,1210,840,495000,1941
3140,10437,1,0,2040,1100,925000,1959
2030,4080,1.5,0,1840,190,775000,1908
2100,7920,1.5,0,1400,700,429000,1916
1010,12705,1,0,1010,0,229000,1959
1980,113691,1,0,1980,0,400000,1962
2100,8290,2,0,2100,0,625000,1978
840,6654,1,0,840,0,130000,1951
1690,5080,1,0,1190,500,349000,1976
2140,26600,1,0,2140,0,365000,1983
1810,1988,2,0,1350,460,487500,1997
2600,7210,2,0,2600,0,475000,1989
1650,8400,1,0,1470,180,685000,1959
2460,4800,1,0,1230,1230,960000,1938
4320,7620,2,0,2880,1440,1.10E+06,1973
2600,15000,2,0,2600,0,428000,1978
1930,5790,2,0,1930,0,435000,1988
2190,5400,1,2,1260,930,769950,1952
1420,10980,1,0,1200,220,385000,1954
2090,3002,2,0,1670,420,352000,2005
2290,14374,2,0,2290,0,622500,1983
2470,11900,2,0,2290,180,660000,1976
840,8400,1,0,840,0,105000,1959
2100,4480,1,0,1400,700,420000,1908
1360,11250,1,0,1360,0,499950,1955
3420,22421,1,0,2270,1150,975000,1948
1930,2960,1.5,0,1490,440,665000,1929
2180,10140,1,0,1180,1000,540000,1968
1670,12056,1,0,1670,0,400000,1955
2720,6427,1,0,1650,1070,469950,2008
3170,9900,2,0,3170,0,777000,1979
1610,6300,1,0,1010,600,346500,1941
2370,4950,2,0,2370,0,685000,2003
2590,18980,1,0,2590,0,396500,1976
2850,7130,2,0,1990,860,783500,1980
1660,4800,1.5,0,1660,0,575000,1922
5550,12968,2,0,5550,0,1.50E+06,2005
2200,7620,1,0,1130,1070,515000,1942
2020,6628,1,0,1250,770,300000,1963
1760,9600,1,0,1760,0,272000,1966
1810,4970,2,0,1810,0,355000,2003
1310,8440,1,0,1310,0,223000,1951
3000,8584,2,0,3000,0,397000,2003
1080,5000,1,0,1080,0,460000,1923
2170,2738,1.5,0,1550,620,848000,1930
740,4275,1,0,740,0,392800,1924
5290,224442,2,0,4540,750,1.69E+06,1988
5290,224442,2,0,4540,750,1.80E+06,1988
2370,7878,2,0,2370,0,577000,1985
1890,3330,1.5,0,1390,500,570000,1901
1160,6134,1,0,1160,0,250000,1998
1550,7350,1.5,0,1550,0,645000,1958
3090,67082,2,0,3090,0,567500,1990
2610,5240,2,0,2610,0,337000,2004
1230,8250,1,0,1230,0,280000,1966
1280,5547,2,0,1280,0,167000,1985
1880,7560,1,0,940,940,280000,1919
1220,8409,1,0,1220,0,317500,1948
1350,1252,2,0,1120,230,405500,2006
2370,15336,2,0,2370,0,495000,1995
3040,11651,2,0,3040,0,691000,1987
2080,217800,1,0,2080,0,480000,1963
1560,4141,1,0,880,680,549010,1942
2980,5809,2,2,2980,0,750000,2005
870,5689,1,0,870,0,365000,1948
1660,10716,1,0,1100,560,412500,1988
1870,9000,1,0,1440,430,425000,1978
1410,9656,1,0,960,450,920000,1953
2180,8000,1,0,1630,550,340000,1975
2620,8960,1,0,1520,1100,405000,1955
2450,7051,1,0,1870,580,537100,1990
3250,4650,2,0,3250,0,353500,2007
1150,7080,1,0,1150,0,522000,1952
2780,6978,2,0,2780,0,710000,2001
1360,13320,1,0,1360,0,329950,1985
2810,14207,1,3,1540,1270,830000,1979
1780,11130,1,0,1780,0,800500,1962
1100,10125,1,0,1100,0,168500,1969
2230,5348,2,0,2230,0,490000,2000
1710,1904,2,0,1140,570,579000,2003
2620,9873,2,0,2620,0,600000,1987
1990,4725,1.5,0,1190,800,445000,1944
1450,8450,1,0,1450,0,362500,1960
1630,9010,1,0,1050,580,234000,1975
730,1942,1,0,730,0,321500,2008
1980,3300,1.5,0,1140,840,660000,1926
1730,36356,1.5,0,1730,0,319000,1954
1350,217852,1,0,1100,250,314000,1953
1410,5000,1,0,740,670,517950,1908
2360,10081,1,0,1180,1180,525000,1961
1190,8450,1,0,1190,0,319500,1961
3760,10920,1.5,0,2400,1360,1.58E+06,1950
1220,12426,1,4,1220,0,325000,1946
2920,32219,2,0,2920,0,795000,1995
1590,5136,1.5,3,1320,270,850000,1927
3510,10930,2,0,3510,0,1.01E+06,2013
1320,1310,3,0,1320,0,475000,2006
1610,11250,1,0,1090,520,375000,1975
1410,8053,1,0,1410,0,405000,1951
2170,10500,1,0,1570,600,420000,1962
1890,4800,1.5,0,1390,500,775000,1906
3260,5000,2,0,3260,0,800000,2007
2080,12714,2,0,1540,540,436800,1984
2040,4005,1.5,0,1740,300,620000,1930
1250,9035,1,0,1250,0,230000,1970
850,8050,1,0,850,0,165000,1906
850,8050,1,0,850,0,490000,1906
1600,8400,1,0,1600,0,480000,1963
2400,6975,2,0,2400,0,570000,1993
1870,4894,2,0,1750,120,615000,1992
1720,9605,1,0,860,860,280000,1969
1030,9834,1,0,1030,0,326000,1969
1190,1499,2,0,1100,90,550700,2004
910,2002,1.5,0,910,0,600000,1900
1290,47044,1,0,1150,140,450000,1968
1530,1324,2,0,1280,250,546000,2010
2330,33750,2,0,2330,0,585000,1983
2090,7667,1,2,1200,890,489000,1952
1570,7000,2,2,1050,520,765000,1971
1560,26099,1,3,1560,0,519000,1973
1500,4120,1.5,0,880,620,262000,1928
2160,5005,1,0,1430,730,550000,1987
780,5000,1,0,780,0,285000,1943
2340,17541,1,0,1360,980,476000,1956
3570,30456,1,1,2070,1500,2.20E+06,1946
720,5100,1,0,720,0,335000,1907
2990,102366,1,0,2990,0,510000,1974
1860,13939,1,0,1860,0,291000,1961
1950,13440,1.5,0,1950,0,335000,1931
1860,9003,1,0,1490,370,415000,1955
1550,6039,1,0,830,720,430000,1942
1610,6205,1,0,1210,400,270000,1979
1810,4500,1,0,980,830,760000,1906
1730,4248,2,0,1730,0,450000,1905
1230,23522,1,0,1230,0,425000,1978
2130,3420,1.5,0,1730,400,725000,1916
2190,11060,1,0,1610,580,700000,1973
4130,10404,2,0,4130,0,998000,2004
1680,9766,2,0,1680,0,396000,1989
1480,8381,1,0,1480,0,547000,1968
1790,10200,1,0,1210,580,302000,1963
2810,2700,2,0,1900,910,999000,1910
2360,10000,1,3,1980,380,633000,1977
1460,7361,1,0,1460,0,265800,1982
2160,8114,1,0,1460,700,530000,1960
2610,9132,1,0,1320,1290,605000,1965
2170,4587,2,0,2170,0,489000,2006
2160,12960,1,0,1360,800,305000,1968
2020,7070,1,0,1010,1010,513000,1958
2980,5000,2,0,2980,0,765000,2006
1300,2970,1,0,990,310,550000,1903
3090,10730,2,0,2420,670,974350,1985
2280,7229,2,0,2280,0,653675,1984
1260,8614,1,0,1260,0,245000,1985
1530,4387,1,0,1020,510,700180,1952
1830,8133,1,0,1390,440,510000,1996
1610,10292,1,0,1190,420,390000,1969
2170,5500,2,0,2170,0,606500,2000
5020,26319,2,0,5020,0,1.50E+06,1998
1620,7772,2,0,1620,0,290000,1988
1080,7942,1,0,1080,0,115000,1981
1940,37565,1,0,1940,0,500000,1987
844,4269,1,0,844,0,139950,1913
2360,4638,2,3,2360,0,580050,1996
2010,2261,2,0,1390,620,550000,2014
800,3060,1.5,0,800,0,465000,1903
970,5922,1.5,0,970,0,354950,1949
3720,7150,2,2,3720,0,980000,2007
2010,7447,2,0,2010,0,500000,1985
1430,4080,1.5,0,1430,0,667750,1924
2250,11520,1,1,2250,0,735000,1956
2130,8742,1,3,1330,800,361000,1955
1620,12482,1,0,1290,330,276750,1989
3140,3680,2,0,2310,830,760000,2009
870,7975,1,2,870,0,475000,1946
1820,8217,1,0,1120,700,234000,1987
1510,9153,1,0,1510,0,234950,1974
1320,7540,1,0,1320,0,269950,1968
1800,7318,2,0,1800,0,495000,1989
1120,6380,1,0,1120,0,438000,1942
2160,22702,1,0,2160,0,260000,1981
3220,6399,2,0,3220,0,697000,2004
960,5000,1,0,960,0,212625,1951
2640,4400,1.5,0,1840,800,593000,1925
2430,7243,2,0,2430,0,410000,2003
1470,7137,1,0,1020,450,445434,1941
2040,15463,1,0,1340,700,200126,1968
1670,6666,2,0,1670,0,290700,1992
1010,7515,1,0,1010,0,248000,1955
540,10125,1,0,540,0,345000,1961
1240,4800,1,0,800,440,525000,1951
1510,8385,1,0,1510,0,400000,1968
1820,5750,1,0,1120,700,532000,1918
1000,5026,1,0,760,240,159995,1915
2040,11772,1,0,1030,1010,287000,1963
3690,11191,1,3,2190,1500,1.12E+06,1951
2310,11993,2,0,2310,0,765000,1988
1090,9605,1,0,1090,0,185000,1969
1150,3000,1,0,1150,0,430000,1906
2100,3916,2,0,2100,0,346000,2009
2150,16728,1,0,1240,910,607000,1982
2500,6000,1.5,0,1730,770,417000,1941
3530,9385,1.5,0,3530,0,930000,1925
1290,6600,1,2,870,420,573300,1951
2010,10816,1,0,1410,600,260000,1955
420,6720,1,0,420,0,280000,1922
2180,4000,2,0,2180,0,825000,1920
1150,8184,1.5,0,1150,0,307000,1947
2000,5100,1,0,1130,870,595000,1949
2780,7786,1,0,1390,1390,528000,1966
1550,7764,1,4,1550,0,600000,1965
2180,12875,1,0,1480,700,275000,1959
1570,3600,1.5,2,1320,250,782000,1906
2260,33042,1,0,1660,600,610000,1986
1600,3200,1.5,0,1600,0,488000,1909
1630,5000,1,0,930,700,320000,1954
890,4810,1,0,890,0,153500,1910
1350,9450,1,0,1350,0,414500,1979
2850,11860,1,0,2850,0,750000,1951
1350,165092,1,3,1350,0,349990,1925
3280,79279,1,0,3280,0,645000,2001
1090,6000,1,0,1090,0,425000,1922
2990,9374,2,0,2990,0,785000,2003
1340,63597,1,0,1340,0,290000,1963
1340,63597,1,0,1340,0,415000,1963
720,5160,1,0,720,0,248500,1949
2330,8627,1,0,1480,850,325000,1980
1280,5728,1.5,0,1280,0,272925,1941
1570,1269,2,0,1280,290,500000,2015
1510,5500,1.5,0,1510,0,250000,1920
2470,8536,2,0,2470,0,470000,2002
1190,3400,1,0,990,200,440000,1917
1981,4828,2,0,1981,0,299999,2013
1590,7810,1,0,1590,0,255000,1959
1150,7700,1,0,1150,0,415950,1957
2160,7200,1.5,0,1220,940,402000,1955
1770,30689,1,4,1770,0,729000,1953
2470,8840,2,0,1780,690,635000,2001
1710,8998,2,0,1710,0,479000,1982
1860,2670,2,0,1860,0,462370,1986
1150,6480,1.5,0,1150,0,171500,1946
3850,9457,2,0,2910,940,925000,1963
3410,9600,1,0,1870,1540,675000,1968
1890,43560,1,0,1890,0,320000,1974
3200,43560,2,0,3200,0,499950,1989
2170,65340,1.5,0,1670,500,435000,1930
2390,6426,2,0,2390,0,359800,1999
1410,7566,1,0,1410,0,239900,1985
740,4459,1,2,740,0,295000,1915
2150,25705,1.5,0,2150,0,380000,1980
2180,6500,2,0,1410,770,435000,1945
820,5040,1,0,820,0,508000,1953
5480,10800,2,3,4430,1050,2.40E+06,1999
1960,7875,1,0,1220,740,234500,1978
1270,3200,1,0,960,310,355000,1920
1710,5200,1,0,1030,680,230000,1977
1930,9000,1,1,1150,780,345000,1951
1200,4500,1,0,1200,0,430000,1906
1680,17409,1,0,1680,0,500000,1962
1300,6075,1,0,1300,0,378000,1954
1540,3237,2,0,1540,0,345000,1999
870,4000,1,0,870,0,410000,1941
1890,5400,2,0,1610,280,750000,1905
2050,8913,1,0,1330,720,485000,1968
880,18109,1,0,880,0,105000,1970
2780,4000,2,2,1960,820,1.03E+06,1904
1160,10988,1,0,1160,0,360000,1965
2300,7600,1,0,1400,900,294000,1969
3140,12792,2,0,3140,0,400000,1977
2300,6200,1,0,1150,1150,325000,1970
2900,23550,1,0,1490,1410,770000,1987
1920,8223,2,0,1920,0,443000,1989
1150,7486,1,0,1150,0,325000,1970
3120,8792,2,0,3120,0,760000,1992
2560,7798,1,0,1890,670,640000,1947
1410,4303,1.5,0,1410,0,415000,1900
970,8580,1,0,970,0,156000,1959
3620,8131,2,0,2730,890,996000,1988
880,5100,1,0,880,0,415000,1941
1900,3783,1.5,0,1110,790,615000,1927
2540,4241,2,0,2540,0,717000,2009
1690,7794,1,0,1090,600,548000,1968
1120,6653,1,0,1120,0,425000,1937
2130,9339,1,0,1330,800,325250,1991
3420,79279,2,0,3420,0,1.23E+06,1990
1900,11165,1,0,1900,0,557500,1959
3730,16950,2,0,3730,0,1.26E+06,1990
1790,2003,2,0,1480,310,249950,2006
2250,7345,1,0,1320,930,260000,1984
2880,13500,1,4,1520,1360,1.99E+06,1950
1780,2788,1,0,890,890,442900,1943
1580,12177,1,0,1200,380,475000,1981
3260,9253,2,0,3260,0,365000,2004
3180,9603,2,2,3180,0,780000,2002
2460,4240,1,0,1230,1230,930000,1925
8670,64033,2,4,6120,2550,2.89E+06,1965
1020,4980,1,0,850,170,350000,1941
1630,9403,1,0,1630,0,357500,1983
3290,11446,2,0,3290,0,520000,1992
1940,3784,2,0,1940,0,330000,2003
1350,11150,1,0,1110,240,310000,1995
1110,6060,1,0,1110,0,279000,1949
2993,19400,2,0,2233,760,540000,1921
2280,7200,2,0,2280,0,322000,1994
3800,15500,1,0,2490,1310,380000,1965
850,8400,1,0,850,0,320000,1941
1560,8456,1,0,1560,0,400000,1970
1000,3844,1,0,900,100,412000,1928
1400,5100,1.5,0,1400,0,887200,1900
1540,5120,1,0,770,770,395000,1943
3570,10273,1.5,3,2630,940,895000,1935
800,5280,1,0,800,0,195000,1918
1160,3750,1.5,0,1160,0,390000,1910
1010,7690,1,0,1010,0,165000,1958
1010,7690,1,0,1010,0,255000,1958
2390,57599,2,0,2390,0,589000,1981
1610,4611,2,0,1610,0,505000,1996
2400,7260,1,0,1440,960,335750,1955
1800,5816,1,0,900,900,719000,1947
2110,3000,2,0,2110,0,796000,2001
960,7000,1,0,960,0,95000,1918
2600,5238,1.5,3,1890,710,525000,1989
1340,10224,1,0,1340,0,417000,1956
1410,5000,1,0,980,430,410000,1925
2390,12292,1,0,2390,0,984000,1962
1180,834,3,0,1180,0,325000,2009
1040,16986,1,0,1040,0,314950,1968
1840,9929,1,0,1200,640,350000,1987
2630,4000,2,0,1810,820,1.05E+06,1909
2640,25038,2,0,2640,0,657000,1995
1720,3132,2,0,1720,0,234950,1999
2320,7500,1,0,1220,1100,410000,1955
1840,5664,2,0,1270,570,625000,1948
2890,15891,2,0,2890,0,706000,1990
2200,7706,2,2,2200,0,485000,1908
1660,5150,1.5,0,1280,380,685000,1928
2170,9900,1,0,1690,480,242050,1980
3310,5000,2,0,3310,0,770000,2006
1450,3840,1,0,950,500,557000,1947
1440,11325,1,0,1440,0,246000,1966
1760,7700,1,0,1760,0,194000,1962
3170,7187,2,0,3170,0,720000,2005
1250,4576,1,0,1040,210,449000,1925
3280,209088,2,0,3280,0,925000,1994
2460,10401,1,0,1700,760,570000,1947
1470,10125,1,0,1470,0,395000,1962
1780,15648,1.5,0,1780,0,1.00E+06,1918
1580,8475,1.5,2,1580,0,406000,1928
1630,2946,1.5,0,1630,0,574800,1932
2240,9240,1,0,1120,1120,309000,1968
2430,54059,2,0,2430,0,770000,1987
1940,5625,1,0,1440,500,525000,1941
1970,4058,2,0,1970,0,419000,2004
2050,6705,1,0,1230,820,479000,1973
1340,18552,1.5,0,1340,0,160000,1935
1880,9880,1,0,1880,0,333000,1967
860,12160,1,0,860,0,310000,1921
2140,2868,2,0,1770,370,666000,2007
3620,28064,2,4,2370,1250,2.23E+06,1977
2370,7320,2,0,2370,0,310000,1989
1860,21876,2,0,1860,0,350000,1992
2110,5000,1.5,2,1640,470,610000,1930
1990,8501,2,0,1990,0,564800,1991
1820,9150,1,0,1320,500,438000,1961
3120,9400,1,0,1820,1300,855000,1978
1190,3000,2,0,1190,0,229000,2002
1170,5450,1,0,1170,0,260000,1902
2630,10131,2,0,2630,0,609000,1989
1450,6250,1,0,990,460,277000,1964
2100,8160,1,0,1200,900,283000,1959
1680,8367,1,0,840,840,334000,1914
2000,7350,1,0,1100,900,267000,1963
1030,3000,1,0,830,200,385000,1924
2020,6565,1,0,1120,900,640000,1956
2220,23750,1,0,2220,0,532500,1963
1750,8476,1,0,1240,510,335000,1983
1710,4920,2,0,1710,0,415000,1990
3560,107362,1.5,0,2760,800,1.10E+06,1963
2720,16637,1,3,2160,560,1.44E+06,1953
1010,10215,1,0,1010,0,180000,1955
1830,4500,2,0,1830,0,335000,2004
4480,42717,2,0,4480,0,835000,1987
2080,4400,1.5,0,2080,0,592500,1925
1470,11112,1,0,1470,0,418900,1954
1600,7324,1,0,1600,0,340000,1958
1340,7200,1.5,0,1340,0,545000,1923
3680,8680,2,0,3680,0,1.38E+06,2003
1770,3451,2,0,1770,0,183750,2004
980,10640,1,0,980,0,295000,1978
2530,5625,1,0,1470,1060,625000,1976
2390,4500,2,0,2390,0,290000,1974
3600,155509,2,0,3600,0,760000,2004
3270,24750,1,0,1690,1580,560000,1979
2300,28480,2,0,2300,0,475000,1994
1710,4050,1.5,0,1710,0,620000,1909
1170,4000,1,0,1170,0,330000,1955
1990,6256,1,0,1390,600,620000,1960
1710,10480,1.5,0,1710,0,320000,1969
1740,2350,2,0,1120,620,525000,1996
3320,8030,2,0,3320,0,802500,2005
1960,3194,2,0,1960,0,569500,1907
2820,5400,1,0,1620,1200,850000,1958
1590,4080,1.5,0,1590,0,630000,1922
2490,10720,1,1,1400,1090,454800,1979
870,5200,1,0,870,0,177000,1969
1860,15681,1,0,1860,0,275000,1971
2930,29136,2,0,2240,690,460000,1990
1580,3840,2,0,1580,0,729000,1908
4110,15488,2,2,4110,0,935000,1995
1410,4800,1,0,1410,0,481450,1940
2090,4190,1.5,0,1490,600,860000,1930
1400,8364,1,0,1400,0,274000,1958
1690,1432,2,0,1360,330,499000,2008
3210,61419,1.5,0,3210,0,696500,1979
1190,85226,1.5,0,1190,0,390000,1935
960,9748,1,0,960,0,265000,1922
2380,17199,2,0,1530,850,470000,1979
1020,7742,1,0,1020,0,168500,1935
1290,8250,1,0,1290,0,220000,1983
1830,17321,1,0,1100,730,295000,1948
4770,31570,2,0,4770,0,1.48E+06,1990
2910,19449,2,4,1940,970,1.30E+06,1985
950,10723,1,0,950,0,285000,1959
1160,8950,1,0,1160,0,294950,1968
4930,22093,2,3,4930,0,1.47E+06,2004
1780,5850,1,0,980,800,565500,1944
1410,10625,1,0,1410,0,230000,1980
2700,443440,1.5,0,2700,0,569950,1948
1790,4250,1,0,920,870,721000,1915
4040,8653,2,0,2900,1140,565000,2006
1990,9885,1,0,1030,960,438000,1978
2150,19127,1,0,1650,500,369900,1978
1850,9136,2,0,1850,0,405000,1997
1680,15711,1,0,1240,440,282000,1994
1430,7819,1,0,1110,320,380950,1944
960,8855,1,0,960,0,349810,1958
2700,8810,2,0,2700,0,690000,2004
1290,5141,1,0,1050,240,653000,1947
1860,43170,2,0,1860,0,526500,1986
4320,8490,2,0,3280,1040,1.04E+06,2005
2130,3825,1.5,0,2130,0,335000,1917
2870,102366,2,2,1770,1100,570000,1994
3740,11340,2,0,3740,0,1.08E+06,2013
2130,8022,2,0,2130,0,475000,1985
1210,4250,1,0,1210,0,315000,1941
2800,29985,1,0,1400,1400,405000,1954
3040,8111,2,0,3040,0,562000,1984
1570,6932,2,0,1570,0,295000,1993
2090,15000,1,0,2090,0,383000,1961
1690,7292,1,0,1250,440,242000,1985
1470,17577,1,0,1470,0,352500,1967
1460,6000,1,0,730,730,239950,1941
3030,6820,2,0,2530,500,998000,1947
1190,4500,1,0,1190,0,515000,1922
1840,6710,1.5,0,1840,0,590000,1920
3560,13959,2,0,3560,0,1.16E+06,1972
1580,9750,1,0,1580,0,289000,1954
1230,7200,1,0,1230,0,424000,1953
1440,9477,1,0,1440,0,199000,1943
4420,7902,2,0,3350,1070,730000,2004
910,5250,1,0,910,0,244000,1971
670,10920,1,0,670,0,240000,1942
2650,8610,2,0,2650,0,797000,1959
2220,6953,2,0,2220,0,350000,1999
1640,6435,1,0,1190,450,415000,1972
770,5185,1,0,770,0,378510,1947
3960,6654,2,0,2850,1110,1.20E+06,2006
1140,7620,1,0,1140,0,379900,1925
2480,9041,2,0,2480,0,620000,2004
1580,3172,1,0,900,680,524500,1946
1990,7252,1,0,1270,720,270000,1999
1830,9485,1,0,1200,630,236000,1989
840,14564,1.5,0,840,0,308500,1942
3320,11350,1,0,1660,1660,989900,1963
2050,26000,2,0,2050,0,299000,1977
1560,43748,2,0,1560,0,295000,1967
800,15000,1,0,800,0,110000,1927
1190,6200,1,0,1190,0,295950,1948
1300,4127,1,0,650,650,270000,1918
3400,247421,2,0,3400,0,712000,2001
1170,1250,3,0,1170,0,475000,2000
2510,5258,2,0,2510,0,410000,2001
2510,19550,1,0,1810,700,588000,1977
2390,3903,2,0,1970,420,420000,2006
2200,3404,2,0,2200,0,355000,2005
2550,21675,1,1,1610,940,446000,1958
2560,12100,1,0,1760,800,765000,1976
3250,5797,2,2,2370,880,967500,1951
1340,4447,1,0,1340,0,381000,2004
2840,107157,2,0,2840,0,490000,1983
2480,9780,1,0,1900,580,716000,1975
3060,8862,2,0,3060,0,605000,1989
2910,8596,2,0,2910,0,312200,2004
1900,9000,1,0,1290,610,327000,1948
1300,21000,1,0,1300,0,229950,1969
1480,7000,1,0,1000,480,160000,1980
1250,9472,1,0,1250,0,255000,1972
2000,4700,1.5,0,1220,780,530000,1944
1330,6540,1,0,900,430,239000,1971
1840,6214,1,0,1270,570,285000,1983
1560,7104,1.5,0,1140,420,537000,1945
3150,21893,2,0,3150,0,530000,2006
1560,6013,2,0,1560,0,213675,1990
2910,9636,1,0,1690,1220,530000,1964
2940,15875,2,0,2940,0,780000,1994
950,3621,1,0,950,0,390000,1947
1200,4000,1,0,1070,130,450000,1940
1000,5375,1,0,1000,0,420000,1953
1490,3880,1,0,1490,0,550000,1959
600,6120,1,0,600,0,110000,1943
2320,5500,1.5,2,1720,600,700000,1925
3190,24170,2,0,3190,0,807500,2002
990,8760,1,0,990,0,179000,1977
5470,18200,2,4,3730,1740,1.61E+06,1992
2890,46609,2,0,2890,0,655000,1981
1790,6800,1,0,1240,550,472500,1964
2350,6958,2,0,2350,0,299000,1998
3430,10157,2,0,3430,0,740000,2000
2600,15064,1,0,1700,900,860000,1967
2130,6325,1,0,1440,690,620000,1948
1660,5987,1,0,960,700,410000,1982
2473,9282,2,1,2473,0,343000,1963
1430,1425,2,0,995,435,465000,2006
1570,3109,2,0,1570,0,273950,2002
1240,42247,1,1,1240,0,825000,1915
1720,6200,2,0,1720,0,255000,2014
1140,11161,1,0,1140,0,250000,1998
2690,7200,2,3,1720,970,635000,1978
1520,9600,1,0,1520,0,240000,1966
2040,7031,2,0,2040,0,670000,2012
2830,6000,1,3,1730,1100,713414,1954
1340,7391,1,0,1340,0,245000,1966
2520,10850,1,0,1680,840,600000,1968
1660,5550,2,0,1660,0,270000,2002
880,6900,1,0,880,0,190000,1943
980,5000,1,0,980,0,435000,1940
1360,5814,1.5,0,1360,0,560000,1900
3710,34412,2,0,2910,800,998000,1978
940,8377,1,0,940,0,725000,1952
970,8874,1,0,970,0,210000,1968
1500,1312,3,0,1500,0,513000,2007
2780,9652,1,0,1390,1390,290000,1967
3110,9930,1,1,1640,1470,1.26E+06,1954
1860,11227,2,0,1860,0,330000,1995
1010,7560,1,0,1010,0,189000,1958
2850,6281,2,2,1900,950,907500,1947
2280,200811,1,0,2280,0,410000,1978
3080,10757,2,3,3080,0,1.05E+06,1961
2280,14290,1.5,0,1510,770,622100,1942
2030,14400,1,0,1310,720,250000,1969
2570,4000,2,0,1750,820,1.18E+06,1909
3640,10300,1,0,2060,1580,925000,1979
1760,4046,1,0,960,800,554000,1931
2760,17377,2,0,2760,0,545000,2002
2650,11250,2,0,2650,0,660000,2005
5160,44315,2,0,5160,0,1.90E+06,1996
1480,8625,1,0,1480,0,260000,1974
860,6664,1,0,860,0,219900,1944
2610,4978,2,0,2610,0,373500,2004
1470,81021,1,0,1470,0,380000,1949
4570,16015,2,2,4570,0,1.06E+06,1990
3410,16015,2,4,2220,1190,2.60E+06,1973
1760,10013,2,0,1760,0,450000,1983
2040,12065,1,0,2040,0,379950,1987
3470,4171,3,0,3470,0,834800,2008
680,4800,1,0,680,0,365000,1917
1494,19271,2,4,1494,0,465000,1943
1250,4000,1,0,1250,0,452000,1955
3570,6250,2,2,2710,860,840000,1985
2000,6250,1.5,0,1480,520,465000,1930
2030,4867,2,0,2030,0,295000,2003
1390,6160,1,0,1390,0,396000,1949
1030,12350,1.5,0,1030,0,397000,1942
1280,9000,1.5,0,1280,0,240000,1954
2370,6840,2,0,2370,0,300523,1987
1380,9000,2,0,1380,0,215500,1946
2320,7229,1,0,1370,950,552500,1986
2050,9360,1,0,1520,530,375000,1968
1210,103237,1,0,1210,0,160000,1918
3270,35445,2,0,3270,0,1.07E+06,1989
2450,4400,2,0,1800,650,952000,1922
1890,5000,1.5,0,1090,800,523460,1906
2007,4968,2,0,2007,0,305950,2009
1430,9044,2,0,1430,0,220000,1991
2056,52333,1,0,1048,1008,289000,1980
2210,10772,1,2,1430,780,648000,1964
2330,6000,1.5,0,2080,250,825000,1937
2070,10800,2,0,2070,0,400000,1982
1480,1369,3,0,1480,0,420000,2009
1160,4848,2,1,1160,0,389000,1949
2520,4950,2,0,2520,0,865000,1906
1770,16660,1,3,1220,550,345000,1957
3110,123710,2,0,2430,680,700000,1995
1680,10455,2,0,1680,0,550000,1982
1320,5000,1.5,0,1320,0,201500,1912
1320,5000,1.5,0,1320,0,459000,1912
1810,7350,1,0,1310,500,327000,1984
1140,6700,1.5,0,1140,0,540000,1920
4600,19831,1,3,2300,2300,805000,1956
1840,6000,1,0,1840,0,521000,1908
2000,7294,1,0,1520,480,375000,1965
1480,6592,1,0,1080,400,235000,1978
2040,11841,2,0,2040,0,240000,1994
2060,12155,1,0,2060,0,575000,1968
3720,11690,2,0,3720,0,1.52E+06,2003
3002,6042,2,0,3002,0,394500,2004
1060,5200,1,0,1060,0,174950,1970
1830,21183,1,0,1060,770,383000,1966
1550,15040,1,0,1550,0,249950,1958
1690,2752,2,0,1690,0,431000,1979
2580,11000,1,0,1290,1290,459900,1951
2510,8050,1,0,1490,1020,475000,1977
1290,2500,2,0,1290,0,605000,1987
1450,7560,1,0,1450,0,234950,1967
2690,7947,2,0,2690,0,419000,1993
3340,10890,1.5,0,2240,1100,910000,1963
2600,8921,2,0,2600,0,392000,1991
3140,9808,2,0,2500,640,915000,2001
3800,13995,2,3,3800,0,630000,1983
2320,5490,1,3,1160,1160,416100,1956
2360,7350,1,0,1440,920,285000,1965
1100,9600,1,0,1100,0,353000,1960
1390,5127,1,0,1390,0,297950,1990
2180,21392,2,0,2180,0,750000,1934
1730,1074,3.5,0,1730,0,525000,2006
2760,18112,1,0,1510,1250,495000,1968
2430,11448,1,1,1620,810,710000,1949
2010,12950,1,0,2010,0,310000,1953
1730,5200,1,0,1050,680,205000,1978
2450,211266,1.5,3,2450,0,530000,2004
3300,28433,2,0,3300,0,725000,1998
720,9520,1,0,720,0,195000,1947
1240,11172,1,0,1000,240,401000,1984
3050,8200,1,4,1650,1400,1.03E+06,1962
1590,21600,1.5,0,1590,0,251000,1971
2040,4841,1,0,1020,1020,667500,1949
1840,5550,2,0,1840,0,300000,2004
1960,9021,2,0,1960,0,610000,1973
4110,43560,2,0,4110,0,1.04E+06,1978
1830,19965,1,0,1400,430,430000,1976
1330,92782,1,0,1330,0,455000,1950
2190,9072,1,0,1110,1080,600000,1965
1720,1587,2.5,2,1410,310,638000,2004
1710,5000,1,0,1360,350,561000,1918
2180,5000,1,0,1240,940,625000,1977
1700,11613,1,0,1180,520,263950,1977
2960,9350,2,2,2960,0,740000,1978
1330,8912,1,0,1330,0,234999,1948
1940,3200,2,0,1940,0,380000,2004
1500,9656,1,0,1170,330,329500,1989
2230,64438,1,0,1230,1000,464950,1978
1700,9008,1,0,1340,360,500000,1985
1840,11367,1.5,0,1840,0,415000,1950
2100,205603,2,0,2100,0,437500,1983
2580,5750,1,0,1880,700,599000,1901
2350,8182,2,0,2350,0,367000,1997
760,3000,1,0,760,0,530000,1922
3280,4000,2,0,2440,840,989000,2003
1320,4000,1,0,1020,300,462600,1940
1690,10592,1,0,1690,0,875000,1973
2060,47318,1,2,1600,460,335000,1976
1450,5456,1,0,1450,0,393000,1951
2760,4905,2,1,1840,920,1.34E+06,1938
2830,5788,2,0,2830,0,590000,2001
1890,1475,2,0,1200,690,671000,2015
2610,4500,1.5,0,1660,950,925000,1909
1900,7250,1,0,1250,650,245000,1967
930,6572,1,0,930,0,392500,1952
2730,12000,1,0,1410,1320,505000,1998
2650,6240,2,0,2650,0,702000,2013
1010,4000,1,0,1010,0,337000,1947
3550,10233,2,0,3550,0,920000,1996
2130,6360,1,0,1720,410,495500,1959
1840,7230,1,0,1570,270,245000,1938
1320,1824,1.5,0,1320,0,395000,1909
990,6315,1,0,990,0,335000,1970
1020,10346,1,0,1020,0,187000,1983
1570,7320,1,0,1570,0,450000,1960
1930,7207,1,0,1360,570,280000,1988
3760,22763,1,3,1910,1850,1.38E+06,1969
1000,31505,1,0,1000,0,265000,1960
1930,9600,1,0,1930,0,795000,1958
2240,3800,2,0,1370,870,510000,1929
2190,11500,1,0,1430,760,699900,1972
2400,12469,1,2,1760,640,839000,1958
1970,12409,1,0,1220,750,396000,1968
2860,8458,2,0,2860,0,365000,1983
1900,7225,1,0,1220,680,440000,1970
2090,6667,2,0,2090,0,405000,1997
850,2500,1,0,850,0,295000,1986
1840,1562,2,0,1400,440,275000,2004
820,288367,1,0,820,0,295000,1930
4370,12240,2,0,3270,1100,1.50E+06,1990
3190,10223,2,0,2560,630,795000,1994
3480,36615,2,0,2490,990,650000,1983
1690,13184,1,0,1690,0,260000,1959
1650,2710,2,2,1650,0,382000,2008
2590,9341,2,0,2590,0,790100,1985
2160,8005,2,0,2160,0,220000,1993
3500,8547,2,0,2500,1000,799000,1994
3920,7200,2,0,3120,800,1.48E+06,1928
2190,14937,2,0,2190,0,367300,1993
1890,4500,1.5,0,1490,400,805000,1907
1860,3400,1,0,1010,850,730000,1920
1720,7704,1,0,1160,560,402000,1969
2600,4674,1,0,1560,1040,750000,1976
1570,12196,1,0,1570,0,458000,1972
3530,9753,2,0,3530,0,898000,1997
1960,5642,2,0,1960,0,308000,1998
2230,8296,2,0,2230,0,385000,2004
2720,4800,1.5,0,1790,930,1.02E+06,1928
2840,6240,2,0,2440,400,1.43E+06,1905
1260,7362,1,0,1260,0,240000,1984
1860,8505,1,0,1860,0,217000,1967
2010,6300,1,2,1610,400,972000,1937
820,6400,1,0,820,0,361280,1944
1220,1450,1,0,620,600,385000,1905
2220,60984,2,0,2220,0,475000,1987
2860,3638,1.5,2,1720,1140,724950,1924
4230,9701,2,0,4230,0,935000,1999
840,8470,1,0,840,0,169950,1961
2290,5089,2,0,2290,0,585000,2001
2290,5089,2,0,2290,0,585000,2001
3480,12821,2,2,2890,590,480000,2004
4260,36360,1.5,0,4100,160,635000,1935
2230,5717,2,0,2230,0,368750,2004
3080,5500,2,0,3080,0,432500,1900
2250,4337,2,0,2250,0,589000,2004
3160,6327,2,0,2280,880,840000,2004
1770,3873,2,0,1770,0,316500,2005
2880,8833,2,0,2880,0,536000,2006
2690,25000,1,0,1750,940,563750,1978
1730,7350,1.5,0,1730,0,152500,1970
1730,7350,1.5,0,1730,0,267950,1970
4780,118047,2,0,4780,0,1.64E+06,1994
2540,8400,2,0,2540,0,269950,1977
2630,5772,2,0,2630,0,731688,2006
1890,9000,1,0,1190,700,240000,1959
1220,5040,1,0,1220,0,555950,1961
710,6300,1,0,710,0,289000,1942
2970,11985,1,0,1770,1200,525000,1995
2970,11985,1,0,1770,1200,745000,1995
1000,7664,1,2,1000,0,397000,1939
1980,8505,1,0,1030,950,233000,1965
1920,8259,2,0,1920,0,625000,1979
2740,23505,2,4,2740,0,535000,1988
1740,7345,1,0,1380,360,270000,1973
1300,7770,1,0,1300,0,360000,1967
2740,4000,2,0,1930,810,1.11E+06,1905
4060,4000,2,3,2890,1170,970000,1953
3490,18850,1,4,1840,1650,915000,1958
1430,10500,1,0,1130,300,412000,1960
1860,9112,1,0,1110,750,265000,1963
2120,7700,1,0,1490,630,426000,1976
1860,12693,1,0,1140,720,266000,1978
2330,4950,1.5,0,1430,900,325000,1900
1670,5100,1,2,990,680,615000,1954
2130,7140,1,0,1580,550,310000,1979
1900,7313,1,0,1900,0,340000,1973
1170,2800,1.5,0,1170,0,562500,1905
980,1600,2,0,980,0,447000,2010
4670,23115,2,2,4670,0,2.45E+06,1992
2500,6300,1,0,1500,1000,250000,1961
2020,8044,2,0,2020,0,633000,1990
1290,886,3,0,1290,0,310000,2004
1620,113862,1.5,0,1620,0,439000,1995
1710,2381,2,0,1360,350,470000,2003
1720,8550,1,0,1720,0,270000,1968
1820,8813,2,0,1820,0,299500,1994
1130,10018,1,0,1130,0,227000,1954
3040,2415,2,4,3040,0,735000,1966
2410,7479,2,2,2410,0,537000,1942
2440,14470,1,0,1660,780,699000,1970
800,4533,1,0,600,200,330000,1929
1030,7800,1,0,1030,0,229000,1954
1480,5600,1,0,940,540,200000,1947
1710,9707,1,0,1710,0,522500,1966
3450,5350,1.5,3,2590,860,1.30E+06,1925
2610,16387,2,4,2610,0,2.00E+06,2006
780,55764,1,0,780,0,200000,1945
1260,7200,1,0,1260,0,352000,1971
2590,6250,2,2,2240,350,855000,1964
1580,12250,2,0,1580,0,267000,1993
1660,6000,1,0,1160,500,484000,1942
2950,15540,1,0,2120,830,402000,1974
2240,5000,2,0,1770,470,905000,1900
1940,7500,1,0,1720,220,274000,1966
1850,26445,1,0,1850,0,475000,1962
5770,10050,1,3,3160,2610,1.54E+06,1949
2280,6010,1,0,1140,1140,628000,1900
2740,6360,1,3,1370,1370,675000,1953
3760,4675,2,0,2740,1020,429900,2007
1580,8184,1,0,1140,440,260000,1954
1600,4400,1,0,1030,570,690000,1941
2100,12172,1,0,2100,0,1.08E+06,1961
2610,7333,2,0,2610,0,360000,1988
1840,5000,1,0,920,920,499000,1910
1320,6534,1,0,1320,0,159000,1952
1540,8100,1,0,940,600,430000,1947
2520,18625,1,0,1660,860,1.05E+06,1959
3780,20000,1,1,1890,1890,725000,1978
1200,9527,1,0,1200,0,150000,1959
2720,8712,2,0,2720,0,840000,1976
3100,5700,2,0,3100,0,499000,2011
1630,4000,1,0,1100,530,285000,1968
1910,7201,1,0,1210,700,340000,1987
1580,7300,1,0,1580,0,405100,1955
1690,4898,2,0,1690,0,464000,2003
1960,8680,1,0,1290,670,723000,1959
4300,10441,2,0,2800,1500,430000,1979
1840,4255,1,0,940,900,645000,1907
3480,19991,2,2,2630,850,1.58E+06,1979
2710,4200,2,0,1890,820,925000,1919
2100,4750,1,0,1340,760,759000,1975
1760,7800,1,0,1760,0,690000,1954
2155,8140,2,0,2155,0,358800,1996
1720,4000,1.5,0,1520,200,683000,1925
1430,4240,1.5,0,1430,0,650000,1924
2790,4807,1.5,0,2140,650,288000,1949
1180,7300,1,0,1180,0,209950,1968
2450,9248,2,4,1960,490,939000,1933
1330,5850,1,0,930,400,320000,1954
1940,9560,2,0,1940,0,283748,1989
1600,7620,1,0,1280,320,370000,1987
3210,41689,1,0,1610,1600,399950,1989
2880,6902,1,0,1680,1200,360000,1976
1160,8060,1,0,1160,0,365000,1950
1360,3120,2,0,1360,0,396900,1989
2014,4500,2,0,2014,0,321000,2005
1440,7008,1,0,1440,0,245000,1985
1570,4704,1.5,1,1570,0,502000,1931
2330,7642,1,0,1800,530,257000,1990
1880,7303,1,0,1010,870,423000,1976
1850,9911,1,0,1850,0,485000,1957
2230,8560,2,0,2230,0,500000,2002
990,4313,1.5,2,990,0,442000,1917
1720,3825,1.5,0,1720,0,475000,1925
3230,9935,2,0,3230,0,625000,1986
1180,6050,1,0,820,360,194000,1944
1450,19206,2,0,1450,0,410000,1989
2370,10858,2,0,2370,0,1.03E+06,2003
2570,6157,2,0,2570,0,490000,2006
1870,7575,1,0,1480,390,348500,1972
1220,3000,1.5,0,1220,0,380000,1901
1770,2150,3,0,1770,0,660000,1999
1500,6800,1,0,1500,0,525000,1943
1110,8724,1,0,1110,0,235000,1990
4980,18069,2,3,4980,0,1.21E+06,2006
2360,8116,1,0,1180,1180,397950,1916
1600,7711,1,0,1600,0,268000,1999
1450,4000,1,1,950,500,525000,1948
2680,5860,2,0,2680,0,549950,2001
1150,6600,1.5,0,1150,0,370000,1970
1870,6693,2,0,1870,0,299000,1996
3400,5000,2,2,2860,540,715000,1977
1810,7200,1,0,1810,0,430000,1966
1860,7191,1,0,1260,600,345000,1975
3790,19000,2,4,3790,0,1.60E+06,1985
2130,3500,1,0,1210,920,534640,1994
2860,4500,2,2,1980,880,1.23E+06,1915
2370,7274,2,0,2370,0,351000,1997
2290,10409,2,0,2290,0,745000,1972
1120,5329,1,1,750,370,320000,1929
1810,12420,1,0,1810,0,555700,1957
3220,35400,2,0,3220,0,690000,1991
1660,9697,1,0,1660,0,449000,1952
850,6174,1,0,850,0,308500,1950
2665,5868,2,0,2665,0,340000,2006
2580,3560,1.5,0,1710,870,937750,1917
3200,12369,2,0,3200,0,725126,1998
840,3000,1,0,840,0,135000,1943
2970,7961,1,0,2020,950,635000,1969
790,7500,1,0,790,0,245500,1950
2140,36509,1.5,0,2140,0,230000,1903
2580,14603,1,2,2580,0,1.77E+06,1951
2180,7875,1,0,1200,980,425000,1955
1060,10423,1.5,0,1060,0,220000,1965
1860,9100,1.5,0,1860,0,370000,1939
1840,16815,1,0,960,880,390000,1972
1340,16480,1,0,1340,0,239000,1968
2320,7350,2,0,2320,0,345000,1973
2110,8304,1,0,2110,0,289000,1985
1840,8050,1.5,0,1840,0,285000,1962
1080,9225,1,0,1080,0,147400,1955
1290,4636,1,0,1290,0,600000,1924
2210,10794,1,0,1540,670,245000,1967
2210,10794,1,0,1540,670,520000,1967
1410,14110,1,2,1170,240,352500,1987
3740,24684,2,0,2760,980,448000,1998
2440,7150,1,0,1200,1240,270000,1963
2040,6000,1,0,1840,200,872500,1951
3840,6214,1.5,3,2590,1250,2.15E+06,1939
1660,7221,1,0,980,680,225000,1962
1640,6000,1.5,0,1640,0,735000,1911
1310,8400,1,0,1310,0,375000,1972
1720,9775,1,0,1720,0,169000,1978
1720,9775,1,0,1720,0,279950,1978
4020,18745,2,4,2830,1190,1.95E+06,1989
1960,2345,2,0,1750,210,310000,2003
3240,35083,2,0,3240,0,975000,1978
3610,11914,2,0,3010,600,650000,1958
1800,4500,1,2,1000,800,930000,1942
1960,5000,1,0,980,980,412000,1912
1250,10200,1,0,1250,0,225000,1965
2120,7201,2,0,2120,0,507000,2003
3860,67953,2,2,3860,0,1.76E+06,1927
1340,3011,2,0,1340,0,230000,1995
1780,188465,2,0,1780,0,316000,2001
3920,4832,2,0,3030,890,616200,2014
1690,53578,1,0,1690,0,509900,1984
2570,7753,2,0,2570,0,370000,1987
1870,7030,1,0,1870,0,619100,1977
2860,11250,1,1,2290,570,805000,1956
1670,6000,1,0,1090,580,612125,1950
1070,937,3,0,1070,0,350000,2003
940,15000,1,0,940,0,225000,1960
2588,5701,2,0,2588,0,335000,2008
3500,10457,2,0,3500,0,972800,2001
1690,48096,1,0,1690,0,500000,1973
3790,7200,2,0,2530,1260,2.20E+06,1931
1090,8400,1,0,1090,0,415000,1966
2240,10479,2,0,1710,530,399000,1950
1150,4000,1,0,1150,0,376000,1947
1870,3378,1,0,1120,750,340000,1913
2990,7200,2,0,2990,0,490000,1997
2580,6260,2,0,2580,0,374000,2004
2220,3588,1.5,0,1470,750,852000,1927
1620,12309,2,0,1620,0,473000,1987
2590,25992,1,0,1970,620,540000,1968
1390,12530,1,0,970,420,431000,1959
2270,7245,1,0,1410,860,435000,1979
2920,33976,1,3,1460,1460,1.05E+06,1964
1250,892,2,0,1040,210,450000,2010
1100,27008,1,0,960,140,157500,1935
1500,7475,1,0,1500,0,244000,1976
2800,10603,2,0,2800,0,550000,2001
3420,183387,2,0,3420,0,975000,2000
2100,88426,1,0,2100,0,426500,1990
1790,3876,1.5,0,1090,700,350000,1904
1790,3876,1.5,0,1090,700,615000,1904
2220,12056,2,0,2220,0,542000,1985
2000,6000,1,3,1000,1000,710000,1956
1770,9450,1,0,1770,0,289950,1988
4280,12668,2,0,3900,380,1.90E+06,1947
1260,5100,1.5,0,1120,140,528000,1925
840,5100,1,0,840,0,471000,1949
1830,6643,2,0,1830,0,250000,2001
970,8400,1,0,970,0,155000,1966
1740,8160,1.5,0,1400,340,515000,1946
1654,8464,2,0,1654,0,336600,1995
2390,2750,2,0,1580,810,915000,1925
1080,7242,2,0,1080,0,350000,1984
2610,21600,1,0,2610,0,1.30E+06,1966
1070,6164,1,0,1070,0,175000,1967
1430,3880,1,0,1430,0,545000,1949
2400,5400,2,2,1600,800,475000,1965
670,11505,1,0,670,0,390000,2003
2860,14000,2,0,2860,0,645000,1995
2270,8187,1,0,1420,850,410000,1954
2180,9861,2,2,2180,0,480000,1997
1860,6000,2,2,1860,0,725000,1959
6040,219542,2,0,4100,1940,1.15E+06,1996
1010,11919,1,0,1010,0,300000,1947
2570,8178,1,2,1710,860,752000,1961
1950,3720,2,0,1950,0,585000,2004
1970,10548,1,0,1300,670,678700,1973
2110,11155,2,0,2110,0,603000,1975
1650,7276,1.5,4,1150,500,715000,1928
3520,128502,2,2,3520,0,1.40E+06,1981
2840,7500,2,3,2840,0,1.09E+06,1997
1490,4800,1,0,750,740,467500,1918
1650,7218,1,0,1230,420,359000,1985
1960,4520,1,0,960,1000,745000,1922
2450,42180,1,0,2450,0,450000,1978
1720,2000,1.5,0,1060,660,935000,1910
1980,3128,2,0,1890,90,615000,2009
4110,35741,2,0,4110,0,1.03E+06,1976
1990,5577,2,0,1990,0,283500,1999
860,7102,1,0,860,0,340000,1947
2320,9264,2,0,2320,0,370000,1994
4190,9624,2,0,4190,0,1.15E+06,1999
1940,9533,1,0,1080,860,265000,1962
2520,2370,2,0,1690,830,480000,1908
1880,3800,1,0,1030,850,667500,1927
2910,10044,2,0,2910,0,1.40E+06,1989
5310,8816,2,0,3650,1660,2.30E+06,2013
2670,7500,1,0,1640,1030,465000,1966
470,63737,1,2,470,0,192500,1924
1060,5600,1,0,760,300,345000,1943
1120,6900,1,0,1120,0,439800,1956
2250,8580,1,0,1330,920,468000,1958
2070,8473,1,0,1250,820,775000,1976
2370,9360,2,0,2370,0,684680,1979
3570,27699,2,0,3570,0,910000,1990
4830,22257,2,4,4830,0,3.64E+06,1990
1160,22470,1,0,1160,0,375000,1976
1610,6600,2,0,1610,0,250000,1994
4150,7500,2.5,4,3510,640,3.07E+06,1909
1840,7575,1,0,1390,450,442500,1973
4080,217697,1.5,3,4080,0,900000,2000
1820,4080,2,2,1820,0,699000,1937
2680,18768,1,0,2680,0,360000,1965
4790,25412,2,0,4790,0,1.68E+06,1999
2420,21000,1.5,0,2420,0,675000,1966
1130,8081,1,0,1130,0,345000,1921
1320,5000,1.5,0,1320,0,229000,1928
1290,12415,1.5,0,1290,0,300000,1908
1600,1289,3,0,1600,0,392500,1998
1120,2300,1,0,820,300,552000,1912
2060,7192,1,0,1420,640,457000,1940
2830,13760,2,0,2830,0,518000,1993
1210,6634,1,0,1210,0,237000,1985
1560,11997,1,0,1260,300,399950,1988
2260,17114,2,0,2260,0,605000,1990
1850,8198,2,0,1850,0,295000,1993
1930,8040,1,0,1380,550,513000,1978
3230,4290,2,0,3230,0,772500,2004
3230,4290,2,0,3230,0,765000,2004
2450,5376,1.5,0,1550,900,696950,1920
1200,5650,1.5,0,1200,0,329000,1928
2360,8093,2,0,2360,0,339999,1995
1060,9506,1,0,1060,0,364500,1959
2220,6000,1.5,0,1420,800,607500,1923
880,6664,1,0,880,0,550000,1961
2510,9750,1,0,1630,880,479900,1960
2530,1774,3,2,2100,430,1.12E+06,2013
700,10540,1,0,700,0,192000,1953
1500,5200,1,0,1060,440,250000,1977
1130,9879,2,0,1130,0,340000,1996
1420,6060,1,0,830,590,340000,1942
2210,22040,1,0,1510,700,635250,1976
1170,5043,1,0,880,290,324800,1949
780,16344,1,0,780,0,78000,1942
1770,12875,1,0,1770,0,400000,1988
1070,4505,1,2,1070,0,640500,1919
1930,10929,1,0,1260,670,570000,1964
1940,2885,1.5,2,1940,0,1.33E+06,1900
1440,7350,1,0,1040,400,330490,1980
1740,5267,2,0,1740,0,325000,1999
1740,5267,2,0,1740,0,335000,1999
2210,13500,1,0,1460,750,314000,1963
2190,3622,1.5,0,1990,200,625000,1925
2590,7720,2,0,2590,0,809000,1988
2790,19485,2,0,2790,0,535000,1990
2180,9178,1,0,1140,1040,275000,1963
2580,11900,1,0,1620,960,358000,1967
2820,8100,1,0,1720,1100,297975,1947
1300,22239,1,0,1300,0,492000,1945
720,8040,1,0,720,0,210000,1943
2260,4550,1.5,0,1380,880,622500,1928
1550,1092,3,0,1390,160,550000,2004
1390,7700,1,0,1390,0,190000,1965
2380,9362,2,0,2380,0,340000,2000
2640,5964,2,0,2640,0,678000,2003
2260,11970,1,0,1250,1010,275000,1962
1720,6720,1,0,1270,450,493000,1947
1070,14000,1,0,1070,0,147000,1960
2000,7225,2,0,2000,0,334000,1985
2800,10786,1,0,1420,1380,605000,1970
1450,61419,1,0,1450,0,365000,1976
1620,10610,1,0,1620,0,345000,1958
2710,23292,1,4,2080,630,999000,1956
1520,4220,1,0,840,680,470000,1910
2730,22572,1,0,2080,650,599000,1968
1740,10378,1,0,1740,0,255000,1977
1800,28650,1,0,1800,0,295000,1975
4150,16197,2,0,4150,0,550000,2006
3270,4080,2,0,2180,1090,1.31E+06,2011
1070,6000,1,0,1070,0,225000,1922
1960,8277,1,4,1320,640,520000,1923
1600,1882,2,0,1360,240,345000,2000
1650,7775,1,0,1150,500,475000,1950
2170,8610,1,0,1230,940,497500,1959
3730,383328,1.5,0,2230,1500,649500,1990
3280,6845,2,0,3280,0,734500,2003
870,8040,1,0,870,0,276000,1953
900,28800,1,0,900,0,235000,1928
1400,10800,1,0,1400,0,325000,1974
1680,9545,1,0,1080,600,425000,1979
2390,23972,2,0,1720,670,307000,1949
2300,5500,1.5,0,2000,300,635000,1921
1340,7473,1,0,1340,0,223000,1973
2600,10874,2,0,2600,0,425000,1994
1640,7730,1,0,1220,420,190000,1989
1960,6177,1,0,1960,0,275000,1967
1480,1961,2,0,1480,0,450000,2005
5010,34460,2,0,5010,0,1.47E+06,1988
1540,5000,1.5,0,1540,0,550000,1913
4030,10240,2,2,3310,720,835000,1943
3020,13783,2,0,3020,0,900000,1952
1590,9375,1,0,910,680,290000,1983
2910,9131,2,0,2910,0,1.04E+06,2014
3020,15164,1,0,1730,1290,780000,1976
2290,11200,2,0,2290,0,572500,1979
2180,9220,1,0,1090,1090,389000,1938
2740,10086,1,0,1440,1300,350000,1972
2740,33158,2,0,2740,0,476000,1993
2330,3600,2,0,1870,460,1.05E+06,1927
2300,7200,1,0,1550,750,287000,1978
1550,6596,1.5,0,1550,0,707500,1907
1750,11381,1,0,1610,140,464500,1947
2180,5000,1,3,1090,1090,720000,1941
1610,8544,2,0,1610,0,319000,1994
1570,9136,1,0,1570,0,330000,1953
1140,9628,1,0,1140,0,120750,1969
1140,9628,1,0,1140,0,195000,1969
2480,6383,1,0,1380,1100,650000,1946
1690,8190,1,0,1690,0,530000,1958
2910,8027,1,0,1800,1110,825000,1970
1600,15044,1,0,1600,0,436000,1972
1010,14244,1,4,1010,0,658000,1926
1850,9570,1,0,950,900,547500,1940
2150,2527,2,0,1400,750,762000,1906
2650,7378,1,0,1460,1190,340000,1952
2510,5800,1,2,1830,680,880000,1953
3240,3600,2,0,2060,1180,1.22E+06,2008
3440,14554,2,4,2170,1270,1.95E+06,2012
1150,6249,1,0,1150,0,382500,1952
1890,9535,1,0,1210,680,344500,1976
1430,7403,1,0,1030,400,375000,1982
370,1801,1,0,370,0,276000,1923
3130,12087,2,0,2180,950,500000,1975
2105,6093,2,0,2105,0,330000,2003
890,5965,1,0,890,0,328000,1950
1340,7200,1,0,1340,0,450000,1972
2290,12174,1,4,1490,800,840500,1948
2770,9350,2,3,2770,0,679000,1957
1890,9450,1,0,1090,800,270000,1957
3160,8065,2,0,3160,0,757500,1977
1830,2856,2,0,1830,0,524950,2005
2950,49658,1,0,2950,0,424900,1960
1430,8640,1,0,1430,0,551100,1954
1420,12655,1,0,1420,0,421000,1968
2460,7560,2,0,2460,0,635000,1952
1340,6120,1.5,0,1340,0,255000,1920
1530,7920,1,0,1030,500,419950,1955
2650,12870,1,0,2650,0,325000,1977
1677,3600,2,0,1677,0,281000,2012
2050,11856,1,0,1460,590,655275,1962
2520,3959,1,0,1270,1250,861000,1931
2620,11148,2,4,2060,560,850000,1977
1650,6675,1,0,1290,360,246000,1990
700,4836,1,0,700,0,380000,1926
3430,7508,2,0,3430,0,813000,1998
3140,11049,2,0,3140,0,990000,1988
2350,3750,2,0,1740,610,650000,2003
1990,6180,2,0,1990,0,273000,1990
2050,14724,2,0,2050,0,398000,1989
930,8665,1,0,930,0,200000,1938
1230,12305,1,0,1230,0,839000,1955
1870,9135,1,0,1250,620,502000,1984
2110,7665,1,0,1360,750,305000,1973
3160,10000,2,0,3160,0,574950,1980
1120,8631,1,0,1120,0,311000,1942
2750,6203,1,4,1620,1130,1.65E+06,1959
1230,9568,1,0,1230,0,387000,1962
1190,20672,1.5,3,1190,0,375000,1948
740,3434,1,0,740,0,175000,1920
1770,5855,2,0,1770,0,248000,2003
1720,7803,1,0,1350,370,336750,1955
2770,45514,2,0,2770,0,685000,1989
2330,3917,2,0,2330,0,645000,2004
1660,7388,2,0,1660,0,279000,2003
1730,1037,3.5,0,1730,0,479000,2008
1880,7279,1,0,1280,600,466000,1962
2190,6740,2,0,2190,0,361500,1995
1720,7202,1,0,1720,0,404000,1995
2360,8344,2,0,2360,0,319000,1990
1490,10132,1,0,1490,0,320000,1969
3490,5625,2,0,2610,880,1.31E+06,2014
2370,8900,1,4,1670,700,1.00E+06,1971
2290,9120,2,0,2290,0,660000,1977
1790,3600,1.5,0,1790,0,546000,1901
1820,5015,1,0,1190,630,300000,1926
1760,12000,1,0,1760,0,500000,1964
2430,5556,2,0,2430,0,381500,2003
2630,12899,2,0,2630,0,990000,1966
2390,4639,2,0,2390,0,278226,2006
1500,4158,1,0,1220,280,340000,1947
2510,12000,1,0,1520,990,305000,1977
2420,10285,1,4,1700,720,760000,1958
2170,9948,2,0,2170,0,195000,1952
1960,6138,1,0,1260,700,564000,1960
2280,8550,1,0,1660,620,539500,1977
1580,10230,1,0,790,790,299980,1945
1850,5674,2,0,1850,0,290000,1993
770,11084,1,0,770,0,257000,1947
2120,5520,1.5,0,1420,700,518500,1985
3060,35380,1,0,1810,1250,657000,1982
2680,41250,2,0,2680,0,590000,1984
2220,6350,1,0,1110,1110,526000,1959
1150,11250,1,0,1150,0,254500,1920
980,3663,1,0,980,0,575000,1909
1690,10500,1,0,1690,0,464550,1967
1320,6030,1,0,1320,0,409950,1969
910,22000,1,0,910,0,100000,1956
820,1270,2,0,820,0,365000,2009
1300,7420,1,0,1300,0,208000,1960
1950,3000,2,0,1550,400,497950,1998
3672,9742,2,0,3006,666,405000,2006
2740,22499,2,0,2740,0,568000,1994
890,6000,1,0,890,0,334000,1941
1090,8400,1,0,1090,0,235000,1961
1170,10621,1,0,1170,0,295000,1963
2600,29539,1,0,2600,0,610000,1994
2000,6032,1,2,1300,700,453500,1959
3520,3944,1.5,0,2200,1320,1.22E+06,1913
1410,7000,1,0,1410,0,175000,1968
1410,7000,1,0,1410,0,335000,1968
1950,7620,1,0,1010,940,275000,1956
980,2130,1,0,860,120,400000,1918
3390,7000,1,3,1740,1650,915000,1979
2270,9247,1,0,1500,770,619850,1972
1510,8800,1,0,1010,500,225900,1963
960,7200,1,0,960,0,525000,1910
1900,9600,1,0,1900,0,215000,1967
2580,13096,2,0,2580,0,802000,1986
2340,11784,2,0,2340,0,330000,1997
1580,11680,1,0,1580,0,549800,1958
1230,8636,1.5,0,1230,0,195500,1954
1590,7819,2,0,1590,0,338000,1992
7000,28206,1,4,3500,3500,3.20E+06,1991
1770,7000,1,0,1770,0,480000,1972
1850,8310,1,0,1200,650,383000,1962
1430,7210,1,0,1430,0,257000,1975
2190,9209,2,0,2190,0,335000,1996
2310,6650,2,2,2310,0,422000,2012
2000,10182,1,0,1400,600,560000,1963
3620,35429,2,0,3620,0,680000,2006
1210,7040,1,0,1210,0,320000,1952
2330,15536,1,2,2330,0,665000,1996
2840,6854,2,0,2840,0,751000,2002
2410,10763,1,0,1310,1100,320000,1957
1820,22043,2.5,0,1820,0,290000,1918
1470,7412,1,0,1470,0,250000,1967
1100,10005,1,0,1100,0,423000,1964
2050,8094,1,0,1050,1000,601002,1976
1240,1892,2,0,1240,0,352900,2002
2210,70567,2,3,2210,0,509950,1995
1340,1050,3,0,1340,0,360000,2009
2580,8100,2,1,1780,800,1.08E+06,1964
2390,6441,2,0,2390,0,349950,2002
2250,6840,2,0,2250,0,395000,1987
2000,15265,1,0,1540,460,273500,1967
1870,6000,1,0,1670,200,700000,1949
2370,10968,2,0,2370,0,699000,1985
2640,8800,1,0,1620,1020,537000,1980
1240,9975,1,0,1240,0,405000,1977
800,1200,2,0,800,0,269500,1999
2050,12500,1,0,1300,750,260000,1965
1650,10000,2,0,1650,0,266750,1988
4320,39094,2,4,4320,0,1.80E+06,1938
2130,5920,1,0,1830,300,779000,1950
2840,48716,1,3,1870,970,500000,1994
3080,32997,1.5,0,3080,0,365000,1950
1560,5000,1.5,1,1560,0,724000,1942
3220,15467,2,0,3220,0,890000,1994
1450,3600,1.5,0,1250,200,431000,1902
960,21850,1,0,960,0,242000,1947
2670,8279,2,0,2670,0,415000,1999
2310,5000,2,0,2310,0,727160,1984
3520,19354,1,2,2010,1510,1.11E+06,1978
1090,3272,1,0,1090,0,265000,1970
2000,5680,1,0,1080,920,519000,1903
1840,9009,2,0,1840,0,262000,1965
3160,13194,2,0,3160,0,1.19E+06,1965
1520,6559,1,0,1170,350,295000,1992
2110,56192,1,0,1480,630,615000,1978
3410,7750,1,4,1710,1700,1.10E+06,1958
2630,6247,2,0,2630,0,575000,1992
1350,2325,3,0,1350,0,388000,1999
2860,9159,1,0,1530,1330,750500,1989
2310,78844,1,0,1760,550,527500,1977
2590,108900,2,0,1980,610,503000,1988
3500,4000,2,0,2560,940,1.05E+06,2000
800,7260,1,0,800,0,325000,1953
1580,6127,1.5,0,1580,0,402000,1947
1560,6774,1,0,1060,500,370000,1927
1750,7800,1,0,1150,600,329950,1956
600,6120,1,0,600,0,135000,1943
1630,7626,1,0,1110,520,482500,1990
1260,7248,1.5,0,1260,0,259000,1955
2140,9775,1,0,1470,670,210000,1978
2790,6600,2,0,2790,0,459000,2000
2530,35150,1,0,1800,730,375000,1977
1330,7200,1,0,900,430,295000,1974
2700,6120,1,0,1350,1350,910000,1962
1740,37238,1.5,0,1740,0,470000,1932
2070,7980,1.5,0,2070,0,565000,1940
2670,9040,1,0,2170,500,339950,1955
2200,103237,1,0,1160,1040,547000,1971
810,8382,1,0,810,0,125000,1942
3970,9778,2,2,3390,580,2.30E+06,1928
2370,7500,1,3,1620,750,348000,1979
1460,11880,1,0,1460,0,175000,1961
1770,2875,2,0,1770,0,439950,1990
1120,32250,1,0,1120,0,230000,1934
1520,2550,2,0,1520,0,207000,2005
3020,21441,1,0,1510,1510,320000,1978
5600,107157,2,0,3440,2160,1.09E+06,1988
1320,14250,1,0,1320,0,510000,1954
1870,4992,1.5,0,1670,200,730000,1940
2460,7630,1,0,1940,520,750000,1976
960,7400,1,0,960,0,237000,1962
3440,103672,2,0,3440,0,560000,1990
3010,12432,1,0,1890,1120,745000,1970
6030,39317,2,0,4440,1590,1.83E+06,1991
1990,6350,2,0,1990,0,180000,1967
1990,6350,2,0,1990,0,309950,1967
1710,6050,1.5,0,1410,300,715000,1913
1890,4300,1.5,0,1350,540,620000,1918
1990,9995,2,0,1990,0,330000,1996
1600,7400,1,0,1210,390,525000,1973
3820,53173,1,0,2040,1780,611000,1974
2210,8465,1,0,1490,720,294000,1990
2020,11095,1,0,1480,540,463000,1975
1770,7251,1,0,1770,0,320900,1990
2050,4502,2,0,2050,0,369950,2005
3130,139392,2,0,3130,0,565000,1981
3520,4933,1.5,0,2270,1250,589500,1929
1810,9750,2,0,1810,0,400000,1977
2150,9900,1,0,1450,700,458000,1977
2495,5751,2,0,2495,0,436000,2002
1290,6150,1,1,1290,0,310000,1950
3004,5700,2,0,3004,0,398000,2006
2070,7200,1,0,1390,680,625000,1977
4050,35600,2,0,4050,0,1.01E+06,1990
960,6250,1,0,740,220,435000,1940
1900,9990,1,0,1300,600,250000,1961
1450,7316,1,0,1450,0,430000,1961
2720,3000,2,0,2250,470,790000,2014
4830,18707,2,1,3930,900,1.68E+06,1952
1920,7102,1,0,1130,790,250000,1992
2540,6660,2,3,2340,200,1.12E+06,1954
1600,8040,1,0,1050,550,383900,1965
2210,5929,2,0,2210,0,330000,2004
2510,47044,1,0,1910,600,624000,1975
2280,5750,1,0,1140,1140,383000,1951
4400,186846,2,0,4400,0,687000,1993
3160,8876,2,0,2460,700,558000,1997
1380,3500,2,0,1380,0,275000,1971
3320,10500,1,0,2020,1300,687500,1963
1870,6821,2,0,1870,0,275000,1989
3030,11550,2,2,3030,0,700000,1971
1210,7507,1,0,1210,0,342500,1982
2740,45732,2,0,2740,0,483500,1995
1350,7370,1,0,1350,0,190000,1912
1350,7370,1,0,1350,0,300000,1912
1470,1691,2,0,1000,470,540000,2007
1270,8991,2,0,1270,0,140000,1981
1680,19405,1,0,1560,120,275000,1959
2120,7650,1,0,2120,0,370000,1958
1040,9100,1,0,1040,0,227000,1937
1730,8706,1,0,1010,720,312000,1962
1410,5650,1.5,0,1410,0,260000,1918
1370,1911,2,0,1370,0,797000,1907
2840,228690,1.5,0,2720,120,640000,1948
3280,35160,1,0,2080,1200,605000,1976
2070,7995,1,0,1350,720,329950,1987
960,87991,1.5,0,960,0,180000,1946
1470,7518,1,0,1160,310,220000,1985
2430,4748,1.5,0,1630,800,723000,1928
1430,8412,1,0,1070,360,375000,1928
1760,9277,1,0,1760,0,388000,1962
1730,7375,1,0,1730,0,249950,1944
2290,7900,1,0,1190,1100,390000,1965
1690,11739,1,0,1690,0,705000,1959
3220,7875,1.5,0,3220,0,590000,1966
2130,11097,1,0,1370,760,292000,1952
2100,213008,1,0,2100,0,506000,1990
2770,8642,2,0,2770,0,907500,1987
4040,18916,1,0,4040,0,2.27E+06,1954
2500,5100,1.5,0,1420,1080,319500,1907
1580,5292,1,0,980,600,265000,1913
1130,10650,1,0,1130,0,237000,1954
1500,9282,1.5,0,1500,0,235000,1966
2230,6000,1.5,2,1810,420,740000,1928
1550,4980,1,0,1080,470,359000,1978
2230,5500,2,0,2230,0,334950,1999
790,8100,1,0,790,0,259950,1947
2230,4541,2,0,2230,0,253000,2006
1710,4140,2,0,1710,0,561000,2004
1260,5100,1,0,1260,0,455000,1941
2420,18470,1,0,920,1500,675000,1968
1090,8160,1,0,1090,0,267000,1967
2689,5724,2,0,2689,0,368000,2006
1620,3000,1.5,0,1620,0,599995,1928
940,10500,1,0,940,0,342500,1966
1940,13370,1,0,1940,0,252000,1974
1590,11200,1,0,1590,0,247200,1961
3020,4082,2,0,2080,940,910000,1954
1870,16549,1,0,1870,0,419950,1969
880,8976,1,0,880,0,160000,1966
3030,5494,3,0,3030,0,799950,2014
2140,11266,2,0,2140,0,400000,1986
2050,10200,1,0,1430,620,210000,1956
2050,10200,1,0,1430,620,475000,1956
2090,3821,2,0,2090,0,355900,2008
2520,26943,1,0,1760,760,420000,1977
2630,8580,1,0,1700,930,710000,1977
2560,15000,1,0,1880,680,518000,1974
1200,5404,1,0,1200,0,375000,1937
1010,7755,1,0,1010,0,185000,1953
1520,3425,2,0,1520,0,402000,1986
2170,153767,1,0,2170,0,585000,1976
1980,4500,2,0,1980,0,500000,1910
3070,7207,2,0,2670,400,1.72E+06,1927
5170,7197,3,4,3520,1650,1.68E+06,1998
1140,690,2,0,760,380,570000,2014
2530,4800,2,0,1390,1140,680000,1901
1690,14615,2,0,1690,0,345000,1979
2150,3600,2,0,2150,0,355000,2010
1180,7700,1,0,1180,0,390000,1959
1400,9690,1,0,1400,0,128000,1969
1300,4800,2,1,1300,0,448500,1912
1590,9636,1.5,0,1590,0,346000,1953
1990,5600,1,1,1330,660,779000,1941
1510,9720,1,0,1510,0,335000,1948
2910,1880,2,3,1830,1080,1.85E+06,1914
2850,21780,2,0,2850,0,799990,1994
2830,56628,2,0,2830,0,1.08E+06,2001
1110,1189,3,0,1110,0,371000,2000
1900,9775,1,0,1900,0,620000,1967
2290,10290,1,0,1340,950,343000,1960
1010,14948,1,0,1010,0,265000,1969
4670,15857,2,0,4670,0,1.00E+06,1998
3400,38400,1,4,1870,1530,825000,1955
4070,10976,2,0,4070,0,889000,2004
1630,10962,1,0,1100,530,305000,1977
1700,6635,2,0,1700,0,407000,1976
2070,12000,1,0,1340,730,613000,1967
4660,21164,2,4,4660,0,1.64E+06,1975
2050,6000,2,0,1550,500,645000,1910
4680,9700,2,0,3360,1320,1.16E+06,2005
2320,38186,2,0,2320,0,610000,1980
3800,13071,2,0,2730,1070,450000,1994
720,7598,1,0,720,0,300000,1947
4400,18500,1,3,2250,2150,1.12E+06,1963
2260,74297,2,0,2260,0,418200,1992
1650,2802,2,0,1650,0,250000,2004
2560,43608,2,0,2560,0,619000,2002
3720,15048,3,0,3720,0,500000,1979
2590,16437,2,0,2590,0,465000,1986
1750,68841,1,0,1750,0,322000,1942
1620,7320,2,0,1620,0,276900,1989
1700,12615,1,0,1300,400,660000,1990
2450,28185,2,0,2450,0,480000,1990
1610,10796,1,0,1070,540,925000,1951
3730,35900,1,0,2960,770,825000,1979
1210,7440,1,0,780,430,326000,1940
1300,9880,1,0,1300,0,205000,1959
850,54000,1.5,0,850,0,150000,1950
1770,3205,2,0,1770,0,593567,2005
2060,11231,2,0,2060,0,440000,1987
3090,13316,2,0,3090,0,751000,1992
1050,6500,1.5,2,1050,0,295000,1925
1300,2250,2,0,1300,0,422500,1988
1160,8800,1,0,1160,0,480000,1959
3420,6233,2,0,3420,0,890900,2006
2620,6707,2,0,2620,0,672500,2000
1880,3500,1,0,1080,800,605000,1926
4560,19080,1,0,2490,2070,1.68E+06,1963
2330,7936,2,0,2330,0,565000,1987
2350,7574,1,0,1720,630,725000,1979
1560,1466,3,0,1560,0,640000,2006
1380,7110,1.5,0,1380,0,253750,1939
3040,36721,1,3,1760,1280,799950,1958
1350,8113,1,0,1350,0,595000,1959
3180,11652,2,1,3180,0,850000,1977
1790,4065,2,0,1790,0,366000,2009
1986,6000,2,2,1746,240,715000,1922
2400,7215,2,0,2400,0,300000,1992
4590,9150,2,0,3490,1100,960000,1981
1970,3420,2,3,1970,0,812000,1913
1360,9948,1,0,1360,0,234950,1977
2710,4750,1,0,1460,1250,656500,1919
920,1598,2,0,920,0,255000,1995
2000,7204,1,0,1250,750,538000,1960
1920,9680,1,0,1300,620,260000,1961
2678,6607,2,0,2678,0,546200,1998
1220,4541,1,0,890,330,280500,1952
1440,4000,1,0,1050,390,295000,1979
2420,520,1.5,0,2420,0,700000,1900
2090,15790,1,0,2090,0,560000,1992
4030,10888,2,0,4030,0,912000,1997
1310,9282,1,0,1310,0,437000,1976
1800,3074,2,0,1800,0,447000,2003
1160,20100,1,0,820,340,500000,1913
1160,5969,1,0,880,280,508300,1930
1870,7853,1,0,1300,570,485000,1962
3700,7647,2,1,3700,0,540000,1948
2280,8765,2,0,2280,0,356000,1977
1720,6099,1,0,860,860,525000,1949
3630,11775,2,0,3630,0,962800,1999
2040,6300,2,0,2040,0,315000,2003
1750,1879,3,0,1750,0,525000,2001
1550,2285,2,0,1550,0,325000,2007
2500,8725,1,0,1500,1000,965800,1966
1440,3600,1.5,0,1440,0,550000,1924
1130,13927,1.5,0,1130,0,182200,1929
1210,8505,1.5,0,1210,0,315000,1958
960,5000,1,0,960,0,500000,1900
2160,7737,2,0,2160,0,480000,1998
3400,8965,1,2,1820,1580,1.69E+06,1957
3960,321908,2,0,2690,1270,525000,1989
1900,9075,2,0,1900,0,407500,1988
2620,35124,2,0,2620,0,443000,1987
3150,13700,2,0,3150,0,1.26E+06,1966
1040,4480,1,0,870,170,642000,1924
1540,7558,1,0,1540,0,520000,1964
1820,5000,1.5,0,1720,100,750000,1941
1930,4500,1.5,0,1930,0,855000,1929
1430,27153,1.5,0,1430,0,275000,1934
2920,5250,1.5,0,1800,1120,265000,1911
3100,45738,2,0,3100,0,894400,1991
1200,12856,1,0,1200,0,546000,1948
2390,7489,1,0,2390,0,699950,2007
1270,10713,1,0,1270,0,435000,1969
1300,7200,1,0,1300,0,259500,1970
2290,4785,2,0,2290,0,359950,2007
1740,10000,1,0,1740,0,517000,1976
1590,5400,1,1,1280,310,579000,1948
2420,10735,1.5,0,2420,0,525000,1967
2130,9653,1,0,1500,630,320000,1978
1950,13320,1,0,1370,580,635000,1969
2150,5397,2,0,2150,0,400000,1998
1270,7700,1,0,1270,0,455000,1968
1850,22767,1.5,4,1850,0,572000,1908
1440,136778,1,0,1140,300,650000,1956
1390,7417,1,0,1390,0,162500,1967
1340,1240,2,0,1150,190,400000,2008
1190,9000,1,0,1190,0,268300,1968
3830,4800,3,0,3050,780,989000,1919
1780,10409,1,0,1280,500,342000,1981
3130,5999,2,0,3130,0,315000,2006
1830,8384,1,0,1320,510,485000,1979
2550,7500,1,0,1750,800,277500,1976
3790,90169,2,0,3790,0,1.30E+06,1998
1800,10890,1.5,0,1800,0,385000,1912
1630,7680,1,0,830,800,426000,1947
1870,6000,1.5,0,1870,0,310000,1956
1870,6000,1.5,0,1870,0,449000,1956
980,3915,1,0,980,0,375000,1919
2860,10625,1,4,1920,940,1.19E+06,1976
1470,5597,2,0,1470,0,468000,1985
1160,5000,2,0,1160,0,336000,2000
1940,6555,2,0,1940,0,392000,1990
1630,7969,1,0,1100,530,412500,1977
2755,11612,2,0,2755,0,545000,2001
1430,5600,1.5,0,1430,0,133000,1947
1430,5600,1.5,0,1430,0,440000,1947
1400,7341,1,0,1300,100,294450,1961
2520,7205,2,0,2520,0,335000,1987
1290,10125,1,0,1290,0,362000,1956
1400,18002,1,0,1400,0,322000,1977
740,8853,1,0,740,0,230500,1943
1710,9996,1,0,1710,0,380000,1950
2414,7693,2,0,2414,0,292000,2006
1040,7500,1,0,1040,0,172500,1954
3540,7091,1.5,1,1970,1570,784000,1947
2530,11549,1,0,1700,830,525000,1942
2320,7609,2,0,2320,0,600000,2003
2530,16102,2,0,2530,0,435000,1989
2790,7600,1.5,0,2790,0,359900,1965
1950,7139,1,4,1150,800,700000,1957
1020,889,2,0,720,300,280000,2009
3110,24466,2,0,3110,0,655000,1997
5310,16909,1,4,3090,2220,2.48E+06,1992
2580,23925,2,0,2580,0,499950,2001
1380,1021,2,0,1160,220,540000,2008
3980,9209,2,0,3980,0,970000,2002
2080,7000,1,0,1400,680,330000,1989
1530,8000,2,0,1530,0,474000,1978
1930,9310,1,0,1930,0,670000,1968
2330,9687,2,3,2330,0,1.30E+06,1918
3860,10361,2,2,2940,920,1.16E+06,1985
2880,8061,2,0,2880,0,440000,1988
1590,2088,2,0,1590,0,411000,1997
2150,4000,1.5,0,1470,680,500000,1928
2300,13342,1.5,4,2300,0,1.34E+06,1934
2900,6400,2,0,2300,600,696000,1977
1970,11088,1,0,1180,790,465000,1967
1740,7500,1,0,1220,520,518000,1976
1220,7250,1,0,1220,0,251000,1962
1290,13282,1,0,1290,0,255000,1978
780,8271,1,0,780,0,319000,1924
2210,3400,1.5,0,1470,740,719000,1926
5930,13288,2,2,3920,2010,1.52E+06,1996
1950,4553,2,0,1950,0,322000,2000
1340,7920,1,0,1340,0,205000,1970
1590,6240,1,0,1060,530,229000,1956
1780,9672,1,0,1350,430,395000,1960
760,7272,1,0,760,0,183000,1980
1720,7800,1,0,1170,550,583500,1978
2070,25710,1,0,2070,0,312000,1917
1790,9860,1,0,1410,380,539000,1978
3230,12651,2,0,3230,0,409000,2002
1400,4000,1,0,870,530,510250,1951
1370,3827,1,0,1020,350,535000,1952
1600,7936,2,0,1600,0,280000,1996
950,8400,1,0,950,0,286000,1958
2210,7660,1,1,1460,750,710000,1968
930,6380,1,0,930,0,395000,1940
810,8494,1,0,810,0,237500,1949
1630,6550,1,0,850,780,464000,1912
1770,10080,1,0,1770,0,495000,1968
710,6060,1,0,710,0,257500,1916
3990,23544,1,2,2300,1690,570000,1999
2310,7485,2,0,2310,0,362000,1986
1620,6000,1,0,1040,580,640000,1947
1140,8800,1,0,1140,0,172500,1972
1040,4880,1,0,1040,0,596000,1910
2170,9796,1,0,1650,520,840000,1980
3370,23065,1,4,1920,1450,1.60E+06,1980
901,1245,3,0,901,0,435000,2001
840,7870,1,0,840,0,251000,1949
1650,9750,1,0,1650,0,282500,1964
1380,7226,1,0,1140,240,265000,1987
910,10240,1,0,910,0,330000,1969
1230,3800,1,0,1230,0,435000,1928
1740,8560,1,0,1500,240,827235,1948
1290,5000,1.5,0,1290,0,249950,1957
1950,18533,2,0,1950,0,400000,1988
2150,7944,2,0,2150,0,300499,1990
1560,5220,1,0,1560,0,449000,1959
1120,3220,1,0,1120,0,500000,1923
1790,7526,1,0,1790,0,865000,1953
3290,5414,2,1,2360,930,899950,2006
1540,9541,1.5,0,1540,0,370000,1961
4240,226097,2,0,3410,830,442500,1980
1010,9945,1,0,1010,0,310000,1973
2970,12750,1.5,1,2130,840,1.57E+06,1918
2190,9113,2,0,2190,0,245000,1986
700,8100,1,0,700,0,254950,1949
3300,7480,2,0,3300,0,510000,1980
1370,5000,2,0,1370,0,299950,1990
2680,4500,2,0,2680,0,379950,2011
1390,4820,1,0,910,480,350000,1926
1700,3575,2,0,1700,0,300000,2000
2510,6339,1.5,2,1810,700,994000,1932
1700,8067,1,0,1250,450,315000,1956
2180,11200,1,0,2180,0,480500,1968
1770,5720,1.5,0,1140,630,373000,1926
3290,5951,2,0,3290,0,728000,2003
3040,7125,2,1,2240,800,415000,2002
2460,5091,2,0,2460,0,427500,2003
970,10000,1,0,970,0,339300,1972
1320,6205,1,0,1320,0,313000,1948
1900,1612,2,0,1430,470,431500,2008
1220,835,1.5,0,1220,0,415000,1950
1470,9750,1,0,1470,0,490000,1978
4630,24054,2,3,4630,0,1.43E+06,2005
1400,9750,1,0,1400,0,275000,1964
1070,5080,1,0,1070,0,325000,1942
3630,6000,1.5,0,2470,1160,1.18E+06,2004
1970,4590,2.5,0,1970,0,690000,1909
2010,9474,2,0,2010,0,410000,1953
2820,5934,1,3,1770,1050,960000,1952
2530,8669,2,0,2530,0,299250,1990
710,14000,1,0,710,0,239000,1953
1210,9400,1,0,1210,0,235000,1949
2370,217800,2,0,2370,0,587000,1979
2300,6087,2,0,2300,0,431000,2001
3110,6765,2,1,2550,560,1.64E+06,1946
1990,6500,1,0,1090,900,285000,1961
2630,10156,1,0,2630,0,778000,1987
1300,7975,1,0,1300,0,415000,1958
1680,4500,1,0,1680,0,550285,2004
2180,9865,1,0,1660,520,910000,1966
2770,9136,2,0,2770,0,860000,1991
2120,5000,2,0,1980,140,765000,1920
2830,20345,2,0,1980,850,782000,1979
1370,1764,2,0,1180,190,525000,2000
2810,435600,2,0,2810,0,745000,1995
3520,35512,2,2,2760,760,470000,2005
1990,5650,1,1,1320,670,345000,1963
2070,7800,1,0,1170,900,279000,1964
1320,8100,1,0,1320,0,500000,1951
1300,8160,1,0,1300,0,237000,1960
1260,9346,1,0,1260,0,200500,1963
2400,9900,1,0,1250,1150,387500,1957
1950,8040,1,0,1950,0,392500,1961
1430,12430,1,0,1430,0,305000,1957
2110,10100,1,2,2110,0,981000,1968
2980,8770,2,0,2980,0,680000,1990
2068,7242,2,0,2068,0,276000,1976
3380,8330,2,0,3380,0,655500,2000
2810,13144,1,0,1440,1370,555000,1964
930,10505,1,0,930,0,235000,1930
1300,8879,1,0,920,380,325000,1950
1320,8100,1,0,880,440,268950,1943
1580,14040,1,0,1050,530,264500,1980
1620,5250,2,0,1620,0,240000,1987
2750,226512,2,0,2750,0,819000,2000
2210,5000,1,2,1530,680,850000,1951
1740,9600,1,2,1160,580,294950,1957
2120,13644,2,1,1420,700,693000,1973
2780,7290,2,0,2780,0,478000,1989
830,6893,1,0,830,0,222000,1950
2070,11286,2,0,2070,0,635000,1996
1390,1278,2,0,1140,250,469000,2005
2610,5866,2,0,2610,0,350000,2005
1460,11726,1.5,0,1290,170,180000,1936
3390,39356,1,0,1640,1750,490000,1964
1360,6000,1,0,860,500,360000,1911
2807,9430,2,0,2807,0,630000,1996
1340,2006,1.5,0,1340,0,615000,1931
1340,7202,2,0,1340,0,279950,1989
1160,8813,1,0,1160,0,317000,1952
2470,7350,1,0,1600,870,618000,1978
2000,8713,1,2,1000,1000,620000,1962
1110,6250,1,0,1110,0,345000,1956
2240,3750,1,0,1220,1020,608000,1952
1920,11603,2,0,1920,0,325000,1967
2270,13000,1,0,2270,0,475000,1968
1530,9997,1,0,1020,510,154000,1992
3330,19126,2,0,2610,720,1.19E+06,1977
2643,5750,2,0,2643,0,376950,2012
1250,3360,1,0,1250,0,500000,1957
3230,129578,1,0,2100,1130,499950,1964
880,9035,1,0,880,0,230000,1967
2220,5900,2,0,2220,0,652600,2014
1130,7000,1,0,1130,0,185000,1978
1450,8820,1,0,1050,400,274950,1958
760,6035,1,0,760,0,447000,1920
1150,30184,1,0,1150,0,129000,1950
2720,9856,2,0,2720,0,436000,1969
2080,5000,2,0,2080,0,825000,1906
1080,16000,1,0,1080,0,225000,1952
1890,6088,2,0,1890,0,265000,1996
1500,5111,2,0,1500,0,765000,1984
1960,2166,1.5,0,1260,700,509000,1926
2570,8640,1,0,2570,0,762450,1958
1830,9000,1,2,1030,800,465000,1955
1980,6250,1,1,1090,890,564000,1910
1130,5236,1,0,1130,0,384500,1942
2010,33090,1.5,2,2010,0,415000,1986
1820,8409,1,0,910,910,345000,1948
2340,6896,2,0,2340,0,465950,2001
1780,11096,1,0,1210,570,325000,1979
1780,11096,1,0,1210,570,500000,1979
2450,20348,1,0,1410,1040,450000,1978
2410,8284,1,0,1210,1200,475000,1969
3380,20021,1,0,1690,1690,1.35E+06,1963
1710,5120,2,0,1710,0,747000,1920
1740,6220,1,0,1740,0,395000,1954
1995,1483,3,0,1760,235,505000,2005
1760,9282,1,0,1100,660,215000,1947
3970,210830,2,0,3970,0,775000,2000
3000,5471,2,0,3000,0,540000,2013
1540,8925,1,0,1540,0,392500,1957
2160,15788,1,0,2160,0,987000,1951
2160,15788,1,0,2160,0,1.19E+06,1951
1810,10684,2,0,1810,0,252500,1987
2440,3502,2,0,1970,470,730000,2000
3200,9200,1,2,1600,1600,497300,1953
2970,34981,2,0,2970,0,640000,1998
2290,7125,1,0,1190,1100,580000,1964
1820,34800,1,0,1820,0,377000,1967
3010,3600,2,0,2370,640,1.28E+06,1999
1360,1488,2,0,1120,240,396500,2003
2080,2999,2,0,2080,0,300000,1998
1110,4800,1.5,0,1110,0,532000,1946
1560,4500,1,0,1560,0,579000,2004
3520,7815,2,3,3140,380,1.40E+06,1929
2280,43560,1,1,1380,900,571000,1949
1370,9288,1,0,1370,0,301950,1988
2340,2970,2,0,2160,180,660000,1925
3170,10688,2,2,3170,0,455000,2001
1380,5060,1,0,1380,0,375000,1986
2700,6769,2,0,2700,0,470000,1999
1300,10484,2,0,1300,0,374990,1983
1900,3690,2,0,1900,0,541500,2006
3750,7821,2,0,3750,0,782500,2001
1552,3677,2,0,1552,0,264000,2012
2500,7417,2,0,2500,0,640000,1991
1770,8141,1,0,1770,0,660000,1952
4210,17258,2,3,4210,0,1.37E+06,1995
2170,8140,2,0,2170,0,389950,1994
1510,19874,1,0,1510,0,226000,1951
1870,40250,1,0,1870,0,390000,1959
1570,8111,2,0,1570,0,485000,1984
2480,4602,2,0,2480,0,840000,2000
3580,21343,1.5,0,2140,1440,600000,1937
1480,6210,1,0,1080,400,331000,1950
2610,6000,1,0,1310,1300,780000,1941
1700,8481,2,0,1700,0,300000,1993
1240,7620,1,0,1240,0,361810,1968
1660,6582,1,0,1000,660,467000,1946
1620,10000,1.5,0,1620,0,399000,1918
1130,7500,1.5,0,1130,0,315450,1908
1310,5000,1.5,0,1310,0,600000,1906
1710,5200,1,0,910,800,247500,1977
2140,5037,1,0,2140,0,330000,1957
2350,7210,1.5,0,2350,0,500000,1972
1570,10050,1,0,1570,0,367500,1963
2780,32880,1,0,2780,0,560000,1993
2540,7620,1,3,1320,1220,655000,1948
2500,7140,1,0,1250,1250,530000,1968
2080,26574,1,2,1380,700,270000,1993
1760,2875,2,2,1290,470,437500,1988
1760,10349,1,0,1760,0,575000,1957
1940,6887,2,0,1940,0,278000,1990
3010,6181,2,0,3010,0,568500,2000
2460,9606,1,0,2460,0,280000,2012
750,6350,1,0,750,0,250000,1920
1300,72309,1,0,680,620,247500,1950
3710,13874,1.5,3,2340,1370,1.25E+06,1977
2360,15008,1,0,1920,440,535000,1986
3190,6899,2,0,3190,0,814842,2014
2181,5521,2,0,2181,0,340000,2006
1890,9100,2,0,1890,0,359950,1952
2610,5544,1.5,0,1680,930,750000,1934
3090,8125,2.5,0,3090,0,1.22E+06,1918
860,5040,1,0,860,0,370000,1956
1000,9170,1,0,1000,0,329950,1980
2760,35171,2,0,2760,0,500000,1990
3490,18521,2,0,3490,0,734000,1990
2960,5054,2,0,2960,0,385000,2006
1280,4635,1,0,840,440,230000,1917
3230,7200,1,1,1640,1590,1.39E+06,2000
1830,4992,1,0,1230,600,210000,1953
1420,13187,1,0,1420,0,293000,1974
1580,3774,1.5,0,1580,0,465000,1900
1960,44634,1,0,1130,830,449000,1984
1670,10725,1,0,1670,0,325000,1965
1670,7056,1,0,1670,0,180000,1958
2960,5000,1,0,1790,1170,650000,1968
2420,7102,1,0,1670,750,665000,1946
1420,16000,1,0,1420,0,324450,1966
2170,5750,1,2,1370,800,588000,1975
1310,5200,1.5,0,1160,150,200000,1945
1830,11090,1,0,1060,770,383000,1962
1360,2500,1,0,730,630,499950,1986
3440,12350,1,2,1760,1680,549000,1976
2010,7264,1,0,1290,720,465000,1990
2450,19744,2,0,2450,0,450000,1990
3030,7800,2,0,1580,1450,799900,1991
2480,91911,1,2,1470,1010,495000,1973
4310,10842,2,2,3140,1170,1.20E+06,1988
2120,15000,2,0,2120,0,637000,1983
2210,4366,2,0,2210,0,589000,1901
1400,10350,1,0,1400,0,305000,1976
2760,5200,2,0,1790,970,600000,1910
2550,6256,2,0,2550,0,587000,1992
2220,4000,2,0,2220,0,1.43E+06,2000
1320,11212,1,0,1320,0,250000,1914
2440,3202,2,0,1640,800,515000,1982
3780,10308,2,0,3780,0,833000,1999
4720,32467,2,2,3190,1530,860000,1998
2360,6678,1,0,1760,600,550000,1949
890,6000,1,0,890,0,180000,1919
1770,9375,1,0,1170,600,507000,1968
1720,128066,1,0,1720,0,427000,1994
2490,2722,2,0,2020,470,616950,1999
1890,10550,1,0,1010,880,372000,1969
1020,6380,1,0,1020,0,290000,1930
2420,8438,2,0,2420,0,329990,1997
1600,8156,1,0,1600,0,393500,1948
3370,17458,1,2,2000,1370,1.55E+06,1982
1720,8300,1,0,1720,0,240000,1973
1090,8640,1,0,1090,0,285000,1973
1090,9862,1,0,1090,0,382500,1987
3600,16101,1,0,3600,0,1.93E+06,1951
2760,9471,1,2,1760,1000,800000,1956
2770,24140,2,0,2770,0,550000,1967
2520,15205,1,0,2040,480,387846,1954
1960,16015,1,0,1960,0,367500,1980
1760,4264,2,0,1760,0,780500,1902
1090,6775,1,0,850,240,680000,1950
1960,7875,1,0,1960,0,434400,1968
1220,17172,1,0,1220,0,370000,1947
1730,8073,1,0,1350,380,465000,1971
1830,6925,1,0,1830,0,323000,1979
1600,9921,2,0,1600,0,270000,2009
2040,42693,1,2,2040,0,1.32E+06,1980
2710,6583,2,0,2710,0,560000,2003
1140,4500,1,0,840,300,450000,1907
930,7740,1,0,930,0,290000,1924
1010,21340,1,0,1010,0,354000,1980
2380,5000,2,0,2380,0,705000,1909
1860,7200,1,0,1240,620,445000,1977
1440,11925,1,0,1440,0,229900,1968
2980,5896,2,0,2980,0,610000,2001
2670,5108,2,2,2670,0,535000,2000
2150,8925,1,0,2150,0,437400,1960
3160,10059,2,0,1740,1420,540000,1978
1890,29185,1,0,1470,420,570000,1949
2810,4607,2,0,2810,0,533000,2004
2690,4819,2,0,2690,0,555000,2004
1230,9600,1,0,1230,0,239950,1984
950,9451,1,0,950,0,350000,1977
1200,4880,1,0,980,220,245000,1943
1670,9886,1,0,1670,0,456000,1947
2140,7701,1,0,1470,670,465000,1977
1440,4660,1,2,1440,0,445000,2008
3050,7500,1,0,1800,1250,517850,1966
2570,7260,2,0,2570,0,329000,1996
1840,2875,2,0,1840,0,512500,1997
1250,8100,1,0,1250,0,365000,1947
1410,9384,1,0,1410,0,450500,1948
1560,8232,1,0,1560,0,915000,1952
960,7314,1,0,960,0,205000,1960
1870,8449,2,0,1870,0,314000,1992
900,9260,1,0,900,0,496000,1946
2050,7590,1,0,1280,770,329950,1957
2400,6000,2,0,2400,0,375000,1913
1850,7777,2,0,1850,0,623000,1989
1220,9600,1,0,1220,0,310000,1980
3140,37120,1,0,1760,1380,532500,1984
2410,4560,2,2,1800,610,960000,1929
3130,40918,2,0,3130,0,598000,1994
2300,9218,2,2,2300,0,683000,1998
2840,9425,1,0,1590,1250,425000,1962
1800,3780,1.5,0,1400,400,533000,1926
1190,9486,1,0,1190,0,375000,1953
1710,7225,2,0,1710,0,250500,1988
1900,22896,1.5,0,1360,540,257000,1922
880,18205,1,0,880,0,218000,1945
2060,4437,1,0,1030,1030,460000,1929
1360,6186,1.5,0,760,600,255544,1941
1680,4647,1,0,1680,0,560000,2008
2980,4074,2,0,2980,0,480000,2011
2130,19180,1,0,1500,630,1.30E+06,1968
2650,9752,1,0,2650,0,580000,1989
1700,9100,1,0,1160,540,475000,1998
2680,12215,1,4,1590,1090,1.31E+06,1956
2530,623779,1,0,2530,0,700000,1980
2520,10223,2,0,2520,0,590000,1988
1630,8346,1,0,1630,0,264500,1990
730,2600,1,0,730,0,465000,1918
910,7620,1,2,910,0,290000,1971
4510,12873,2,2,4510,0,1.82E+06,1998
1110,12150,1,0,1110,0,416000,1957
1450,8940,1,0,1450,0,360000,1962
2910,36250,1,0,1590,1320,585083,1977
2600,2750,1.5,0,1620,980,840000,1936
730,9975,1,0,730,0,81000,1943
2440,9200,1,1,2440,0,1.29E+06,1950
2290,7380,1,0,1390,900,326000,1963
720,7500,1,2,720,0,447000,1925
940,7125,1.5,0,940,0,185000,1958
1540,7773,2,0,1540,0,439950,1982
1140,10300,1.5,0,1140,0,234000,1967
2100,8886,2,0,2100,0,485000,1964
2670,6250,2,0,2020,650,750000,1941
2750,5527,2,0,2130,620,865000,1901
2570,9000,1,0,1590,980,287500,1979
1660,9673,1,0,1130,530,375000,1976
1700,8800,1,0,850,850,565000,1969
1530,8306,2,0,1530,0,260000,2010
1260,10900,1,0,1260,0,190000,1943
2760,6420,1,0,1380,1380,399950,1964
1830,7062,2,0,1830,0,275000,1990
2160,4086,1,0,1380,780,528000,1987
1770,9685,1,0,1770,0,315000,1948
2210,5500,1,0,1410,800,614306,1968
4560,14608,2,2,4560,0,1.49E+06,1990
2110,3870,2,0,2110,0,590000,2004
1130,3600,1,0,1130,0,261500,1908
1960,9898,2,0,1960,0,300000,2001
2230,4551,1.5,2,1450,780,439000,1928
2350,13000,1,0,2350,0,277554,1961
1340,8505,1,0,1340,0,215000,1931
2160,17861,2,4,2160,0,1.20E+06,1956
1700,6375,1,0,850,850,420000,1950
1650,3436,2,0,1650,0,485000,2003
1540,8316,1,0,1540,0,202500,1954
3920,8572,2,0,3920,0,710000,2007
3250,6933,2,0,3250,0,535000,2009
1360,7700,1,0,1360,0,260000,1966
1480,7480,1,0,1480,0,254000,1992
2360,5226,2,0,2360,0,600000,2001
1800,2516,2,0,1800,0,285000,2001
2540,20662,2,0,2540,0,800000,1998
1200,13100,1,0,1200,0,165000,1943
710,6960,1,0,710,0,216500,1943
2640,5595,2,0,2640,0,387990,2011
3010,5040,2,0,3010,0,500000,2006
2770,5612,2,0,2770,0,650000,2001
2310,4079,2,0,2310,0,646000,2008
2060,9138,1,0,1430,630,323400,1992
1880,4200,2,0,1880,0,300000,2007
2280,5400,1.5,0,1340,940,712500,1947
1380,3402,1.5,0,1380,0,550000,1900
1180,7537,1,0,1180,0,400000,1969
1650,7200,1,0,1100,550,255000,1977
2030,9032,2,2,2030,0,660000,1963
2110,6375,1,2,1600,510,925000,1941
2130,7210,1,0,1330,800,534000,1965
1690,7700,1,0,1690,0,215000,1969
2510,12779,1.5,4,2510,0,1.95E+06,1968
3530,7924,2,0,3530,0,1.40E+06,2001
1470,8350,1,0,1470,0,212000,1990
1840,7300,1,0,1840,0,265000,1966
1860,5750,1.5,0,1300,560,400000,1918
1940,10133,2,0,1940,0,311500,1992
4420,20759,2,0,4420,0,2.33E+06,2003
800,6050,1,0,800,0,225000,1944
3700,21755,1,4,2620,1080,1.25E+06,1988
1400,8710,1,0,1400,0,380000,1948
2250,11370,2,0,2250,0,600000,1991
2230,9053,2,0,2230,0,600000,1987
1950,3000,2,0,1950,0,315000,2001
2550,4623,2.5,0,2550,0,847000,1905
2750,10351,2,0,2750,0,730000,1998
2290,11137,1,0,2290,0,1.06E+06,1955
2350,17709,2,0,2350,0,1.62E+06,1977
1720,5785,1,0,860,860,664000,1948
2810,6000,2,0,2810,0,454450,2007
940,4200,1,0,940,0,341000,1955
1190,8875,1.5,0,1190,0,276693,1946
1390,11340,1,0,1390,0,185000,1969
1660,2258,2,0,1660,0,160000,1981
1920,8497,2,0,1920,0,270000,1998
1460,8760,1,0,1460,0,300000,1958
1370,10115,1,0,1370,0,264950,1957
1050,6250,1,0,840,210,209950,1943
3360,8708,2,0,3360,0,850000,2006
3160,11380,2,0,3160,0,645000,1983
2480,36974,2,0,2480,0,855000,1973
2720,37258,2,0,2720,0,632500,1994
2070,5013,2,0,2070,0,289950,1987
2170,25732,1,2,2170,0,850000,1952
3260,4900,2,0,3260,0,565000,2013
2250,19270,2,0,2250,0,792000,1999
1950,9600,1,0,1200,750,260000,1987
2220,209523,1,0,2220,0,585000,1991
1330,10523,1,0,1000,330,295500,1981
1190,7877,1.5,0,1190,0,329000,1946
2770,15232,1,0,1570,1200,750000,1976
2310,7555,2,0,2310,0,495000,1997
1580,5750,1,2,1330,250,672500,1947
2800,3200,1.5,0,1910,890,1.31E+06,1932
1500,9636,2,0,1500,0,405000,1994
2140,5808,1,1,1070,1070,620000,1947
2330,7020,1,0,1450,880,615000,1973
3830,11180,1,2,2440,1390,887000,1962
4510,5000,2.5,2,3270,1240,1.06E+06,1941
2160,39430,1,0,1660,500,753000,1974
3170,5000,2,0,2230,940,1.60E+06,1975
5550,28078,2,2,3350,2200,3.71E+06,2000
1520,8519,1,0,1520,0,365000,1954
3410,23000,2,0,3410,0,870000,1982
1830,9601,2,0,1830,0,321000,2003
1550,4486,2,0,1550,0,280000,2000
1520,3593,2,0,1520,0,288000,2004
1240,12285,1,0,620,620,248500,1939
2380,13550,2,0,2380,0,330000,1999
2720,11454,2,0,1830,890,740000,1988
2210,8010,2,0,2210,0,445000,1998
1050,9600,1,0,1050,0,198500,1959
1940,5458,2,0,1940,0,280000,1994
1420,3433,2,0,1420,0,336500,1981
1690,10336,2,0,1690,0,267000,1989
1160,9180,1,0,1160,0,315000,1968
2040,7412,2,0,2040,0,545000,1988
1840,16679,1,0,1840,0,274950,1989
1440,7130,1,2,1210,230,500000,1948
1390,9624,1.5,0,1390,0,299000,1954
1470,1445,2,0,1160,310,420000,2005
1776,1248,3,0,1604,172,620000,2006
1640,12000,1,0,1180,460,575950,1967
2860,6600,2,0,2860,0,666500,2000
1740,7292,1,0,1020,720,180000,1962
1390,18200,1,0,1390,0,261350,1962
2730,5607,1,0,1660,1070,1.03E+06,1948
1435,8960,1,0,1435,0,390000,1969
1640,12384,1,0,1090,550,253500,1954
2630,48706,2,0,2630,0,625000,1986
1580,7800,1,0,1580,0,255000,1959
1740,3721,2,0,1740,0,257000,2009
1900,13122,1,4,1100,800,869000,1954
3130,10860,2,0,3130,0,745000,1990
3500,9525,2,0,3500,0,1.35E+06,1999
2130,7500,1,0,1090,1040,350000,1956
950,1110,2,0,950,0,475000,2003
1720,11656,2,0,1720,0,540000,1987
830,2699,1,0,830,0,175000,1996
660,5240,1,0,660,0,100000,1912
2590,4652,2,0,2310,280,890000,1907
1600,4271,2,0,1600,0,280000,2000
4390,13833,2,3,3320,1070,1.05E+06,2003
3560,12047,2,0,3560,0,486000,1988
2860,68519,2,0,2860,0,670000,1958
1640,7847,2,0,1640,0,480000,1987
1500,6180,1,0,1060,440,440000,1947
3990,8505,2,2,2870,1120,1.50E+06,1922
2610,33206,2,0,2610,0,743700,1988
1470,7590,1,0,1470,0,449950,1988
700,2334,1,0,700,0,367000,1945
3960,12895,2,0,3960,0,1.19E+06,2001
900,7576,1,0,900,0,201000,1959
2010,3800,2,0,2010,0,575000,1922
1940,10350,1,0,1420,520,295000,1979
1510,8760,1,0,1510,0,190000,1946
2020,5000,1,0,1350,670,742500,1952
4430,11453,2,0,3000,1430,875000,2001
4010,10880,2,3,3150,860,1.39E+06,1990
3070,8400,2,0,3070,0,600000,1970
1460,11100,1,0,1460,0,207000,1956
3260,5335,2,0,3260,0,650000,2003
830,5610,1,0,830,0,275000,1922
2390,4200,2,0,2150,240,1.20E+06,1924
1130,7200,1,0,1130,0,262500,1944
1120,8661,1,0,1120,0,399000,1946
1410,10648,1,0,1410,0,139000,1966
1750,4797,2,0,1750,0,575000,1991
1040,3200,1,0,1040,0,580000,1926
1630,2490,2,0,1630,0,468000,2004
1380,10112,1,0,940,440,230000,1963
3680,18804,2,0,3680,0,675000,1990
1250,20040,1,0,1250,0,318000,1970
2660,6978,2,0,1980,680,332100,1996
620,6600,1,0,620,0,175000,1963
2600,10660,2,0,2600,0,817000,1979
2150,8119,2,0,2150,0,1.20E+06,1953
1470,6550,1,2,1070,400,525000,1916
1380,7282,1.5,0,1380,0,189000,1915
1680,1683,2,0,1120,560,629950,2014
1000,9084,1,3,1000,0,641500,1950
1630,7573,1,2,1230,400,490000,1983
1790,15142,1,0,1360,430,415000,1976
890,6380,1,0,890,0,250000,1951
1290,8175,1,0,820,470,781000,1952
2420,7927,1,0,1400,1020,400000,1973
3680,7105,2,2,2890,790,935000,2008
3020,17810,1,0,1600,1420,575000,1979
4240,11189,2,2,4240,0,1.66E+06,2006
3130,9450,1,0,1580,1550,302300,1973
900,6656,1,0,900,0,355000,1940
2880,7599,1,2,1710,1170,1.54E+06,1958
2390,17717,1,0,2390,0,926250,1964
1450,7620,1,0,1050,400,300000,1955
1070,9000,1,0,1070,0,361500,1978
1740,9840,1,0,1740,0,616000,1963
1210,1161,2,0,1210,0,395000,2014
2100,10000,1,0,2100,0,245000,1954
1060,9600,1,0,1060,0,206000,1962
3280,16575,1,0,2190,1090,706000,1972
1660,6000,1.5,0,1660,0,578000,1937
3070,5252,2,0,3070,0,341950,2005
1150,9048,1,0,1150,0,305000,1922
1710,3600,1,0,1590,120,575000,1909
1180,43124,1,0,1180,0,330000,1959
2130,7200,2,0,2130,0,445000,1972
1050,7560,1,0,1050,0,333000,1951
2520,3980,2,0,2520,0,598500,2005
700,6000,1,0,700,0,225000,1943
2640,4200,2,0,2640,0,570000,1998
2330,6783,1,0,1310,1020,630000,1956
2830,7738,2,0,2830,0,779000,1977
3720,13591,2,3,3720,0,760000,2004
1890,9600,1,0,1890,0,322968,1960
2910,7287,2,0,2910,0,595000,1998
1300,18836,1,0,1300,0,321000,1941
2770,57745,2,0,2770,0,653000,1985
2520,21834,1,4,1420,1100,750000,1960
1340,4284,1,0,1080,260,530000,1910
1060,1241,2,0,960,100,352750,2008
2480,8563,2,0,2480,0,424950,1992
2220,4000,1,0,1230,990,427000,1973
3220,5120,2,0,2420,800,558000,2000
1600,5643,1,0,1600,0,438200,1954
640,4800,1,0,640,0,340000,1918
3610,7904,3,0,3290,320,830005,1994
3420,5012,2,0,2330,1090,548000,2008
1840,5101,1,0,1040,800,411715,1952
2790,16117,2,0,2790,0,865000,1999
5860,13928,2,3,4150,1710,1.75E+06,2013
3450,16200,2,0,3450,0,688000,1983
2350,5100,2,0,2350,0,399950,2003
1250,4590,1.5,0,970,280,555000,1903
2000,3207,1,0,1100,900,677000,1916
2260,9568,1,0,1780,480,539000,1985
1510,6597,1,0,950,560,410000,1939
1800,2748,2,0,1800,0,472000,1979
2420,8856,1,3,1620,800,755000,1957
1750,8325,1,0,1750,0,269900,1966
2660,40312,2,0,2660,0,667400,1977
2640,7544,1,0,2640,0,1.22E+06,1995
1460,1613,2,0,1180,280,544000,2007
1570,5000,1.5,3,1570,0,800000,1924
1010,7500,1,0,1010,0,315000,1975
1200,7200,1.5,0,1200,0,227000,1944
4040,25752,2,0,4040,0,765000,2000
1820,1641,3,0,1540,280,625000,2006
5810,7440,2,0,3790,2020,1.88E+06,2004
3010,9600,1,2,1510,1500,822600,1979
1910,8947,1,0,1160,750,515000,1970
1640,5014,1,0,930,710,377000,1982
1480,17360,1,1,1480,0,600000,1954
2520,7770,1,0,1680,840,525300,1965
2840,13554,1,2,1990,850,760000,1974
840,7200,1,0,840,0,202000,1907
1730,38884,1,0,1730,0,470000,1997
3140,10983,2,0,3140,0,810000,1991
1480,8415,1,0,1080,400,175000,1967
1920,7986,1,0,960,960,440000,1952
770,8636,1,0,770,0,197000,1951
1010,7384,1,2,1010,0,254000,1943
1460,10000,1.5,0,1460,0,405000,2002
940,4264,1,0,940,0,416000,1949
2840,4864,3,0,2840,0,779950,2014
1910,7210,1,0,1430,480,200000,1980
2430,8509,2,0,2430,0,658100,1992
1610,4104,1,0,950,660,397000,1996
2780,5002,2,0,2780,0,815000,1999
1160,8504,1,0,1160,0,345000,1949
1850,7199,2,0,1850,0,305500,1989
2120,13090,1,0,2120,0,340000,1997
2620,12763,1,0,1400,1220,330000,1979
2060,3608,2,0,2060,0,269000,2004
1060,9525,1,0,1060,0,349950,1966
1500,6240,1,0,1500,0,431000,1953
2380,5700,2,1,1820,560,735000,1946
3045,5030,2,0,3045,0,414000,1999
1700,4105,2,0,1700,0,619500,1992
1240,13869,1,0,1240,0,675000,1957
1410,7854,1,0,1410,0,380500,1971
880,6600,1,0,880,0,253000,1945
740,9003,1,0,740,0,157500,1949
2030,9300,1,0,2030,0,627000,1976
2090,7241,1,0,1140,950,469500,2001
920,8341,1,0,920,0,319950,1939
1180,7200,1,0,1180,0,249500,1968
1260,3230,1.5,0,1260,0,485000,1907
3690,10260,1,4,2070,1620,1.13E+06,1967
1700,17355,1,0,1200,500,314500,1978
770,8149,1,0,770,0,220000,1948
2020,7800,1,0,1330,690,444950,1958
2030,9825,1,0,1330,700,598000,1985
2690,6164,2,0,2690,0,699850,2002
1750,3354,2,0,1750,0,595000,1991
3270,45537,2,0,3270,0,735000,1993
2330,14289,2,0,2330,0,542500,1978
1720,6960,1,0,1140,580,450000,1978
2420,8800,1,0,1420,1000,298500,1959
710,1136,2,0,710,0,403950,1943
710,4240,1,0,710,0,271000,1942
1510,3844,1,0,1510,0,335000,1923
1610,1968,2,0,1610,0,305000,1979
1880,2200,2,0,1520,360,630000,2007
1220,5000,1,0,860,360,253000,1921
2060,7900,1,0,1070,990,395000,1957
1340,10290,1,0,1140,200,265000,1981
1030,9192,1,0,1030,0,225000,1959
2717,4513,2,0,2717,0,338500,2005
1360,8100,1,0,860,500,300000,1975
1260,7810,2,0,1260,0,255000,1945
2240,8504,2,0,2240,0,337000,1992
2080,9740,2,0,2080,0,324900,1988
2760,8476,1,0,1690,1070,821000,1967
3000,213008,1,0,3000,0,500000,1975
3310,6000,2,2,2200,1110,885000,2010
1630,10375,1,0,1630,0,360000,1968
900,7500,1,0,900,0,304000,1972
880,2400,1,0,760,120,376000,1918
1620,7875,1,0,1620,0,425000,1956
1610,7200,1,0,1090,520,1.18E+06,1973
1730,1803,2,0,1730,0,187000,2005
1640,4080,1.5,0,1540,100,710000,1916
1840,7350,1,0,1370,470,585000,1974
4700,22326,2,0,4700,0,1.40E+06,2002
4500,44384,1,0,3340,1160,1.98E+06,1990
1780,35233,1,0,1420,360,250000,1979
3800,12200,2,3,3800,0,950000,1986
2980,16996,2,0,2980,0,725000,1992
2780,6369,1,0,1590,1190,505000,1978
560,4120,1,0,560,0,90000,1947
2060,3060,2,0,2060,0,400000,1968
1140,7785,1,0,1140,0,407000,1954
1890,4400,1.5,0,1890,0,651000,1919
2090,7450,1,0,1350,740,485000,1978
3460,13168,2,0,3460,0,460000,1932
1320,6135,1,0,880,440,369000,1942
1240,27042,1,1,1000,240,355000,1943
810,4755,1,0,810,0,155000,1980
1880,5450,1.5,0,1880,0,1.00E+06,1924
2680,11590,2,0,2680,0,419625,1988
2040,6880,2,0,2040,0,435000,1954
2180,7876,1,0,1290,890,379000,1977
1870,5371,2,0,1870,0,293000,2009
2310,7851,1,0,1790,520,592100,1989
1120,9730,1,0,1120,0,362000,1944
1340,10035,1,0,1340,0,227000,1959
1260,8487,1,0,1260,0,335500,1970
1200,55321,1.5,0,1200,0,213000,1977
2400,4496,2,0,2400,0,338000,2004
940,7200,1,0,940,0,163500,1954
860,5000,1,0,860,0,199988,1949
2390,7875,1,1,1980,410,1.19E+06,1948
3130,5200,2,0,3130,0,320000,2005
3550,11780,1,0,2960,590,450000,1948
1470,2541,2,0,1470,0,249900,2005
910,9869,1,0,910,0,223000,1957
2630,59586,1,0,1470,1160,631000,1963
1780,10416,1,0,1060,720,350000,1963
1430,39160,1,0,900,530,279000,1925
2730,7344,1,0,1510,1220,310000,1962
900,8000,1,0,900,0,185000,1954
1740,22089,1,0,1130,610,445000,1977
2905,4874,2,0,2905,0,365000,2003
2230,9120,1,0,1390,840,333500,1959
1680,8450,1,0,1340,340,385000,1960
1240,11200,1,0,1240,0,345000,1954
3230,8625,2,3,2220,1010,1.26E+06,1998
2560,10400,1,0,1280,1280,440000,1965
2600,4724,2,0,2600,0,444500,2002
1200,11834,1,3,1200,0,340000,1972
1660,6075,1.5,0,1660,0,680000,1915
1140,8558,1,0,1140,0,420000,1982
3050,10689,2,0,3050,0,438500,1988
800,10625,1,0,800,0,109500,1942
1700,7495,1,0,1200,500,461000,1964
2630,9645,1,0,2630,0,968000,1963
1960,7705,1,0,980,980,355000,1950
1180,11579,1,0,1180,0,249000,1962
1960,7350,1,0,1360,600,256500,1969
4250,20441,1,1,2490,1760,1.81E+06,1984
1950,8661,1,0,1950,0,269000,1966
3600,5217,2,0,2720,880,1.35E+06,1947
2060,9552,1,0,1610,450,885000,1975
1640,9825,1,0,1090,550,455000,1971
2730,4800,1.5,0,2230,500,980000,1909
1530,6300,1,0,1530,0,412500,1942
3060,4777,2,0,3060,0,740000,2007
2860,5658,2,3,2130,730,1.30E+06,1933
1030,798,3,0,1030,0,326000,2008
2460,4200,2,0,2460,0,568500,1998
2500,8282,2,0,2500,0,620000,2013
1830,7600,2,0,1490,340,283000,1947
2820,4536,2,0,1930,890,875000,1917
3750,5000,2,0,2440,1310,1.31E+06,1924
2070,6145,2,0,2070,0,289950,2003
1780,7192,1,0,1250,530,252500,1974
2200,6750,1,0,1480,720,376000,1959
3240,13978,1,0,1860,1380,635700,1977
2880,12349,2,0,2880,0,710000,1996
1570,5120,1,2,980,590,440000,1947
3180,7904,1,0,1810,1370,439000,2006
1310,12196,1.5,0,1310,0,455000,1970
910,9612,1,0,910,0,225000,1981
1460,10914,1,0,1460,0,250000,1959
3410,34939,2,0,2470,940,585000,1992
2720,4720,1.5,0,1580,1140,685000,1925
2280,10319,1,0,1300,980,420000,1959
670,1675,1,0,670,0,245000,1960
1480,15000,1,0,1480,0,275000,1957
2330,8000,1,0,1390,940,270000,1986
2170,2500,2,0,1710,460,767250,1997
1760,9900,1,0,1760,0,229000,1943
1240,4000,1.5,0,1240,0,400000,1928
5210,35765,2.5,4,4940,270,2.20E+06,1911
2800,17788,1,0,1400,1400,665000,1963
2060,44431,2,0,2060,0,500000,1988
2360,19899,1,0,2360,0,355500,1968
2370,6557,2,0,2370,0,369000,1998
720,6050,1,0,720,0,338500,1951
950,4000,1,0,780,170,256000,1949
1980,9725,2,0,1980,0,470000,1994
2540,7680,2,1,2540,0,675000,1940
2760,7533,1,0,1400,1360,369950,1997
2950,7980,2,3,2350,600,615000,2005
3640,28531,2,0,3640,0,1.20E+06,1996
2150,3503,2,0,1870,280,950000,1921
2760,5750,2,0,2760,0,799500,1993
840,11600,1,0,840,0,187000,1952
2890,12478,2,0,2890,0,598000,1977
2060,10160,1,0,1340,720,429950,1967
1700,13500,1.5,0,1700,0,347950,1962
3560,107290,2,0,3560,0,851000,1987
1210,10185,1,0,1210,0,205000,1957
1590,9200,1,0,1110,480,225000,1979
2620,10536,1,0,1520,1100,705000,1979
3190,6178,2,0,3190,0,535000,2003
1450,9044,2,0,1450,0,222500,1990
1270,1282,2,0,1000,270,313500,2006
2730,7521,2,2,2730,0,632000,1992
1840,3432,2,0,1840,0,467000,2012
1970,7210,1,0,1380,590,339000,1978
3200,6699,2,0,3200,0,712000,2004
1060,10050,1,0,1060,0,335000,1967
1740,1693,2,0,1360,380,470000,2007
810,7000,1,0,810,0,367000,1968
2460,4399,2,0,2460,0,440500,2007
2100,9288,1,0,1050,1050,305000,1968
1530,5000,1,2,1020,510,635000,1948
1670,4800,1.5,3,1670,0,1.02E+06,1903
1175,1366,2,0,740,435,342000,2005
2130,8800,1,0,1270,860,283000,1978
2470,50123,1,0,1280,1190,430000,1978
1700,4268,2,0,1700,0,245000,2000
2600,5540,2,0,2600,0,355500,2004
1460,5000,1,0,1460,0,395000,1934
2010,7280,2,0,2010,0,324900,1988
1320,5750,1.5,0,1320,0,660000,1918
3150,20189,2,0,3150,0,570000,1990
1960,8469,2,0,1960,0,552321,1984
2050,11900,1,0,2050,0,1.10E+06,1950
1800,9216,1,0,1800,0,237000,1950
1210,5600,1.5,0,1210,0,402000,1922
1830,39165,1,0,1830,0,470000,1963
1880,8706,1,0,940,940,395900,1927
860,5535,1,0,860,0,442000,1948
2890,16397,2,0,2890,0,795000,1997
1390,10155,1,0,1130,260,190500,1980
3340,7230,2,0,3340,0,808000,1996
2040,6685,2,0,2040,0,500000,1998
3010,15992,2,0,3010,0,775000,1996
2110,8500,1,0,1100,1010,300000,1962
2110,8500,1,0,1100,1010,496000,1962
2510,6853,2,2,2510,0,448000,2006
2770,11884,1,3,1570,1200,645000,1969
1120,5500,1.5,0,1120,0,464600,1925
1530,2370,2,0,1530,0,590000,1901
1800,3300,2,0,1690,110,399000,2004
1030,6000,1,0,1030,0,305000,1925
1210,6175,1,0,1210,0,478000,1976
1090,32010,1,0,1090,0,598800,1958
1790,7203,1,0,1110,680,430000,1973
1550,5053,1,0,1180,370,433000,1963
2400,20000,1,0,1170,1230,420000,1961
2470,131790,2,2,2470,0,585000,1937
1170,7395,1,0,1170,0,255000,1969
1120,10125,1,0,1120,0,305000,1961
1040,4420,1.5,0,1040,0,396000,1944
2460,7350,2,0,2460,0,347500,1989
3690,11468,2,0,3690,0,900000,1987
1960,43332,1,0,1400,560,425000,1982
1920,15124,2,0,1920,0,429000,1995
1670,3135,2,0,1220,450,540000,2002
1340,9750,1,0,890,450,324950,1974
2610,3357,2,0,1980,630,1.05E+06,1926
1540,7200,1,0,1260,280,221000,1966
1640,7201,1,0,1640,0,405000,1948
2100,15120,1,0,2100,0,1.15E+06,1953
1930,7245,1,0,1510,420,588000,1972
1430,10850,1,0,1430,0,234950,1994
2430,4995,1.5,0,1730,700,580000,1928
2460,7240,1,0,1840,620,637000,1991
2490,6973,1,0,1490,1000,704000,1953
880,9750,1,0,880,0,210000,1938
2110,3750,2,0,2110,0,772000,2000
1850,4388,2,0,1850,0,763000,1941
2060,7713,1.5,0,2060,0,213500,1930
1360,9367,1,0,680,680,255000,1924
2000,10490,1,0,1430,570,423500,1978
1810,18483,1,0,1810,0,520000,1954
2230,14400,1,0,1460,770,550000,1977
1820,7517,1,0,1820,0,795000,1997
2740,2811,2,0,2240,500,495000,2003
2710,6558,2,0,2710,0,455000,1997
910,9753,1,0,910,0,85000,1947
1980,10585,1.5,0,1980,0,239000,1924
1040,10080,1,0,1040,0,184900,1959
2810,8560,1,0,1610,1200,386000,1979
2000,5962,2,0,2000,0,415000,1999
1530,6372,1,0,1210,320,387000,1962
5110,7128,2.5,0,5110,0,2.14E+06,1906
3133,16197,2,0,2533,600,685000,1965
2020,32710,1,0,1070,950,340000,1941
750,4000,1,0,750,0,422000,1926
1980,39932,2,0,1980,0,442000,1994
1200,6250,1,0,920,280,280000,1943
3580,8921,2,0,3580,0,1.15E+06,2000
2010,11618,2,0,2010,0,279000,1990
1730,3884,1,0,1060,670,569000,1924
5960,13703,2,2,4770,1190,1.36E+06,1984
860,5080,1,0,860,0,209950,1960
1370,7697,1,0,1370,0,468000,1939
1360,9603,1,0,1360,0,237100,1963
2530,8169,2,0,2530,0,336000,1993
1680,3813,2,0,1680,0,500000,1900
1580,6860,2,0,1580,0,290000,1995
3890,8342,2,4,2840,1050,1.19E+06,1968
1600,4168,1.5,0,1600,0,365000,1927
1200,9668,1,0,1200,0,146300,1975
1760,10780,1,0,1760,0,554000,1977
1670,7700,1,0,1170,500,424000,1972
4640,9827,2,2,3210,1430,1.35E+06,2007
1800,6750,1.5,0,1800,0,508500,1950
1210,8864,1,0,1210,0,244500,1985
1280,1566,2,0,1280,0,206000,2005
1650,7104,2,0,1650,0,643500,1945
1590,10523,2,0,1590,0,372500,1922
1900,5000,1,2,1720,180,630000,1957
1500,3608,2,0,1500,0,418000,2005
2689,6688,2,0,2689,0,425000,2006
3250,5500,2,0,3250,0,800000,2007
960,13438,1,0,960,0,208000,1951
1650,9600,1,0,1650,0,476000,1977
1690,5171,2,0,1690,0,277500,2003
2790,36585,1,0,1410,1380,478000,1970
2310,4020,3,0,2310,0,890000,1979
1790,1288,3,0,1390,400,450000,2000
1230,8750,1,0,1230,0,205000,1965
1620,2640,1.5,0,1620,0,665000,1929
2440,12051,1,0,1440,1000,518000,1966
2100,7350,2,0,2100,0,465000,1979
3040,7232,2,0,3040,0,330000,2003
2490,5064,2,0,2490,0,449400,2007
2690,10443,1,0,2690,0,829000,2007
2190,9752,1,0,2190,0,450000,1964
1490,9120,1,0,1490,0,310000,1959
2530,45234,2,0,2530,0,615000,1985
2060,4040,1,0,1120,940,605000,1947
1970,35100,2,0,1970,0,437500,1977
1400,4000,1.5,0,1400,0,545000,1925
3680,35617,1,0,2390,1290,770000,1985
3000,13899,2,0,3000,0,600000,1975
1440,5000,2,0,1440,0,560000,1910
7730,230868,2,0,6660,1070,1.92E+06,2004
1170,3348,1.5,0,1170,0,457000,1924
1770,8640,1.5,0,1520,250,585000,1949
1860,13374,1,0,1860,0,560000,1985
770,3008,1,0,770,0,345000,1917
3820,17745,2,2,2440,1380,550000,1955
3190,8195,2,0,3190,0,589950,2006
1320,13200,1,0,1320,0,327000,1970
1730,31491,2,2,1730,0,800000,1947
1010,25000,1,0,1010,0,150000,1966
1140,1182,3,0,1140,0,425000,2007
860,7030,1,0,860,0,350000,1973
1540,10545,2,0,1540,0,273000,1978
2160,9525,1,0,1080,1080,750000,1961
1450,9477,1,0,1450,0,240000,1963
1830,9620,1,0,1830,0,400000,1978
1630,6625,1,0,980,650,230000,1980
2500,8215,2,0,2500,0,372000,1990
1470,4950,1,0,1030,440,459500,1984
2380,19860,2,0,2380,0,582000,1995
2170,7700,1,0,1420,750,465000,1969
2120,7560,1,0,2120,0,386000,1991
1530,3464,2,0,1530,0,546000,1998
2710,9088,1,0,2060,650,278000,1965
2860,8935,2,0,2860,0,540000,2004
2800,90169,2,0,2800,0,529000,1934
1120,7104,1.5,0,1120,0,554000,1946
1730,7210,1,0,1430,300,210000,1963
1010,5408,1,0,1010,0,225000,1926
2350,6624,2,0,2350,0,561600,1990
2860,5682,2,0,2860,0,300000,1978
4285,9567,2,1,3485,800,1.65E+06,1946
4060,19290,2,0,4060,0,1.02E+06,2002
1310,9612,1,0,960,350,150000,1962
2320,6250,1,0,1400,920,400950,1948
2210,8101,2,0,2210,0,620000,1985
2090,14141,1.5,0,1680,410,449000,1941
2240,4025,1,2,1250,990,630000,1926
1180,7200,1,0,1180,0,336000,1949
1560,31299,1,0,1560,0,299950,1965
1970,7451,1,0,1350,620,352500,1962
840,12750,1,0,840,0,150000,1925
840,12750,1,0,840,0,175000,1925
1830,10873,1,0,1830,0,305000,1989
4475,20424,2,4,2659,1816,2.57E+06,1999
1800,4700,1,0,1200,600,607500,1941
1250,5040,1,0,950,300,505000,1920
2440,10179,1,0,1220,1220,280500,1962
2910,12283,2,2,2910,0,610000,1993
3060,6895,2,0,3060,0,381000,2003
2230,9600,1,0,1320,910,482000,1978
1270,6900,1,0,1270,0,379950,1977
4300,19844,2,0,4300,0,2.50E+06,1985
1580,39189,1,0,1180,400,425000,1992
2570,36465,2,0,2570,0,580000,1980
860,6510,1,0,860,0,605000,1952
820,1060,1,0,760,60,194000,2007
2090,8579,2,0,2090,0,546200,1987
3560,16782,2,0,2560,1000,1.40E+06,2014
1860,9629,1,0,1240,620,315000,1961
900,8690,1.5,0,900,0,465000,1941
1160,32251,1,0,580,580,330000,1963
3100,7501,2,0,3100,0,795000,1998
2300,9100,1,0,1280,1020,265000,1977
3110,11857,2,4,2040,1070,1.30E+06,1990
1130,12212,1,0,1130,0,126500,1942
2920,7901,2,0,2920,0,760000,2004
1230,1569,2,0,1050,180,540000,2009
2190,12687,1,0,1370,820,446000,1978
850,5600,1,2,850,0,170000,1903
1500,7420,1,0,1000,500,379000,1972
4620,5508,2.5,0,3870,750,1.40E+06,1915
3150,7035,2,0,3150,0,800000,2004
1300,10139,1,0,1300,0,260000,1962
3160,8000,1,0,1580,1580,820000,1960
2070,96703,1,3,2070,0,449950,1999
1790,7125,1,0,1220,570,392000,1974
1650,4636,2,0,1650,0,465000,1999
2070,7312,1,0,1230,840,449950,1977
1580,8841,1.5,0,1180,400,520000,1923
2170,10000,1,0,1420,750,546800,1975
2220,11925,1,0,1560,660,825000,1953
1440,11364,1,0,1440,0,337000,1985
720,6686,1,0,720,0,333000,1942
1120,780,2,0,760,360,380000,2004
1970,8426,2,0,1970,0,280000,1992
1420,9081,1,0,1420,0,202000,1990
2250,4119,2,0,2250,0,585000,2001
2630,9663,1,1,1330,1300,435000,1956
4740,172497,2,0,4740,0,1.20E+06,2003
1280,2574,2,0,1280,0,364000,1992
1260,8280,1,0,1260,0,300000,1946
1930,4601,1,0,1930,0,558000,2006
1048,4800,1,0,1048,0,199950,1942
1640,8400,1,0,1640,0,515000,1962
2380,4950,2,0,2380,0,590000,2004
2530,15520,1,0,2220,310,813500,1964
2700,25870,2,0,2700,0,725000,1992
2330,3600,1.5,0,2330,0,490000,1971
2160,9612,2,0,2160,0,277000,1994
1470,70800,1,0,1470,0,325000,1976
2280,9827,2,0,2280,0,649800,1995
1280,3200,1.5,0,1280,0,425000,1903
850,4650,1,0,850,0,460000,1975
4610,81935,2,0,4610,0,750000,1984
2690,11745,1,0,1790,900,469000,1960
2440,5000,1,0,1340,1100,566000,1954
1930,10460,2,0,1930,0,407500,1996
800,8775,1,0,800,0,353500,1942
2430,73151,1,0,2430,0,524000,1974
1990,9656,2,0,1990,0,264950,1994
2550,10355,2,0,2550,0,547500,1990
1370,7087,2,0,1370,0,264500,1993
2020,8118,1,0,1020,1000,507500,1963
1560,2198,2,0,1180,380,560000,2006
5610,22529,2,0,4090,1520,995000,1996
3560,5120,2.5,2,3560,0,835000,1900
2120,6290,1,0,1220,900,440000,1949
2920,5629,1,2,1460,1460,1.02E+06,1955
1340,7788,1,2,1340,0,300000,1947
1230,4800,1.5,0,1230,0,125000,1916
2840,5900,2,0,1920,920,986000,1910
2080,5650,1,0,1680,400,315000,1950
2070,7007,2,0,2070,0,320000,1996
4010,13797,2,0,4010,0,972000,2003
2190,10000,1,0,1540,650,760000,1957
1730,7264,2,0,1730,0,265000,1920
1250,4558,1,0,1250,0,355000,1948
1300,20812,1,0,1300,0,300000,1927
2080,8347,1,0,1460,620,474950,1975
2180,17180,2,0,2180,0,470000,1977
1630,16393,1,0,1630,0,437500,1969
1840,3825,1,0,1040,800,520000,1928
1370,11584,1,0,1370,0,237600,1950
950,2784,1,0,950,0,162950,1972
1690,6375,1,0,1690,0,457000,1903
1780,11000,1,0,1210,570,635000,1980
2840,4120,1.5,0,2060,780,735000,1931
2000,5150,2,4,2000,0,910000,1992
1570,2048,2,0,1290,280,346500,2006
2370,9517,1,0,1630,740,655000,1984
1610,144619,1,0,1610,0,425000,1977
1300,10125,1,0,1300,0,137000,1959
2620,11056,2,0,2620,0,557500,1988
3060,48787,2,0,3060,0,415000,1992
2780,10192,2,0,2780,0,830000,1978
4270,85643,2,0,4270,0,949000,1991
1310,3963,1,0,1310,0,420000,1986
1100,7500,1,0,1100,0,353000,1951
1480,383328,1.5,0,1480,0,560000,1980
1270,1180,3,0,1270,0,445700,2001
1270,6459,1.5,0,1270,0,226000,1918
890,9870,1,0,890,0,358000,1960
1480,8667,1,0,740,740,501000,1954
3240,23870,1,0,1840,1400,609000,1972
4280,47179,2,0,3050,1230,734950,2002
3210,12000,1,0,1830,1380,725000,1968
1870,7200,1,0,1390,480,350500,1975
3990,3839,1,0,1990,2000,610000,1962
1160,5029,1,0,910,250,605125,1940
2940,20384,2,0,2940,0,1.39E+06,1970
1850,37264,2,0,1850,0,550000,1981
1060,1202,2,0,760,300,335000,2003
1100,9165,1,0,1100,0,397000,1969
1190,10299,1,0,1190,0,240000,1994
1030,11118,1,0,1030,0,240000,1970
1140,14373,1,0,1140,0,262500,1949
2260,5300,1,0,1200,1060,440000,1940
1140,3240,1.5,0,1140,0,160000,1910
1860,4736,1.5,0,1860,0,427000,1901
4080,10666,2,0,4080,0,920000,2005
3280,7100,2,4,2180,1100,2.30E+06,1911
2870,35757,2,0,2870,0,480000,1977
2300,11700,1,0,1960,340,615000,1977
2230,4800,1.5,0,1290,940,736500,1915
1920,1649,2.5,0,1600,320,542500,2004
700,5000,1,0,700,0,191000,1952
2740,11975,2,0,2740,0,730000,1991
3440,5000,2,2,3440,0,1.23E+06,1901
650,15364,1,0,650,0,129000,1967
1500,10018,1,0,1500,0,284000,1957
2490,5978,2,0,2490,0,645000,2003
1330,7600,1,0,1330,0,218000,1968
3190,6875,2,2,2120,1070,675000,1999
1590,2910,2,0,1110,480,575000,1984
830,5720,1,0,830,0,225000,1950
1810,5107,2,0,1810,0,626000,1989
2910,20067,2,0,2910,0,499950,2001
2180,13529,1,0,1090,1090,405000,1956
1090,3523,1,0,1090,0,152500,1969
2160,6825,2,0,2160,0,325000,1994
2110,10005,1,0,1110,1000,475300,1924
2180,7318,1,0,1210,970,485000,1967
2100,2200,2,0,1500,600,720000,1919
1410,6886,1,0,1410,0,465000,1924
1020,9072,1,0,920,100,489000,1930
5090,23669,2,0,5090,0,3.10E+06,2006
2090,7500,1,0,1280,810,288000,1977
1350,9793,1,0,1350,0,225000,1968
2650,11774,1,1,2240,410,499000,1952
3520,36558,2,0,2100,1420,632000,1985
2040,4627,2,0,2040,0,580000,1992
2340,5000,2,0,2100,240,730000,1912
1770,7799,2,0,1770,0,325000,1998
1100,8662,1,0,1100,0,421000,1964
1490,4078,2,0,1490,0,316000,1998
1460,4200,1,0,880,580,415000,1914
1350,2839,2,0,1350,0,401000,2003
1030,12700,1,0,1030,0,229950,1944
1820,9875,1,0,1820,0,539950,1966
1170,5360,1,0,1170,0,335000,1919
1450,3748,2,0,1450,0,339000,2004
2200,8545,1,0,1100,1100,414950,1918
1610,8976,1,0,1610,0,650000,1966
2690,21883,2,0,2690,0,445000,1994
1850,7800,2,0,1850,0,295000,1974
2250,3600,2,0,2010,240,975000,1912
1580,10100,1,0,1580,0,296500,1961
2030,56192,1,0,1550,480,440000,1979
1890,10880,1,0,1890,0,420000,1962
2140,9492,2,0,2140,0,302000,1994
1770,7336,1,0,1770,0,350000,1986
3320,478288,1.5,3,2260,1060,667000,1933
1640,4218,1,0,910,730,645000,1941
1820,5400,1,0,1220,600,430000,1988
1410,6000,1,0,810,600,413000,1925
1240,7300,1,0,1240,0,420000,1968
1780,8050,1,0,1230,550,495000,1979
4240,13162,2,0,4240,0,2.19E+06,2004
3570,17411,2,0,3570,0,965000,1990
1900,5001,1,0,1200,700,500000,2008
1010,6000,1.5,0,1010,0,636100,1919
2870,12648,2,0,2870,0,720000,1986
1620,12825,1,0,1340,280,298000,1962
1480,4000,1,0,740,740,409000,1925
2650,5706,2,0,2650,0,370000,2005
1410,9000,1,0,1410,0,230000,1967
1360,6685,1,0,1360,0,290000,1952
2930,9840,1,0,1560,1370,420000,1977
3500,10891,2,2,3500,0,917000,1995
3160,5000,2,2,2180,980,957000,2005
1710,21485,2,0,1710,0,482000,1989
2180,14734,2,0,2180,0,488000,1990
2870,4712,2,0,2870,0,760369,2014
1500,18540,1,0,1500,0,170000,1950
2120,10021,1,0,1230,890,625000,1976
1590,6750,1,0,1080,510,357000,1976
1830,8276,1,0,1350,480,583000,1989
1210,9097,1,0,1210,0,173250,1954
1590,10331,1.5,0,1590,0,414050,1956
1050,6150,1.5,0,950,100,400000,1928
1550,27003,1.5,0,1550,0,537000,1982
2070,7500,2,0,2070,0,465000,1977
1740,9682,1,0,1740,0,425000,1969
1700,21780,1,0,1080,620,445000,1940
1200,9000,1,0,1200,0,179950,1958
1710,7230,2,0,1710,0,275000,1996
1840,13493,2,0,1840,0,190000,1994
1900,5520,1,0,1280,620,385000,1982
2300,9583,1,0,1220,1080,303000,1928
970,7503,1,0,970,0,165000,1967
1270,5000,1,0,1270,0,600000,1944
3130,65775,2,0,3130,0,710000,1978
4230,21455,2,0,2720,1510,875000,1990
1480,9743,2,0,1480,0,269950,1996
3310,42998,2,0,3310,0,838000,2001
1590,6750,1,0,1590,0,670500,1951
1690,9391,1,0,1290,400,420000,1960
1690,161913,1,0,1430,260,370000,1952
1500,7200,1,0,1500,0,360000,1957
2320,8721,2,0,2320,0,562500,1991
3300,11525,1,0,1650,1650,360500,1961
1445,1471,2,0,1300,145,389999,2003
1890,13140,1,0,1270,620,450000,1967
1760,8400,1,0,1060,700,247500,1962
1050,6240,1,0,1050,0,208000,1948
1980,7309,2,0,1980,0,455000,1993
2120,7680,1,0,1060,1060,379400,1950
760,40039,1,0,760,0,190000,1906
1300,8800,1,0,1300,0,326188,1977
1160,2174,2,0,1160,0,168000,1998
2340,8990,2,0,2340,0,314000,2003
2710,37277,2,0,2710,0,630000,2000
1440,8957,1,0,1440,0,550000,1957
1980,15086,2,0,1980,0,530000,1981
1680,10685,1,0,1680,0,637500,1966
1390,2815,2,0,1390,0,400000,1999
3100,9825,2,2,3100,0,700000,1950
1680,8512,2,0,1680,0,272000,1991
2710,6474,2,0,2710,0,600000,2004
840,7020,1.5,0,840,0,450600,1943
2090,8095,2,2,2090,0,550000,1988
1120,8407,1,0,1120,0,225000,1987
1210,5200,1,0,1210,0,132825,1969
1210,5200,1,0,1210,0,219950,1969
1940,6000,1,0,970,970,580000,1945
1930,213008,1,2,1300,630,568000,1980
1270,6017,1,0,1030,240,406000,1990
1680,2400,1.5,0,1170,510,469000,1929
2090,6045,2,0,2090,0,415000,2000
1000,13991,1,0,1000,0,390000,1956
1350,10125,1,0,1350,0,251000,1967
3280,6750,2,1,2440,840,750000,2001
2390,5071,2,0,1760,630,845000,1988
1860,17640,1,0,1860,0,350000,1966
1380,5864,1,0,790,590,322000,1944
3070,9210,2,0,2740,330,664500,2010
2190,3800,1.5,2,2190,0,988000,1923
1990,4000,1,0,1090,900,625000,1952
930,36478,1,2,930,0,675000,1951
2070,9827,1,0,1420,650,503000,1967
2170,10500,1,2,1270,900,431000,1960
1910,10230,1,0,1290,620,250000,1964
2100,4237,2,0,2100,0,268500,2006
3560,21400,2,4,3560,0,1.07E+06,1952
2290,4539,2,0,2290,0,295000,2001
2130,11782,1,0,1590,540,780000,1977
2160,15817,2,0,2160,0,354000,1999
860,7250,1,0,860,0,305000,1949
2880,4425,2,0,2880,0,733000,2005
2100,11894,1,0,1720,380,640000,1968
2360,9600,1,2,1630,730,840000,1973
3680,10300,1.5,0,3680,0,1.48E+06,1927
1560,8100,1,0,1140,420,525000,1952
1680,11180,1,0,1680,0,625000,1966
1380,3600,3,0,1380,0,350000,2015
2610,4160,3,0,1910,700,650000,1910
870,4000,1,2,870,0,435000,1950
1210,9622,1,1,1210,0,660000,1955
1150,12877,1,0,1150,0,350000,1970
3110,6000,1,2,1560,1550,435000,1967
2550,33740,1,0,1750,800,375900,1958
2430,10500,1,0,2150,280,272000,1983
1460,7800,1,0,1040,420,233000,1979
1330,5750,1.5,2,1330,0,500000,1915
2040,9322,1,0,1440,600,540000,1977
2375,4094,2,0,2375,0,712000,2002
2480,4504,2,0,2480,0,425000,2005
1580,6099,1,0,790,790,242000,1944
2740,9629,1,0,1390,1350,515000,1977
1920,7700,2,0,1920,0,415000,1970
2200,9600,1,3,1570,630,375000,1977
910,7194,1,0,910,0,182500,1971
1860,10379,1,0,1240,620,310000,1963
1510,6000,1,0,1060,450,360000,1947
3920,9555,2,0,3920,0,889000,2004
1330,3698,1,0,1330,0,450500,1952
1964,3541,2,0,1964,0,342000,2013
1520,3451,1,0,1520,0,413000,1996
3720,15200,2,0,3720,0,960000,2005
770,9370,1,0,770,0,180000,1947
3210,14910,2,0,3210,0,770000,1995
1070,7200,1,0,1070,0,224400,1994
1430,8861,1,0,1430,0,280000,1956
1670,2575,2,0,1670,0,500000,2000
710,9000,1,0,710,0,153000,1943
1920,4833,1,0,1060,860,385000,1921
750,5534,1,0,750,0,325000,1947
2210,4191,2,0,2210,0,315000,2004
1660,9760,2,0,1660,0,294999,1994
1910,17003,1.5,0,1910,0,175000,1963
1910,17003,1.5,0,1910,0,299000,1963
780,9750,1,0,780,0,146000,1937
1650,10336,1,0,1500,150,290000,1962
3230,7800,2,3,3230,0,1.78E+06,2005
810,4800,1,0,810,0,367500,1919
2750,15099,2,0,2750,0,535000,1994
1650,13816,2,0,1650,0,334999,1998
1960,5520,1,0,1080,880,655000,1952
2790,10125,1.5,0,2790,0,1.30E+06,1985
2230,11200,1,0,1300,930,480000,1977
1280,4720,1,0,850,430,465000,1941
1240,10800,1,0,1240,0,297950,1967
1860,3600,1.5,0,1110,750,590000,1915
2410,6000,1,0,1410,1000,805000,1950
1960,7708,1,0,1490,470,204250,1984
1710,4561,2,0,1710,0,500000,1994
3480,12696,1,0,1980,1500,490000,1977
3480,14850,1,4,1870,1610,2.50E+06,1951
2960,69351,2,3,2960,0,750000,1990
2670,20894,2,0,2330,340,405000,2002
700,7303,1,0,700,0,209995,1953
2830,8399,2,0,2830,0,680000,1998
1120,7740,1,0,860,260,355000,1948
1310,6600,1,0,1310,0,280000,1942
1710,11500,1,0,1210,500,385000,1978
2200,9778,1,0,1100,1100,505000,1962
3310,8897,2,0,2380,930,429900,1991
2280,9874,2,0,2280,0,560000,1989
1640,4875,1,0,1040,600,231000,1977
750,5217,1,0,750,0,135000,1943
3520,4895,1,0,1980,1540,800000,1954
2720,8622,2,0,2720,0,420000,2002
1660,9600,1,0,1660,0,360000,1963
2560,8780,2,0,2560,0,642000,1992
1080,5077,1,0,1080,0,379950,1985
2050,11041,1.5,0,2050,0,745000,1959
2670,3240,1.5,0,1780,890,630000,1930
1730,7200,2,0,1730,0,250000,1985
990,9798,1,0,990,0,275000,1968
3560,4290,1,0,1780,1780,435000,1957
700,8174,1,0,700,0,175000,1941
1880,3880,1.5,0,1090,790,560000,1944
1870,9680,1,0,1170,700,325000,1959
2500,5568,2,0,2500,0,1.19E+06,1905
2570,10431,2,0,2570,0,399950,1989
2940,10382,2,0,2940,0,752000,1991
3930,43560,2,0,3930,0,1.20E+06,2003
2150,11026,1,0,2150,0,400000,1952
1330,6000,1,0,630,700,240000,1900
3220,4759,2,0,3220,0,640000,2003
2710,6174,2,0,2710,0,564450,1998
1630,82764,1,0,1630,0,300000,1948
1680,4226,2,0,1680,0,286000,2003
1930,5344,2,0,1930,0,531800,2004
2140,10943,1,0,1550,590,502000,1977
4070,23321,2,0,4070,0,993500,1968
1350,10000,1,0,1350,0,450000,1954
4270,117176,2,0,4270,0,997950,2008
1320,5250,1.5,0,1320,0,526000,1913
2100,8298,1,0,1230,870,335000,1952
710,14700,1,0,710,0,187250,1926
2350,6000,1,0,1020,1330,735000,1948
1180,8400,1,0,1180,0,425000,1951
1250,53143,1,0,1250,0,110000,1945
1490,7697,1,0,1490,0,305000,1994
1000,9450,1,0,1000,0,212000,1962
4050,18827,1,2,2150,1900,1.38E+06,1979
2300,11505,1,0,1300,1000,298950,1963
1330,8136,1,0,1330,0,525000,1977
3200,7081,2,0,3200,0,707000,2004
2590,12063,2,0,2590,0,695000,1993
2590,12063,2,0,2590,0,796500,1993
2030,8100,1,0,1150,880,420000,1973
2700,21208,1,0,1950,750,625000,1955
1670,9900,1,0,1670,0,620000,1957
3090,19865,1,0,3090,0,1.45E+06,1953
2650,54380,2,0,2650,0,549950,1984
1440,10920,1,0,1440,0,275000,1943
2820,7200,1,3,1780,1040,705000,1979
1690,7735,1,0,1060,630,197000,1976
1420,8126,1,0,1420,0,265000,1991
1790,5341,1,0,1050,740,297000,1951
1320,12528,1,0,1320,0,207500,1970
1509,1418,3,0,1509,0,410000,2014
1610,8416,1,0,1610,0,268000,1994
1550,50094,1,3,1550,0,330000,1967
1160,7491,1,0,1160,0,417500,1917
2500,8500,2,0,2500,0,760000,1979
1540,1326,3,0,1390,150,499000,1995
1910,7683,2,0,1910,0,620000,1987
2340,6837,2,0,2340,0,315000,1992
2060,4730,2,0,2060,0,624950,1994
1960,12350,1,0,1960,0,525000,1961
1150,3927,2,0,1150,0,300000,1982
2330,7200,1,0,1560,770,299900,1977
2210,10119,1,0,1450,760,299000,1966
3260,19542,1,0,2170,1090,1.88E+06,1968
1900,10588,1,0,1900,0,265000,1958
1610,158558,1.5,0,1610,0,280000,1948
1340,15600,1,0,1340,0,124740,1978
3170,34850,1,0,3170,0,1.09E+06,1957
4440,6480,2,3,3140,1300,1.97E+06,1959
1370,5339,1.5,0,1370,0,219000,1948
1420,6250,1.5,0,1420,0,569950,1926
1030,21712,1,0,1030,0,212500,1938
1820,8316,1,0,1320,500,680000,1960
2650,6900,2,0,2400,250,1.46E+06,1909
910,7700,1,0,910,0,300000,1971
1680,1683,2,0,1120,560,629950,2014
1550,9230,1,0,970,580,349900,1969
2780,6235,2,0,2780,0,690000,2001
4070,11334,2,0,4070,0,1.45E+06,2014
3240,12625,2,0,3240,0,1.29E+06,1987
3650,38546,2,0,2550,1100,696000,1996
2180,60112,2,0,2180,0,650000,1976
2480,10800,2,0,2480,0,640000,1998
3180,23809,1,0,3180,0,499950,1978
3630,8387,2,0,3630,0,490000,1997
3160,5635,2,0,3160,0,685000,2003
1370,7140,2,0,1370,0,387500,1942
1070,1236,2,0,1000,70,401750,2005
2180,8800,1,0,1170,1010,254950,1977
2420,36680,2,0,2420,0,500000,1977
3290,8147,2,0,3290,0,856500,2003
1430,5000,1,0,1080,350,552000,1919
1890,7200,1,0,1500,390,506500,1978
1760,4539,2,0,1760,0,500000,1988
2230,10160,1,0,1400,830,280000,1968
1630,11475,1,0,1330,300,308000,1979
2350,7035,2,0,2350,0,613500,1989
1550,9720,1,0,1050,500,255000,1976
3550,136343,2,0,3550,0,545000,1977
2720,34498,1,0,1360,1360,620000,1966
1740,6800,1.5,0,1740,0,450000,1949
1840,7275,1,0,1090,750,279000,1976
2010,3200,2,0,2010,0,625000,2009
1670,7415,1,0,1320,350,274950,1987
1820,6038,1,0,1040,780,423000,1952
720,5820,1,1,720,0,350000,1950
2370,10140,1,0,1460,910,305000,1968
2120,11340,1,3,1060,1060,368000,1966
1290,6604,1,0,1290,0,232000,1984
1800,2500,2,0,1800,0,250000,2000
1230,8917,1,0,1230,0,220000,1966
1380,2500,1,0,750,630,435000,1986
740,7680,1,0,740,0,350000,1922
1720,10202,1.5,0,1720,0,206325,1970
1720,10202,1.5,0,1720,0,339000,1970
2100,7355,1,0,2100,0,399000,1969
1210,7667,1,0,900,310,529000,1950
2210,7722,2,0,2210,0,640000,1999
2470,2550,3,0,2470,0,735000,2004
2760,8015,1,0,1600,1160,378000,1960
2540,7200,1.5,3,1600,940,775000,1905
5150,7800,2.5,2,4170,980,2.25E+06,1954
3420,7440,3,0,3420,0,1.35E+06,2014
2270,11500,1,0,1540,730,380000,1967
2270,11500,1,0,1540,730,624900,1967
1470,1779,2,0,1160,310,379770,2005
1280,16200,1,0,1030,250,340000,1976
2830,8126,2,0,2830,0,515500,2005
1970,7125,1.5,0,1500,470,600000,1908
1390,60984,1,0,1390,0,400000,1960
1020,11383,1.5,0,1020,0,364000,1947
2250,7526,2,0,2250,0,440000,1989
800,6240,1,0,800,0,285000,1954
1560,4500,1.5,0,1560,0,669000,1915
2100,13468,1,0,1050,1050,475000,1962
990,4000,1,0,990,0,747000,1911
1060,5750,1,0,1060,0,317000,1981
1270,8164,1,0,1270,0,390000,1941
2740,5000,2,0,2740,0,1.07E+06,2012
2470,5500,1,3,1570,900,1.21E+06,1960
1970,5100,1,0,1130,840,580000,1908
2070,10244,1,0,1370,700,518000,1969
1010,6552,1,0,1010,0,147500,1969
2220,8125,1,0,1450,770,555000,1965
1090,934,3,0,1090,0,427500,2008
4310,32093,1.5,4,2510,1800,1.74E+06,1982
1490,3840,2,0,1490,0,265950,2002
700,6046,1,0,700,0,247500,1950
1450,8960,1,0,1450,0,244000,1943
2120,6602,2,0,2120,0,578550,1989
1670,3315,2,0,1670,0,451000,2005
1810,4220,2,0,1810,0,489000,2004
710,1164794,1,0,710,0,190000,1915
2540,18900,1,0,1580,960,475000,1978
1420,4080,1.5,0,1420,0,485000,1905
2440,45738,2,0,1840,600,530000,1987
2570,10155,2,0,2570,0,379000,1994
3090,16583,2,0,3090,0,1.63E+06,1964
2050,5160,1.5,0,1300,750,739000,1926
920,6460,1,0,920,0,189950,1969
2320,4468,2,0,2160,160,637500,1999
3450,16740,1,4,1960,1490,2.23E+06,1949
1660,8800,1,0,960,700,209950,1963
1130,7000,1,0,830,300,460000,1944
2550,5835,2,0,2550,0,543500,1998
2420,5773,2,0,2420,0,376000,2005
1470,1703,2,0,1470,0,430000,2005
2030,39049,1,0,1530,500,515000,1953
2310,2400,1.5,0,2310,0,580000,1915
3370,16846,2,1,2650,720,600000,1998
1900,43700,1.5,0,1900,0,476800,1919
1940,3570,2,0,1740,200,815000,1916
2420,8252,2,0,2420,0,455600,1998
1010,9514,1,0,1010,0,270000,1969
2710,2800,3,0,2380,330,1.20E+06,1974
1340,3600,1.5,0,1340,0,525000,1903
1310,9645,1,0,1310,0,242000,1979
2650,30500,1,0,1680,970,715000,1960
1890,3938,2,0,1890,0,475000,1999
2580,5511,2,0,2580,0,370000,1999
3500,7200,2,0,3500,0,788600,2005
1040,13100,1,0,1040,0,160000,1912
1930,501376,2,0,1930,0,800000,1930
2190,5085,2,0,2190,0,520000,1992
1530,4000,2,0,1530,0,725000,1985
1480,6500,1.5,0,1480,0,335000,1914
3620,17133,1,4,2220,1400,919000,1993
3370,13929,2,0,2650,720,425000,1986
2100,14395,1,0,1140,960,420000,1983
3370,47959,2,0,3370,0,905000,1981
2240,7200,1,0,1120,1120,435000,1940
1650,3031,2,0,1650,0,438000,2003
2630,7505,2,0,2630,0,725000,1994
2330,4000,2,0,1300,1030,840000,1924
1970,2752,2,0,1970,0,425500,1978
2820,14890,1,4,1770,1050,853505,1985
590,10945,1.5,0,590,0,398000,1983
2060,4399,2,0,2060,0,418500,2007
1890,5000,1.5,0,1890,0,826000,1929
2810,10986,2,0,2810,0,742000,1997
1470,18581,1.5,0,1470,0,180000,1924
2190,8400,2,0,2190,0,286000,1978
1440,3060,2,0,1440,0,421200,2003
2480,14141,1,0,1500,980,390000,1994
2780,6737,2,0,2780,0,739000,2002
2180,12196,2,0,2180,0,499900,1968
3340,13805,1,0,3340,0,670000,1950
2560,3996,1.5,0,2150,410,842500,1910
1600,80400,2,0,1600,0,492500,1978
2230,7200,3,3,2230,0,836500,1996
900,1818,2,0,900,0,334000,1945
1010,9920,1,0,1010,0,179900,1977
1580,5289,1,0,870,710,563000,1940
1890,6300,2,0,1890,0,310000,2003
2160,8817,1,0,1460,700,335000,1965
2160,8817,1,0,1460,700,499950,1965
1410,5101,1.5,0,1410,0,658500,1927
1430,1650,3,0,1430,0,297000,1999
2380,4080,2,0,2380,0,725000,1917
2206,82031,1,2,866,1340,780000,1983
1030,6127,1,0,880,150,252500,1947
1070,1155,2,0,720,350,330000,2005
2320,9610,1,0,1730,590,525000,1990
1270,7500,1,0,1270,0,365000,1982
2570,9104,2,2,2570,0,500000,1930
920,4875,1,0,920,0,179950,1969
1790,32379,1,0,1790,0,440000,2007
480,9750,1,0,480,0,145000,1948
2483,5701,2,0,2483,0,331000,2005
2140,3000,2,0,2140,0,780000,1905
1900,4000,1,0,1300,600,855000,1965
1650,7739,1,0,1290,360,225000,1986
1510,9100,1,0,1510,0,199000,1966
2910,35200,1.5,0,2910,0,550000,1979
4960,6000,2.5,0,3680,1280,1.43E+06,1909
2710,4500,1.5,0,1880,830,805000,1929
1810,29308,1,0,950,860,261000,1983
940,9198,1,0,940,0,347000,1968
1600,10240,1,0,1090,510,390000,1979
2640,3899,2,0,2640,0,436000,2000
3890,20005,1,0,2260,1630,1.80E+06,1977
1630,1587,3,0,1630,0,557000,2004
830,9600,1,0,830,0,135000,1959
1800,14036,2,0,1800,0,425000,1993
2060,9953,1,0,1070,990,648752,1964
4040,20001,1,0,2020,2020,1.39E+06,1972
1910,11356,1,0,1160,750,630100,1977
2800,246114,2,0,2800,0,739000,1999
1320,2625,2,0,1320,0,269000,1986
1220,5038,1,0,1220,0,250000,1942
3100,5298,2,0,3100,0,475000,2007
550,5700,1,0,550,0,290000,1916
1080,10639,1.5,0,1080,0,219000,1953
880,6650,1,0,880,0,416000,1918
720,8914,1,0,720,0,179000,1949
2030,9120,1,0,2030,0,302000,1988
2040,8281,2,1,2040,0,565000,1961
1570,8316,1,0,1070,500,281700,1962
1500,3420,1,0,1500,0,480000,1902
3180,15358,2,0,3180,0,775000,1988
1260,11224,1,0,1260,0,375000,1947
1390,13860,2,0,1390,0,345000,1979
2850,9375,1,0,2240,610,300000,1977
2070,2992,2,0,2070,0,364950,2002
2650,7819,1,2,1760,890,410000,1956
1220,8817,1,0,1220,0,231000,1978
1630,8702,1,0,1630,0,445000,1987
1785,779,2,0,1595,190,530000,1975
1260,972,2,0,840,420,353500,2008
1380,11130,1,0,1380,0,209950,1960
2330,7200,1,0,1320,1010,650000,1950
840,4239,1,0,840,0,325000,1948
1730,9516,1,0,1180,550,257000,1978
2230,5970,2,0,2230,0,337000,2002
1790,4038,2,0,1790,0,541000,2005
2280,10879,2,0,2280,0,577500,1984
2430,5128,1,1,1270,1160,560000,1978
3730,5500,1.5,0,2160,1570,979700,1927
2230,8560,1,0,1150,1080,750000,1960
770,2971,1,2,770,0,407500,1923
1814,5000,1,0,944,870,530000,1951
1920,9350,1,0,1000,920,235000,1977
1860,3840,1.5,0,1170,690,715000,1928
2750,10000,1,0,1730,1020,795000,1957
1930,9653,1,0,1930,0,465000,1968
1950,8251,2,0,1950,0,287600,1990
2470,9328,2,0,2470,0,630000,1982
1630,6449,1,0,1310,320,445000,1986
2110,16200,1,0,1630,480,490000,1978
1490,5000,1,1,1250,240,565000,1954
1740,1844,2,0,1320,420,330000,2008
1900,6000,1,2,1300,600,463000,1961
4510,15175,2,0,4510,0,1.87E+06,1969
1090,6710,1.5,0,1090,0,219500,1912
1720,7200,1,0,1420,300,622200,1959
1400,1243,3,0,1400,0,474800,2000
2090,9702,1,0,1320,770,465000,1965
1580,9049,1,0,1580,0,389950,1966
2620,19864,2,0,2620,0,650000,1984
1500,2506,1,0,870,630,395000,2003
2030,5202,2,0,2030,0,304500,2001
1020,8484,1,0,1020,0,307000,1949
1540,7120,1,0,770,770,485000,1938
3910,16200,1,0,2890,1020,1.56E+06,1960
3920,11412,2,0,3920,0,650500,1955
3180,10105,2,0,3180,0,960000,1986
2330,9160,2,0,2330,0,710000,1997
2600,23361,1.5,4,2150,450,540000,1912
1950,4200,1,0,1040,910,601000,1951
3250,13702,1,2,1650,1600,463828,1965
1130,8308,1.5,0,1130,0,293000,1944
2620,4800,2,0,2620,0,597500,2002
1120,45302,1,2,1120,0,240000,1932
1800,23103,1,0,1800,0,284000,1968
2180,10200,1,2,2000,180,440000,1966
1960,8136,1,0,980,980,340000,1948
1960,8136,1,0,980,980,363000,1948
1150,3600,1,0,1150,0,270000,1910
2800,6820,2,0,2800,0,365000,1997
1310,2550,1,0,780,530,428000,1986
2340,57499,1,0,2340,0,600000,1988
1430,10200,1,0,1430,0,405000,1960
2340,9748,1,1,1610,730,339900,1981
1290,11250,1,0,1290,0,275000,1956
760,6380,1,0,760,0,361600,1941
2780,13950,2.5,0,2780,0,325000,1955
2090,4077,1.5,0,1530,560,1.05E+06,1931
3060,50002,1,2,2460,600,959750,1957
1110,7962,1,0,1110,0,210000,1962
1790,7879,1.5,0,1790,0,258000,1998
1830,9848,1,0,1830,0,468000,1962
2850,2910,2,2,1970,880,710000,1905
1420,6000,1,0,1420,0,268000,1941
790,7252,1,0,790,0,115000,1930
2300,4307,2,0,2300,0,500000,1998
2440,71002,1,0,2440,0,431000,1996
1310,7349,1,0,870,440,241500,1995
1380,12000,1,0,1380,0,300000,1963
2790,10289,2,0,2790,0,982000,1987
1360,7293,2,0,1360,0,248500,1988
2510,5936,2,0,2510,0,665000,1998
4560,16339,2,2,4040,520,1.22E+06,2001
780,3910,1,0,780,0,380000,1918
1410,7998,1,0,1410,0,220000,1940
2530,5650,1.5,0,1910,620,631500,1910
1270,6760,1,0,1270,0,386100,1972
3180,4606,2,3,1990,1190,1.05E+06,1929
1450,4000,1.5,0,1350,100,650000,1903
2040,53578,1,0,1160,880,545000,1959
2650,12001,2,0,2650,0,870000,1984
1240,8611,1,0,1240,0,380000,1973
820,8423,1,2,820,0,265000,1957
1890,5202,1.5,0,1890,0,645500,1909
1270,3090,2,0,1270,0,570000,1911
3350,11688,1,2,1760,1590,1.20E+06,1995
1550,3200,1.5,0,1550,0,605000,1927
920,9812,1,0,920,0,199500,1962
950,4800,1,0,950,0,445000,1941
2040,3570,1,0,1020,1020,495000,1917
1870,5200,2,0,1200,670,594000,1937
1720,5280,1,0,900,820,465000,1943
1020,13647,1,0,1020,0,160000,1915
2690,6099,2,0,2690,0,340000,1998
3090,41147,1,0,3090,0,870000,1990
1070,5150,1,0,1070,0,249000,1940
2050,7201,2,0,2050,0,500000,1994
1660,15600,2,0,1660,0,220000,1981
2810,9360,1,0,1520,1290,368500,1965
2460,14600,1,0,1720,740,439950,1977
1230,12000,1,0,1230,0,179900,1970
2360,4367,2,0,2360,0,490000,2003
1730,11890,1,0,980,750,425000,1955
2770,21806,2,0,2770,0,533300,1991
1770,3332,2,0,1630,140,447500,1924
3030,13640,2,0,3030,0,768000,1980
2380,6000,1.5,0,1320,1060,285000,1935
1780,120661,1,0,1780,0,336900,1979
1540,7886,2,0,1540,0,415000,1967
1580,4379,2,0,1580,0,500000,1994
3200,5772,2,0,3200,0,337000,2003
2220,6800,2,0,2220,0,419950,2002
2240,8162,2,0,1380,860,290000,1946
1640,4176,1,0,1040,600,349950,1948
1170,4950,1,0,1170,0,330000,1960
3160,34560,1,0,3160,0,965000,1981
2100,7851,2,0,2100,0,515000,1986
2600,17388,2,0,2600,0,665000,1996
1630,5999,1.5,0,1630,0,265000,1985
2850,19200,1,3,2340,510,545400,2004
2560,5606,2,0,2560,0,350000,2004
980,1296,2,0,840,140,260000,2001
5480,57990,2,4,5480,0,2.51E+06,1991
2160,8091,1.5,0,2160,0,355000,2000
3030,5156,1.5,0,2080,950,879000,1929
3560,7178,2,3,2590,970,833000,2006
760,6407,1,0,760,0,261590,1943
2260,2400,2,0,2260,0,512500,1909
1560,3200,1,0,880,680,600000,1946
2270,6664,1,0,1340,930,417500,1995
3480,15185,2,0,3480,0,970000,1964
1900,7479,2,0,1900,0,316000,1992
2350,9952,1,0,1650,700,397500,1989
2390,5500,1,3,1700,690,1.35E+06,1952
3730,9847,2,0,3730,0,840000,1997
1780,81021,1,3,1780,0,270000,1954
1630,4473,2,0,1630,0,312900,2003
1130,6908,1.5,0,1130,0,325000,1945
2140,3584,1,0,1070,1070,680000,1952
3220,7873,2,0,3220,0,763000,1994
800,533610,1.5,0,800,0,375000,1950
1800,3300,2,0,1690,110,475000,2004
809,940,2,0,809,0,219000,2003
1820,9694,1,0,1240,580,415000,1977
580,7500,1,0,580,0,90000,1943
580,7500,1,0,580,0,220000,1943
2900,5650,1,2,1520,1380,616000,1959
1140,74052,1,0,1140,0,269500,1968
1060,5754,1,0,1060,0,395350,1917
2320,7200,1,0,1260,1060,770000,1943
3450,43216,2,0,3450,0,840000,2000
1760,4441,1,0,1310,450,428950,1950
3370,6766,2,0,3370,0,800000,2005
1940,5753,1.5,0,1940,0,401000,1947
2520,7334,1,0,1600,920,303697,1955
1360,8968,1,0,1360,0,355000,1956
800,5040,1,0,800,0,350000,1960
3010,9323,2,0,3010,0,754999,1992
2340,5500,2,2,2340,0,982218,1988
1780,8621,1,0,1780,0,406500,1992
4200,210394,2,0,4200,0,1.65E+06,1993
1720,3000,1,0,860,860,565000,1925
830,4500,1,0,830,0,160000,1920
1090,6320,1,0,890,200,220000,1954
5040,9466,2,0,5040,0,1.28E+06,2004
3500,5040,2,2,2950,550,970000,1927
1080,6250,1,0,1080,0,115000,1950
1080,6250,1,0,1080,0,124000,1950
1080,6250,1,0,1080,0,157000,1950
870,5200,1,0,870,0,183000,1969
2830,6163,2,0,2830,0,527000,2000
1880,14653,2,0,1880,0,407193,1978
3600,5040,2,0,2610,990,970000,2004
2340,5600,2,0,2340,0,535000,1921
2040,13125,1,0,810,1230,245000,1910
1310,12750,1,0,1310,0,337000,1993
1470,6000,1,0,1090,380,630000,1950
1370,9900,1,0,1370,0,320000,1983
1080,7486,1.5,0,990,90,228500,1942
1990,7577,2,0,1990,0,293000,1990
1310,7000,1,0,1310,0,447000,1958
1640,10762,1,0,1130,510,226500,1988
1770,8000,1,0,1350,420,436000,1976
2050,4876,2,0,2050,0,451000,2005
1170,62290,2,0,1170,0,315000,1986
1340,7250,1,0,1340,0,450000,1951
2240,5300,1,0,1120,1120,635000,1955
880,17743,1,0,880,0,292500,1951
2170,4905,2,0,2170,0,329900,2004
1260,6660,1.5,0,1260,0,531000,1926
1880,13300,1,0,1380,500,725000,1967
1620,7410,1,0,1620,0,355300,1955
1610,10022,2,0,1610,0,280000,1996
3330,9143,2,0,3330,0,1.10E+06,1995
1370,4000,2,0,1370,0,605004,1951
690,6000,1,0,690,0,260000,1949
3170,4979,2,0,2570,600,748000,1925
1990,6180,1,0,1010,980,776000,1941
1080,6095,1.5,0,1080,0,425000,1924
1870,14703,1.5,0,1090,780,230000,1928
1670,12075,1,0,1370,300,418000,1958
2800,28254,2,0,2800,0,440000,2001
3460,7977,2,0,3460,0,858450,2011
1930,12443,1,0,1930,0,390000,1969
2370,3836,2,0,1750,620,957000,1969
1180,6000,1,0,1180,0,507000,1950
1320,4750,1.5,0,1320,0,575000,1928
1350,4000,1.5,0,1350,0,700000,1925
1068,1452,2,0,1068,0,239950,1990
1580,8240,1,0,1040,540,253000,1978
1690,3417,1.5,0,1690,0,540000,1907
5120,4600,3,2,4490,630,1.55E+06,2008
3960,38615,2,0,3960,0,805000,2000
2420,4000,1.5,0,1870,550,920000,1911
1910,5562,2,0,1910,0,496600,1988
1440,10500,1,0,1130,310,246000,1983
2320,8400,1,0,1510,810,350000,1963
1670,4572,1.5,0,1670,0,585000,1931
1390,11700,1,0,1390,0,450000,1966
2620,8950,2,0,2620,0,746000,1992
3040,7880,2,0,3040,0,598555,2004
2990,10711,1,4,1560,1430,820000,1976
1740,5460,1,0,1210,530,266500,1998
2360,105850,1,2,1180,1180,370000,1947
2240,3600,2.5,0,1650,590,625000,1901
1610,6200,1,0,1610,0,243500,1979
700,5829,1,0,700,0,340000,1945
2730,9519,1,0,1670,1060,559950,2014
1780,15114,1,0,1080,700,315000,1980
3070,223463,2,0,3070,0,753000,2003
2060,3200,2,0,2060,0,800000,1907
1360,5111,1.5,0,1360,0,550000,1934
1430,14250,1,0,1430,0,465000,1953
1840,5752,2,0,1840,0,465000,2003
2000,8068,2,0,2000,0,710000,1976
1820,11012,2,0,1820,0,505000,1988
2330,16300,2,0,2330,0,690000,1964
1070,8400,1,0,1070,0,217500,1980
930,3750,1,0,930,0,500000,1909
1040,5796,1,2,1040,0,325000,1921
1960,12436,2,0,1960,0,500000,1984
2970,234788,2,3,2040,930,721500,1991
2200,5000,1.5,0,2200,0,924000,1932
3810,28176,1,4,3810,0,2.01E+06,1969
830,1034,2,0,830,0,345000,2009
3920,11086,2,0,3920,0,825000,1999
2870,95396,1,0,1350,1520,560000,1980
2560,14680,1,0,1330,1230,599000,1987
1350,7620,1,0,1350,0,211000,1941
1240,21190,1,0,910,330,425000,1974
3210,8520,1,2,1810,1400,750000,1976
1690,3322,2,0,1690,0,479000,2003
2550,10623,2,0,2550,0,612500,1992
3240,34510,2,0,2690,550,605000,1963
3560,8960,2,0,3560,0,1.36E+06,2001
2160,59241,1,0,2160,0,389900,2007
3060,5000,2,0,3060,0,710000,2006
1690,8564,2,0,1690,0,295000,1992
1520,7199,2,0,1520,0,275250,1992
2040,5770,2,0,2040,0,250000,1994
2360,18000,1,0,2180,180,709000,1951
1360,4840,1.5,0,1360,0,399500,1928
2000,9202,2,0,2000,0,225000,1992
1650,4648,2,0,1650,0,500000,2001
2500,8304,2,0,2500,0,364900,1997
1140,7500,1,0,1140,0,356000,1976
2140,47743,1.5,0,2140,0,616750,1978
2870,6600,2,2,2870,0,755000,1984
830,8183,1,0,830,0,327500,1950
1960,10139,2,0,1960,0,605000,1984
1130,5200,1,0,1130,0,179950,1968
3630,30570,2,0,3630,0,633000,2000
1764,15600,1,0,1764,0,349950,1942
2770,5800,1,0,1650,1120,1.08E+06,1959
2650,12247,2,0,2650,0,425000,2002
2500,6350,2,0,2370,130,990000,1979
2710,19000,2,3,2710,0,410000,1950
2490,8800,2,0,2490,0,590000,1975
1500,7560,1,0,1500,0,242000,1979
1160,13747,1,0,580,580,775000,1931
1880,6200,1,2,1440,440,680000,1954
1340,4200,2,0,1340,0,217000,2002
1960,3953,2,0,1960,0,395000,1999
2030,9791,1,0,1500,530,572500,1984
2200,6380,1,0,1440,760,559900,1987
2540,4750,1.5,0,1840,700,845000,1930
1520,7131,1,0,1520,0,241000,1993
2360,5504,2,0,2080,280,1.33E+06,1913
1340,2805,1.5,0,1340,0,475000,1919
1400,5810,2,0,1400,0,575000,1940
3030,117378,1,0,1680,1350,455000,1959
3200,203425,1,0,3200,0,839000,2000
1580,10260,1,0,1030,550,475000,1955
2120,6897,1,0,1060,1060,600000,1923
1640,5200,1,0,1040,600,515000,1937
1890,8400,1,0,1520,370,425000,1977
1710,3875,1.5,0,1710,0,565000,1907
1140,8282,1,0,1140,0,498000,1924
2720,3800,2,0,1800,920,739000,1919
1650,4000,1,0,950,700,355000,1947
1790,7485,1,0,1330,460,263000,1979
1680,6834,1.5,0,1680,0,375000,1948
2200,12231,1,0,1250,950,322000,1964
830,5100,1,0,830,0,325000,1941
770,4800,1,0,770,0,290000,1943
3280,6181,2,0,3280,0,809950,2001
2080,3025,2,2,1220,860,969500,1984
2790,43091,2,0,2790,0,665000,1989
4150,13232,2,0,4150,0,635000,2006
1780,7332,2,0,1780,0,272450,1987
1460,9750,1,0,1460,0,427000,1967
1410,8174,1,0,1410,0,261500,1958
2170,9665,1,0,1300,870,488800,1976
690,5200,1,0,690,0,340000,1918
3000,10297,2,0,3000,0,398950,2003
870,5200,1,0,870,0,217000,1969
3170,94855,1,0,1910,1260,799000,1978
1540,7350,1,0,770,770,160000,1969
1270,8800,1,0,1270,0,447000,1968
2190,6450,1,0,1480,710,765000,1957
4410,36200,2,0,4410,0,1.32E+06,1989
2790,8111,2,0,2480,310,445000,2004
1510,6000,1,0,1170,340,310000,1953
1800,7191,1,3,990,810,380000,1952
2410,6975,1,0,1510,900,325000,1957
2250,7412,1,0,1480,770,345000,1975
950,4760,1.5,0,950,0,300000,1929
2860,48351,1,0,1710,1150,530000,1978
2860,48351,1,0,1710,1150,583500,1978
1560,10125,1,0,1130,430,410000,1954
1940,5700,1,0,970,970,535000,1937
3580,19989,1.5,4,3480,100,2.05E+06,1915
2040,5523,2,0,2040,0,345000,1999
1700,11727,1.5,0,1700,0,539000,1954
3700,12500,1,0,1920,1780,590000,1973
1050,2926,1,0,1050,0,187000,1974
1690,9583,1,0,1690,0,270000,1969
1120,6180,1,0,1120,0,546000,1939
1490,1036,2,0,1090,400,520000,2008
2220,6000,1.5,0,1390,830,515000,1925
2160,6000,1.5,0,1880,280,990000,1939
870,10492,1,0,870,0,382000,1937
1900,13600,1,0,1900,0,1.21E+06,1956
3370,5000,2,2,2470,900,900000,2008
3370,5350,1.5,1,2310,1060,675000,1910
880,3300,1,0,880,0,460000,1909
940,5375,1,0,940,0,234000,1952
1340,7191,1,0,1340,0,399000,1974
1440,12040,1,0,1440,0,253500,1959
1750,12632,1,0,1750,0,475000,1952
3990,5000,2,0,2910,1080,740000,2004
2860,4442,2,0,2860,0,799000,2000
1940,3864,2,0,1940,0,390000,2003
1400,11245,1,0,1400,0,421000,1947
1770,6033,2,0,1770,0,296500,1987
1710,4178,1.5,0,1710,0,895000,1926
2810,11897,2,0,2810,0,386000,2003
1580,13912,1,0,1580,0,424000,1955
1580,5000,1.5,0,1580,0,749000,1926
1440,8681,1.5,0,1440,0,523000,1937
2420,9147,2,0,2420,0,389000,1998
1930,15000,1,0,1930,0,270000,1946
1190,27215,1,0,1190,0,275000,1943
2240,6944,1,2,1310,930,287500,1979
2550,216344,2.5,0,2550,0,345000,1993
920,3780,1,0,920,0,427000,1910
1520,9600,1,0,1000,520,508450,1955
1460,6250,1.5,0,1460,0,705000,1912
1900,40600,1.5,0,1450,450,550000,1977
1430,11173,1,0,1430,0,380000,1955
2500,4203,2,0,2500,0,539900,2001
720,7250,1,0,720,0,330000,1943
1140,5720,1,0,850,290,455000,1947
3530,10935,2,0,3530,0,510000,1992
1220,14645,1,0,1220,0,315000,1970
1320,7000,1,0,1320,0,206000,1967
2170,8240,1,0,1370,800,592500,1968
2020,7512,2,0,2020,0,744000,1981
1990,3694,2,0,1990,0,334500,1989
2660,3900,1.5,0,1480,1180,886000,1923
2360,13500,1,0,1780,580,600000,1973
2740,101930,1,2,2740,0,850000,1999
1360,5850,1,0,1000,360,550000,1938
1230,5000,1,0,1230,0,184900,1911
1260,7964,1,0,1260,0,245000,1955
1040,4172,1,0,1040,0,370000,1946
2700,9700,1,0,1670,1030,480000,1978
1800,4429,2,0,1800,0,579000,1906
1590,7260,1,0,1080,510,339275,1964
1360,542322,1,2,1140,220,425000,1955
1370,10780,1,0,1370,0,170000,1959
3320,7644,2,0,3320,0,950000,1995
2980,9235,1,0,1690,1290,623000,1977
1350,2053,3,0,1350,0,477000,2005
1160,9600,1,0,1160,0,330000,1967
1480,5400,2,0,1480,0,600000,1914
1640,2808,1,3,820,820,570000,1924
2680,7178,2,0,2680,0,515000,2004
2440,9889,1,0,1540,900,805000,1952
2920,24074,2,0,2920,0,555000,1997
1780,9598,2,0,1780,0,245000,1985
2170,7275,1,0,1820,350,638150,1978
5550,16065,2,0,3880,1670,1.65E+06,2003
2060,13500,1,0,1260,800,269950,1968
1050,5525,1,0,1050,0,195000,1969
790,7095,1,0,790,0,159100,1944
1010,6120,1,0,1010,0,550000,1942
1040,4600,1,0,1040,0,299000,1950
3130,4500,2,0,2060,1070,1.38E+06,2014
900,4500,1,0,900,0,249500,1951
1470,5450,1.5,0,1470,0,700000,1918
1080,26114,1.5,0,1080,0,275000,1900
2440,8378,1,0,1480,960,565000,1962
2520,11017,1,0,1320,1200,425000,1956
1760,6000,1,0,880,880,620047,1946
1820,13362,1,0,1220,600,480000,1977
1820,13362,1,0,1220,600,515000,1977
3040,24123,2,0,3040,0,420000,1999
3490,23400,1,0,1890,1600,610000,1957
2440,8040,1,0,1440,1000,849000,1950
2280,3446,2,0,2280,0,718000,1949
1980,8000,1,0,1560,420,295000,1974
2360,6150,1,0,1180,1180,871000,1940
3890,7140,1,2,2390,1500,430000,1943
2300,10880,1,0,1190,1110,440000,1961
910,6490,1,0,910,0,405000,1942
1140,11620,1,0,1140,0,340000,1994
2390,5249,2,0,2390,0,675000,2006
1150,4945,1,2,1150,0,480000,1943
2330,8586,1,0,1270,1060,362500,1961
2420,9000,2,0,2420,0,752888,1987
960,8863,1,0,580,380,255000,1949
1010,10900,1,0,1010,0,283700,1968
2370,6000,2,0,2370,0,335000,2001
2880,18296,1,0,1580,1300,285000,1958
2400,7738,1.5,0,2400,0,278000,1964
3670,8960,1.5,0,3670,0,731000,1973
1140,15890,1,0,840,300,335000,1985
1410,45302,1,0,1410,0,334200,1980
1530,4305,1.5,0,1530,0,642000,1921
1720,4240,1.5,0,1460,260,540000,1925
1620,79993,1,2,1620,0,299000,1960
1570,4375,1,0,970,600,560000,1940
1990,3750,1.5,0,1990,0,852000,1913
930,5650,1,2,930,0,306000,1941
1550,7820,1,0,1210,340,440000,1981
1650,8250,1,0,1650,0,517000,1966
800,6380,1,2,800,0,379000,1940
930,6098,1,0,930,0,360000,1919
2550,4000,1.5,0,1760,790,645000,1926
720,4760,1,0,720,0,217000,1942
620,4760,1,0,620,0,255000,1941
2360,12164,2,0,2360,0,625000,1987
1760,8400,1,0,1460,300,680000,1960
2100,29735,1,0,1080,1020,440000,1957
2480,12070,2,0,2480,0,615000,1978
1040,6860,2,0,1040,0,239000,1942
1656,108900,1,0,1656,0,462500,1985
2090,3610,1.5,0,1790,300,619400,1927
2520,54160,2,4,2520,0,975000,1954
700,4000,1,0,700,0,330000,1943
4030,36762,2,0,4030,0,985000,1988
760,7114,1,0,760,0,430000,1946
6500,14986,2,0,5180,1320,2.46E+06,2001
1840,6000,2,0,1720,120,778000,1946
1090,7350,1,0,1090,0,219000,1990
2980,13341,1.5,4,1800,1180,1.60E+06,1928
1900,8272,1,0,1460,440,715000,1966
2790,15653,2,0,2790,0,950000,1964
1280,5026,1,2,1020,260,425000,1951
1510,15022,1,0,1510,0,239000,1962
920,8282,1.5,0,920,0,310000,1944
700,8120,1,0,700,0,400000,1927
1980,44550,2,1,1280,700,428000,1977
1440,4300,1.5,0,1440,0,600000,1929
2740,8250,2,0,2740,0,415000,1990
1400,8220,1,0,1400,0,401000,1949
2270,7156,1,0,1370,900,292000,1948
1310,12825,1,0,1310,0,291750,1950
1680,7455,1,0,1680,0,227000,1968
2260,13209,1,0,2260,0,675000,1977
1350,980,2,0,1050,300,397500,2007
1820,8867,2,0,1820,0,206000,1921
3380,3333,3,0,2800,580,1.19E+06,2008
2140,49658,1,0,2140,0,360000,1959
2430,3249,2,0,2430,0,427500,2010
940,6000,1,0,940,0,115000,1943
2070,5386,1,0,1140,930,559000,1948
1510,1501,1.5,0,1510,0,420000,1906
2550,39460,1,0,1890,660,550000,1982
700,5940,1,0,700,0,282150,1948
1150,3090,1,0,1150,0,260000,1910
2340,3466,2,0,2340,0,428000,2004
1510,1245,3,0,1510,0,319950,2007
2070,9600,1,1,1590,480,1.35E+06,1946
1150,5000,1,0,1050,100,552000,1924
2190,2867,1.5,0,1470,720,637000,1929
1980,9000,1,0,1480,500,213000,1978
960,7200,1,0,960,0,215000,1958
2180,6120,1,2,1380,800,590000,1949
2560,43560,2,0,2560,0,390000,1989
2270,11997,1,2,1540,730,287000,1959
3550,9600,2,0,3550,0,580000,1960
1330,5632,1,0,1330,0,424000,1988
2110,6360,2,0,2110,0,610000,1988
3470,11843,1,3,2270,1200,1.32E+06,1989
1550,3350,1,0,860,690,623500,1918
570,81893,1,1,570,0,260000,1936
2030,1800,3,0,2030,0,906000,2013
1500,11233,1,0,1500,0,330000,1987
920,7688,1,0,920,0,275000,1955
1470,8200,1,0,1040,430,290000,1953
1150,3775,1,0,1150,0,599950,1917
4180,35169,2,0,4180,0,550000,1986
1690,3449,1,0,1690,0,289000,1987
2150,9915,1,0,1240,910,411000,1976
2330,4000,1,2,1730,600,826000,1964
2680,13680,2,2,2350,330,400000,1943
1740,2226,2,0,1320,420,342000,2008
1320,3420,1,1,1080,240,475000,1955
3150,5500,2,0,3150,0,1.21E+06,2014
2480,9238,1,0,2050,430,455000,1913
3330,4000,1,0,1790,1540,850000,1958
1010,6400,1,0,1010,0,185000,1971
4920,20590,1,3,2730,2190,850000,1960
1570,18730,1,0,1200,370,239900,1960
3580,14275,2,0,3190,390,765000,1999
2220,17568,1,0,2220,0,437000,1967
1010,10350,1,0,1010,0,240000,1969
1440,7808,1,0,860,580,395000,1949
1230,7492,1,0,1230,0,320000,1955
1710,7350,1,0,1280,430,525000,1981
2390,8993,2,0,1680,710,260000,1988
2840,39324,1,0,2200,640,450000,1988
2300,7989,2,0,2300,0,560000,1990
2270,5001,1,0,1360,910,310000,1989
2290,6302,2,0,2290,0,440000,1997
1330,9715,1,0,970,360,458450,1957
1200,10703,1.5,0,1200,0,200000,1918
2160,6527,2,0,1580,580,430000,1987
1120,10500,1,0,1120,0,360000,1966
2090,11645,1,0,1200,890,311000,1962
1470,1152,3,0,1470,0,615000,2003
2270,10136,2,0,2270,0,575000,1979
4100,22798,1.5,3,2540,1560,2.03E+06,1934
1440,4025,1,0,720,720,430000,1917
1200,4800,1,0,1200,0,400000,1962
1720,10710,1,0,860,860,340000,1957
930,6600,1,0,930,0,351000,1924
2400,8038,2,0,2400,0,440000,2002
1960,11798,2,0,1960,0,298000,1999
1890,9205,1,0,1260,630,300000,1964
1590,3056,2,0,1590,0,310000,2001
2590,9354,2,0,2590,0,500000,1993
860,1664,1.5,0,860,0,399900,1927
1270,2509,2,0,1270,0,343000,2004
1130,2191,2,0,1130,0,415000,2010
1860,15457,2,0,1860,0,410000,1997
1802,11225,1,0,1802,0,320000,1961
4480,5000,2.5,0,3420,1060,1.99E+06,1902
1310,7128,1,0,940,370,253000,1980
2320,32772,2,0,2320,0,630000,1992
1130,12500,1,0,1130,0,216000,1953
2180,11100,1,0,1230,950,540000,1983
1830,12233,1.5,0,1830,0,212000,1930
2340,12282,1,2,1470,870,300000,1978
2830,3750,3,0,2830,0,969950,2014
1610,7680,1,0,900,710,715000,1956
2410,19447,2,2,2290,120,1.32E+06,1968
2660,9547,1,1,1930,730,1.44E+06,1968
1030,5350,1,0,1030,0,305000,1924
1390,1569,2,0,1150,240,458000,2006
1580,8775,1,0,1220,360,275000,1942
2330,4780,2,3,1730,600,550000,1930
1540,704,3,0,1540,0,742000,2011
1570,4000,2,0,1570,0,700000,1908
2940,5763,1,0,1640,1300,640000,1955
1240,7200,1,0,1240,0,352000,1947
1410,7419,1,0,1050,360,301500,1969
2190,9880,1,0,1410,780,630000,1979
3040,6255,2,0,3040,0,340000,1999
1860,9364,1,0,1080,780,477500,1953
1690,7460,1,0,870,820,285000,1997
1900,16117,1,0,1900,0,255000,1958
1600,7982,2,0,1600,0,315000,1993
2530,9000,1,0,2530,0,830000,1978
1860,1558,3,0,1860,0,539950,2014
2390,4590,2,0,2090,300,980000,1941
3100,8529,2,0,3100,0,735000,1990
2650,9140,1,1,1350,1300,536000,1965
1520,5000,1.5,0,1140,380,575000,1945
1510,4000,1,0,930,580,500000,1924
1960,7950,1,0,1960,0,285500,1967
2270,7375,1,0,1290,980,498000,1973
910,6282,1,0,910,0,412000,1939
2100,8220,1,0,1300,800,607000,1975
1000,8512,1,0,1000,0,199000,1991
2760,18306,1,0,1630,1130,492500,1978
2840,11044,2,0,2840,0,585000,2001
1860,5321,2,0,1860,0,326995,2000
1920,9660,1,0,1920,0,372500,1968
840,40642,1,4,840,0,528000,1937
2390,32109,1,0,2390,0,400000,1975
2100,8501,2,0,2100,0,344000,1993
2430,7163,2,0,2430,0,409950,2003
1880,4000,1,2,1280,600,625000,1950
1350,9000,1,0,1350,0,304950,1987
2160,35183,1,0,2160,0,381500,1985
1430,13399,1,0,900,530,215000,1946
2840,12870,2,2,2840,0,345000,1925
2510,20000,2,0,2510,0,363000,1961
1690,20063,1.5,0,1690,0,240000,1913
1930,5479,1,0,1930,0,548050,2005
720,4920,1,0,720,0,314000,1941
2990,16809,2,0,2990,0,800000,1990
2300,6720,2,0,2300,0,400000,1905
460,4120,1,0,460,0,247000,1937
1240,4120,1,0,890,350,540000,1906
1900,15123,2,0,1900,0,410000,1995
2120,9146,1,0,1260,860,525000,1981
2440,5737,2,0,1700,740,820000,1929
3300,15375,1.5,3,2820,480,1.25E+06,1933
1180,10200,1,0,1180,0,244000,1955
520,4800,1,0,520,0,275000,1930
2070,23160,1,0,1260,810,577000,1946
2250,7945,1,0,1360,890,446950,1977
2050,5694,2,2,2050,0,457000,2004
1310,137214,1.5,0,1310,0,320000,1926
1250,9484,1,0,1250,0,210000,1969
2130,9100,1,0,1290,840,220000,1978
2250,8800,1,0,1250,1000,589000,1925
1880,3840,1,0,970,910,435000,1904
1520,10798,1,0,1520,0,375000,1953
4010,9654,2,0,4010,0,1.74E+06,2007
1660,5581,1,0,1660,0,545000,2005
3400,10000,2,0,3400,0,970000,1983
2320,6755,1,0,1380,940,705000,1946
3740,11536,2,0,2540,1200,915557,1984
1810,9000,1.5,0,1810,0,259000,1960
3170,3000,2,2,1990,1180,1.70E+06,1900
1680,8610,1,0,1290,390,427000,1969
930,3100,1,0,930,0,390000,1911
2390,8000,2,0,2390,0,363000,1995
2680,3626,1.5,3,1680,1000,612000,1928
1790,10186,1,0,1790,0,380000,1965
1680,6003,1,0,1150,530,230000,1997
1570,2600,1.5,0,1570,0,580000,1931
2230,3200,2,2,1630,600,770000,1918
1260,8400,1,0,1260,0,207200,1991
1790,11430,1,0,1190,600,525000,1985
2440,7419,1,0,1520,920,925000,1961
2410,4000,2,0,1650,760,883000,1910
1780,2992,2,0,1780,0,455000,2003
1900,5194,2,0,1900,0,343500,2004
960,8450,1,0,960,0,244000,1950
1640,11730,1,0,1640,0,397000,1967
850,5000,1,0,850,0,180500,1976
2150,6576,1,0,1900,250,310000,1926
2780,3969,2,0,2780,0,315000,2005
1030,4958,1,0,1030,0,718000,1952
1930,7267,1,0,1330,600,279950,1977
2080,9612,1,3,1700,380,689000,1940
3520,9901,2,0,3520,0,828000,1998
890,8100,1,0,890,0,150000,1942
1640,3400,1,0,930,710,505400,1926
4860,23723,2,2,3820,1040,1.68E+06,1989
1040,5000,1,0,1040,0,217450,1959
2820,4174,2,0,2820,0,677000,2004
1320,48787,1,0,1320,0,361000,2004
2590,7237,2,0,2590,0,620000,2004
1540,5449,1,0,1180,360,176000,1989
960,7218,1,0,960,0,330000,1969
1190,8175,1,0,1190,0,290000,1986
2770,9532,2,0,2770,0,711000,1988
1060,8100,2,0,1060,0,295000,1983
4010,12110,2,0,4010,0,1.10E+06,2003
1140,7078,1,0,1140,0,257500,1991
1910,16320,1.5,0,1910,0,240000,1934
2340,8955,2,0,2340,0,645000,1990
1170,2400,1,0,740,430,499000,1903
1290,9526,1.5,0,1290,0,321000,1961
1810,1658,3,0,1810,0,449000,1998
1820,5280,1,0,910,910,515000,1949
2220,12385,1,0,1270,950,456000,1978
3830,219106,2,0,3830,0,865000,1977
2920,7700,2,0,2920,0,515500,2003
2630,6100,2,0,2630,0,576925,2004
1320,10416,1,0,1320,0,243000,1996
1400,8640,1,0,1400,0,253400,1968
1600,3580,2,0,1600,0,292000,2000
1490,8005,1,0,1090,400,271500,1976
2170,6750,1,0,2170,0,765000,2012
1280,1730,2,0,1090,190,375000,2005
1620,9566,1,0,1620,0,382880,1968
2630,10100,1,0,1580,1050,852500,1967
1240,8738,1,0,1240,0,475000,1959
1300,2580,1,0,820,480,462000,1919
2430,14607,1,1,1230,1200,762400,1949
1890,7540,1,0,1890,0,330000,1967
1890,12236,1,0,1890,0,473000,1978
2440,7200,1,0,2440,0,550000,1949
1780,7280,1,2,1340,440,449500,1972
2830,13059,2,0,2830,0,744000,1998
2490,4700,1,0,1690,800,700000,1952
1560,12220,1.5,0,1560,0,511100,1965
1980,4500,2,0,1980,0,317950,2012
2070,39768,2,0,2070,0,542950,1988
1490,11360,1,0,1490,0,490000,1975
3090,4060,2,0,2420,670,760000,1992
1580,8659,1,0,1220,360,475000,1961
5190,23716,2,2,3390,1800,1.70E+06,1987
2692,6197,2,0,2692,0,435000,2007
1740,3690,2,0,1740,0,399000,2000
1940,3800,1,0,1050,890,627000,1927
2150,5100,1.5,0,1290,860,346500,1991
1320,8000,1,0,1320,0,412000,1957
3360,40471,2,0,3360,0,845000,1994
1850,9655,1,0,1100,750,373000,1959
2880,8882,2,0,2480,400,725000,1965
2420,11662,1,2,1420,1000,376000,1965
2020,4120,1.5,0,1520,500,552500,1929
2280,19000,1.5,0,2280,0,365000,1924
3010,46173,2,0,3010,0,700000,1996
2550,9736,1,0,2550,0,315000,1967
1540,5110,1,0,1540,0,262500,1957
2280,6150,2,2,2280,0,660000,1984
2450,6941,2,0,2450,0,340000,2006
2950,5500,1.5,0,1720,1230,660500,1918
690,1950,1,0,690,0,280000,1928
800,2480,1,0,800,0,267000,1919
1470,25661,1.5,0,1470,0,230000,1932
1840,11403,2,0,1840,0,417000,1993
1170,9730,1,0,1170,0,252000,1968
2344,4800,1.5,0,1544,800,791000,1921
1230,3774,1,0,830,400,415000,1924
1150,13278,1,0,1150,0,339000,1966
1140,10477,1,0,1140,0,158000,1942
1660,5100,1,0,1260,400,535000,1957
1080,4120,1,0,980,100,818900,1919
1720,4000,1,0,1420,300,550000,1950
590,8717,1,0,590,0,240000,1953
1290,1230,2,2,1090,200,590000,2008
1480,21320,1,0,1480,0,369300,1967
2600,118666,1,0,1400,1200,510000,1981
2040,10086,2,0,2040,0,542500,1987
970,7854,1,0,970,0,262500,1980
2620,4350,1,0,1760,860,900000,1957
4560,41636,2,0,4170,390,1.10E+06,1995
1750,14400,1,0,1750,0,368000,1951
3620,6499,2.5,0,3620,0,825000,2003
1660,7509,1,0,1660,0,343500,2002
1360,6000,1,0,1020,340,273500,1944
2044,5610,2,0,2044,0,1.00E+06,1996
2370,6000,1.5,2,1340,1030,770000,1926
1170,3868,1.5,0,1170,0,400000,1925
1660,7210,1,0,1100,560,225000,1963
2020,18150,1,0,2020,0,345000,1955
2530,8116,2,0,2530,0,450000,2001
870,5635,1,0,870,0,334850,1948
3670,9600,1,1,1980,1690,605000,1955
3180,14000,2,0,3180,0,760000,1997
1870,12960,1.5,0,1350,520,390000,1926
1940,5660,2,0,1940,0,488000,2001
4220,41300,1,4,2460,1760,3.30E+06,1958
4820,13165,2,0,3950,870,1.06E+06,1990
2400,217800,2,0,1590,810,608000,1975
2930,6000,2,2,1920,1010,1.39E+06,2000
800,3000,1,0,800,0,299950,1904
2200,4800,2,2,1910,290,818000,1943
2400,9701,1,0,2400,0,355000,1990
5570,9600,2,0,3860,1710,1.86E+06,1952
1980,2850,3,0,1980,0,660000,1987
3530,17450,1,3,1840,1690,2.37E+06,1930
3430,35120,2,0,3430,0,1.21E+06,1984
1720,3676,2,0,1720,0,255950,1992
1930,11092,1,0,1500,430,475000,1983
2140,159865,1,0,1140,1000,362950,1960
1110,9012,1,0,1110,0,452000,1966
1970,8200,1,0,1270,700,315000,1964
1630,2844,2,0,1630,0,330950,2003
2520,49222,2,0,2520,0,535000,1978
2270,9464,1.5,0,1520,750,479000,1940
1212,1174,3,0,1212,0,340000,2004
1890,8362,1,0,1890,0,312000,1966
1370,6600,2,0,1370,0,305000,1993
1770,7336,2,0,1770,0,270000,1996
1710,1664,2,0,1300,410,529999,2003
1190,6967,1,0,1190,0,587100,1946
1690,16061,1,0,1690,0,459800,1984
1680,7800,1,0,1330,350,451000,1966
4340,4947,2,3,3060,1280,2.48E+06,1993
2040,435600,2,2,2040,0,525000,1983
1110,26051,1,0,1110,0,250000,1951
2040,6180,2,0,2040,0,475000,1908
1920,11595,1,0,1920,0,235000,1962
1330,9548,1,0,1330,0,230000,1967
1630,2566,1.5,0,1630,0,581000,1921
1520,9030,1,0,1520,0,415000,1956
1520,9030,1,0,1520,0,522500,1956
1340,7725,1,0,1340,0,383000,1967
2500,8289,1,0,1250,1250,315000,1958
1460,3600,2,0,1460,0,591000,1902
3140,12150,2,0,3140,0,750000,1979
2150,4333,1,0,1200,950,430000,1956
3140,32336,1.5,0,3140,0,712000,1995
2310,53578,1,0,1340,970,510000,1981
710,4800,1,0,710,0,480000,1950
1460,7200,1,0,1260,200,538000,1906
730,5000,1,0,730,0,464000,1929
1440,3840,2,0,1440,0,476000,2001
1130,16875,1,0,1130,0,349500,1947
1810,8262,2,0,1810,0,270000,1981
2710,18480,2,2,2000,710,740000,1978
2740,8336,2,0,2740,0,395000,1990
1690,4088,2,0,1690,0,498000,2004
1470,4675,2,0,1470,0,339900,1999
2830,9972,2,0,2830,0,539000,2006
1410,9704,1,0,1140,270,400000,1983
2170,11745,1,0,1410,760,225000,1967
1340,4080,1.5,0,1170,170,330000,1907
2480,5500,2,3,1730,750,1.39E+06,1950
1990,31200,1,0,1990,0,490000,1986
2240,7200,1,0,1140,1100,260000,1967
2990,8913,2,0,2990,0,469900,1991
2120,3801,1.5,0,1220,900,493000,1925
2920,46355,2,0,2920,0,740000,1998
1700,6000,1,0,1700,0,148900,1967
1620,14467,2,0,1620,0,475000,1981
760,4000,1,0,760,0,415000,1944
1230,6000,1,0,1230,0,229500,1967
4960,13990,2,2,3760,1200,1.36E+06,2001
2030,11375,1,0,1330,700,385000,1969
1830,11331,1,0,1250,580,230000,1965
970,2700,1,0,770,200,425000,1926
1000,4179,1,0,1000,0,189900,1914
750,6480,1,0,750,0,238000,1943
2620,16200,1,2,1570,1050,968060,1950
2220,9496,1,0,1490,730,921000,1954
3000,6000,1,0,1500,1500,380000,1958
1060,54846,1,4,1060,0,285000,1935
1980,5400,2,0,1980,0,449000,1998
1600,5500,1.5,0,1600,0,625000,1946
2000,9000,1,0,2000,0,318989,1978
1310,1266,2,0,1120,190,445000,2002
1120,8549,1,0,1120,0,750000,1952
3320,11875,1,0,3320,0,959000,1979
2370,9102,2,0,2370,0,330000,1990
830,1241,2,0,830,0,425000,2005
940,7913,1,0,940,0,280000,1948
2250,50155,2,0,2250,0,476500,1998
2020,3600,2,0,2020,0,556000,1998
5240,320917,2,2,5240,0,1.86E+06,2006
4083,68377,2,0,4083,0,637000,2005
1450,6081,1,0,1450,0,405000,1969
1170,6757,1,0,800,370,397000,1944
3555,6565,2,0,3555,0,895990,2014
1610,14046,2,0,1610,0,259000,1933
960,112384,1,0,960,0,420000,1955
1680,2096,2,0,1380,300,518000,2008
1380,8182,1,0,1380,0,425000,1942
1040,13920,1,0,1040,0,182500,1973
1380,3031,1.5,0,1380,0,549900,1929
1850,16863,1,0,1280,570,445000,1980
1740,5400,1,0,990,750,452000,1946
1920,6500,1,0,1260,660,715000,1951
2010,5200,2,0,2010,0,559000,1989
8020,21738,2,0,8020,0,3.30E+06,2001
1860,7350,1,0,1090,770,250000,1977
4390,6656,2,0,2930,1460,1.23E+06,2008
2380,128937,1,0,2380,0,276500,1960
2880,7386,2,0,2880,0,440000,1987
2820,15600,1.5,2,1970,850,543200,1940
750,4000,1,0,750,0,250000,1918
1750,9000,1,0,1410,340,625000,1977
1540,3399,1.5,0,1200,340,530100,1926
1140,936,2,0,940,200,549900,2014
1560,6534,1,0,1560,0,430000,1962
2960,6856,2,0,2960,0,835000,2009
2140,13000,1,0,1320,820,409500,1968
1600,6765,1,0,830,770,329000,1947
2080,4000,1.5,0,2080,0,940000,1912
1560,3200,1.5,0,1560,0,539950,1910
2880,213444,1,0,2140,740,579950,1984
2510,4125,1.5,3,1590,920,881000,1925
960,5424,1.5,0,960,0,362500,1916
1120,35500,1,0,1120,0,243950,1961
3310,6166,2,0,3310,0,658000,2008
1080,9774,1,0,1080,0,218250,1968
2860,12394,2,0,2860,0,655000,1999
1490,7599,1,0,1490,0,255000,1990
1210,7175,1,0,1210,0,215000,1918
2240,5657,1.5,2,1910,330,1.27E+06,1941
4575,24085,2.5,2,3905,670,2.92E+06,1926
1600,5960,2,2,1600,0,424305,1910
2090,4300,1.5,0,1250,840,494000,1925
2260,3713,2,0,2260,0,560000,2003
1200,7000,2,0,1200,0,130000,1908
2480,176418,1.5,3,2480,0,468000,1927
2240,15435,1,1,1390,850,480000,1952
1550,4054,1.5,0,1550,0,475000,1926
2130,8151,1,0,1330,800,285000,1967
2870,5700,1,0,1950,920,765000,1964
1160,5750,1,0,1160,0,208000,1924
2430,5000,2,0,2430,0,372000,2001
900,5512,1,0,900,0,470000,1947
2830,8925,1.5,0,2830,0,451000,1967
1620,8132,1,0,1620,0,442200,1974
2510,8580,2,0,2510,0,330000,1991
1790,5120,1,0,940,850,335000,1949
1640,13249,1,0,1640,0,280000,1995
2240,6050,1,0,1250,990,625000,1950
1870,3584,2,0,1870,0,345000,2003
1500,11050,1,0,1500,0,255950,1964
1490,6000,1.5,0,1490,0,570000,1918
2230,8558,2,0,2230,0,685000,1960
1710,7210,1,0,1240,470,273148,1974
1620,7686,2,0,1620,0,246500,1989
2250,7176,1,0,1310,940,349950,1983
1700,2350,1,0,850,850,545000,1926
1502,1400,3,0,1502,0,403000,2005
1900,4054,2,0,1900,0,299950,2003
3320,12840,1,0,2600,720,792000,1990
1980,10205,1,0,1080,900,418000,1929
1670,8102,1.5,0,1670,0,332500,1944
2235,43560,1,0,990,1245,337000,1975
1070,7386,1,0,1070,0,212000,1949
1800,2819,2,2,1800,0,542000,1979
2980,8107,2,0,2980,0,622500,2000
1670,8511,1,0,1340,330,260000,1985
2620,38350,1,0,1320,1300,525000,1977
5470,35071,2,0,4590,880,975000,1976
3080,6500,1,0,1700,1380,1.14E+06,1941
940,10360,1,0,940,0,500000,1964
1870,11411,1,0,1170,700,554000,1961
2070,4500,2,0,2070,0,343000,2004
950,15219,1,0,950,0,515000,2009
1290,6272,1,0,890,400,492000,1922
2570,8022,1,0,1370,1200,655000,1984
1600,6848,2,0,1600,0,290000,2000
2550,5055,2,0,2550,0,952500,1910
1010,7500,1,0,1010,0,235000,1941
1720,7110,1,0,1720,0,323000,1955
2200,1970,2,0,1610,590,1.05E+06,2008
384,213444,1,0,384,0,265000,2003
1400,9600,1.5,0,1400,0,200000,1941
1830,7500,1,0,1330,500,419995,1968
3110,9015,1,4,1590,1520,1.50E+06,1980
1600,7829,2,0,1600,0,455000,1987
3600,37982,2,0,3600,0,660000,1996
1390,12823,1,0,1390,0,319000,1968
2092,250905,1,0,2092,0,390000,1981
1200,6240,1,0,1030,170,718500,1952
1090,3160,1,0,840,250,474000,1926
2140,6360,2,0,1840,300,615750,1945
2010,17362,2,0,2010,0,551000,1994
1500,7210,1,0,1150,350,230000,1984
3500,9198,2,0,3500,0,790000,2004
2660,1967,3,3,1870,790,1.23E+06,2007
1440,6443,2,0,1440,0,325000,1995
2780,6207,2,0,2780,0,705000,2001
1580,8856,2,0,1580,0,259000,1979
1250,8700,1,0,1250,0,306000,1959
970,6828,1,0,970,0,315000,1928
1100,7650,1,0,1100,0,392500,1952
3240,12930,2,0,2730,510,1.07E+06,1968
1290,1445,3,0,1290,0,350500,1999
3810,9792,2,0,3810,0,825000,1938
1500,6360,1.5,0,1500,0,235000,1944
2660,257875,1,2,1530,1130,650000,1976
2400,3340,1,0,1200,1200,675000,1964
1860,8505,1,0,1860,0,265000,1955
1450,7098,1,4,1450,0,822500,1924
2260,4000,2,0,1540,720,705000,1956
5540,7200,2.5,2,3950,1590,2.63E+06,1909
1300,1676,1,2,1300,0,685000,1943
1610,5000,2,0,1610,0,630000,1946
3820,24166,2,1,3310,510,1.25E+06,1990
1820,11325,1,0,1390,430,359000,1976
5820,13906,2,0,3750,2070,784500,1993
2470,8800,2,0,2470,0,850000,1961
3040,6054,2,0,3040,0,410000,2005
1120,8250,1,0,1120,0,252000,1966
1880,18295,1,0,1880,0,618000,1955
1070,4800,1,0,970,100,265000,1947
1560,8509,1,0,790,770,465000,1969
870,6552,1,0,870,0,240000,1947
1000,12000,1,0,1000,0,217000,1959
2520,4200,1.5,0,1510,1010,415000,1909
1700,7992,1,0,950,750,274000,1980
2150,6117,1,0,1370,780,420000,2003
1590,6000,1.5,0,1590,0,1.06E+06,1925
4670,43950,2,0,4670,0,1.42E+06,1989
1800,5000,1,0,1080,720,618500,1942
1670,10800,1,0,1670,0,295000,1956
1010,12252,1,0,1010,0,400000,1980
2550,6677,2,0,2550,0,595000,2002
3700,20570,1,0,1850,1850,1.73E+06,1976
1350,7686,1,0,1350,0,261000,1987
1660,4000,1.5,0,1660,0,780000,1929
1390,5040,1,0,1090,300,589000,1947
1720,9125,1,0,1140,580,230000,1981
2980,2147,2.5,0,2490,490,690000,2006
2190,15491,2,0,2190,0,524000,1981
1230,987,2,0,1060,170,380000,2011
1000,4080,1,0,740,260,357500,1945
2500,10697,1,0,2500,0,330000,1994
2240,4750,1,0,1120,1120,635000,1920
2820,4480,2,0,1880,940,934000,1918
1400,865,2,0,1110,290,358500,2005
1470,6867,1,0,1470,0,401000,1955
1820,7750,1,0,1820,0,270000,1992
2060,6000,1,1,1370,690,705000,1954
1670,17071,1,0,1100,570,325000,1988
1540,7740,1,0,1540,0,384950,1909
1210,9730,1,0,1210,0,310000,1953
3430,42775,2,0,3430,0,829950,1992
2550,6021,2,0,2550,0,353000,2002
1060,7700,1,0,820,240,170500,1981
3670,49658,2,0,3670,0,885250,1999
4420,7850,2,4,3150,1270,2.70E+06,2001
1550,9126,1,0,1550,0,245000,1957
1190,1290,3,0,1190,0,469000,2008
1300,3550,1.5,0,1300,0,455000,1927
2430,5959,2,0,2430,0,305000,2002
4290,37607,1.5,0,4290,0,840000,1982
3500,10155,2,0,2570,930,905000,1996
1680,7000,1.5,0,1680,0,219200,1968
1250,8004,1,0,1250,0,455000,1965
1020,8100,1,0,1020,0,195000,1940
1510,4178,2,0,1510,0,799000,1902
910,8155,1,0,910,0,285000,1948
1320,15053,1,0,1320,0,300000,1979
900,8580,1,0,900,0,83000,1918
890,4804,1,0,890,0,220000,1928
1240,2689,2,0,1240,0,174500,1986
2960,10760,2,0,2960,0,695000,1987
1020,11410,1,0,1020,0,255000,1959
2590,7245,1,0,1510,1080,539000,1973
1100,2800,1,0,1100,0,552700,1925
1300,6710,1,0,1300,0,571500,1952
1200,6561,1,0,1200,0,263700,1950
7710,11750,3.5,0,6090,1620,3.30E+06,1904
1390,1302,2,0,1390,0,186950,1986
1430,53628,2,0,1430,0,520000,1985
1250,7194,1,0,1250,0,358000,1969
840,49658,1,0,840,0,210000,1948
5020,8694,2,1,3970,1050,3.65E+06,2007
2060,8767,2,0,2060,0,543000,1983
2000,10679,1,0,1350,650,330000,1960
1530,3400,1,0,990,540,529000,1907
700,2500,1,0,700,0,295000,1907
950,8450,1,0,950,0,365000,1962
1380,1081,3,0,1380,0,473000,2005
1830,8004,1,0,1200,630,403500,1960
1790,8203,1.5,1,1790,0,544000,1910
1340,4000,1.5,0,1340,0,621000,1927
1520,5750,2,0,1400,120,672600,1908
1370,3125,1,0,1090,280,689800,1950
1470,4480,1,0,1130,340,613000,1918
2500,8866,2,0,2500,0,808000,1987
1060,9241,1,0,1060,0,301000,1956
1210,9635,1,0,1210,0,340000,1987
920,8400,1,0,920,0,206000,1963
1340,6000,1,0,1340,0,550000,1960
960,4800,1.5,0,960,0,325000,1912
1630,7586,2,0,1630,0,475000,1986
1840,7350,1,0,1310,530,432100,1976
3085,7280,1,0,1560,1525,359000,1959
920,4800,1,0,780,140,490000,1926
2260,7005,1,1,1130,1130,648360,1947
1730,11986,1,3,1730,0,340000,1918
1610,8069,1,0,1090,520,545000,1955
550,7980,1,0,550,0,115000,1952
2400,12350,1,0,1420,980,705640,1968
1960,1585,2,0,1750,210,300000,2003
3190,14904,1,3,1940,1250,1.65E+06,1949
3160,4200,2,4,2180,980,1.14E+06,1999
1550,7410,1.5,0,1550,0,280000,1944
1930,7650,1,0,1280,650,245000,1981
1170,4590,1.5,0,1170,0,564000,1925
2520,4534,1,0,1460,1060,849000,1954
1220,7447,1,0,1220,0,698000,1964
960,8556,1,0,960,0,319000,1971
4110,15720,1,1,2230,1880,1.45E+06,2000
3310,21050,2,0,2400,910,695000,1992
2220,5310,1,0,1170,1050,680000,1951
2250,12000,2,0,2250,0,287500,1985
1510,1850,2,2,1230,280,465000,2001
1350,14212,1,0,1350,0,335000,1981
2420,37800,1,0,1880,540,602000,1981
2950,6545,2,0,2950,0,482000,2003
1260,8382,1.5,0,1260,0,220000,1918
1700,6025,1,0,1700,0,206000,1978
3320,5760,2,0,2120,1200,1.10E+06,1954
1470,3971,2,0,1470,0,491150,2003
2500,12848,1,1,2120,380,390000,1975
2641,8091,2,0,2641,0,393000,1998
2260,8457,2,0,2260,0,635000,1992
1160,5000,1,0,1160,0,490000,1937
3680,2242,2.5,0,2670,1010,770000,1930
1615,4590,1.5,0,1615,0,665000,1906
1250,26862,1,0,1250,0,287000,1965
1230,7020,1,0,1090,140,410000,1924
2510,5200,1,0,1470,1040,562000,1925
1540,54450,2,0,1540,0,475000,1983
1860,2218,3,0,1860,0,387500,2001
2700,10875,1,0,1540,1160,580000,1962
3290,6830,2,0,3290,0,930000,2000
2700,18893,1,0,2110,590,625000,1948
1570,5600,1,0,1570,0,325000,1999
1950,8712,1,0,1950,0,235000,1960
1380,4390,1,0,880,500,450000,1931
2410,5650,1.5,0,2070,340,745000,1909
1200,8470,1,0,1200,0,223000,1961
1770,12278,1,0,1350,420,630000,1937
1540,1614,3,0,1470,70,413450,2008
2860,5379,2,0,2860,0,720000,2005
1740,21980,1,0,1740,0,339000,1973
2830,4000,1.5,0,1840,990,1.12E+06,1919
4280,11307,2,0,2710,1570,839000,1996
3890,25470,2,3,3030,860,2.95E+06,1923
2340,50233,1,0,1170,1170,568000,1966
1410,10577,1,0,1410,0,269000,1994
1350,2560,1,0,1350,0,382000,1974
1100,1114,2,0,900,200,574000,2009
2070,4697,2,0,2070,0,405000,2002
2360,9938,1,0,1690,670,572000,1987
2760,12100,2,0,2760,0,675000,1976
1220,7980,1.5,0,1220,0,165000,1944
1220,7980,1.5,0,1220,0,260000,1944
1220,6719,1,0,1220,0,196000,1953
3020,12184,2,0,3020,0,515000,2003
3470,7396,2,3,2520,950,810000,1979
2380,7700,2,0,2380,0,365650,1977
2260,1834,2,0,1660,600,651000,2002
720,6345,1,0,720,0,240000,1943
1730,6007,1,0,1730,0,299000,2004
2660,10928,2,0,1830,830,768000,1988
1030,5072,1,0,1030,0,397380,1924
2890,6885,1,0,1590,1300,476000,1945
890,5200,1,0,890,0,315000,1957
1410,7290,1,0,940,470,240000,1980
810,4080,1,0,810,0,325000,1941
1370,8006,2,0,1370,0,160000,1990
2260,5100,2,0,2260,0,435000,2007
1430,16200,1,0,1430,0,427500,1967
2510,10240,1,0,1410,1100,450000,1984
1760,4880,1.5,3,1290,470,688000,1928
1430,3600,1,0,980,450,285000,1947
1510,1125,3,0,1510,0,530000,2006
1320,7694,1,0,1320,0,195000,1928
1180,7384,1,0,1180,0,250200,1959
1560,8570,1,0,1080,480,1.10E+06,1977
2470,10321,2,0,2470,0,732500,1988
2190,8834,1,0,1390,800,194250,1987
1610,8000,1,0,1190,420,526000,1966
2700,9882,2,0,2700,0,520000,1958
1530,6125,1,0,1120,410,526000,1958
7320,217800,2,0,7320,0,1.14E+06,1992
920,7569,1,0,920,0,202000,1950
2990,8622,2,0,2990,0,645500,2000
720,7540,1,4,720,0,570000,1905
1750,9000,1.5,0,1750,0,325000,1936
2410,5930,2,0,1930,480,725000,2007
1240,10361,1,0,1240,0,192000,1987
1010,9219,1,0,1010,0,560000,1960
2770,6116,1,0,1490,1280,283450,1979
2800,5400,1,0,1400,1400,863000,1924
1400,4800,2,0,1400,0,815000,1986
1020,7679,1,0,1020,0,245000,1942
2860,10292,1,0,2860,0,1.32E+06,1953
4270,12305,2,2,4270,0,1.16E+06,1994
2270,4488,2,0,2270,0,480000,1999
2560,5593,2,0,2560,0,600000,2001
900,5220,1,0,900,0,329950,1956
2010,12085,2,0,2010,0,299500,1986
1690,5131,1,0,1690,0,460000,1941
2310,5249,2,0,1560,750,515000,2000
1520,1245,3,0,1520,0,405000,2004
1220,3780,1.5,0,1220,0,483000,1927
2170,11511,2,0,2170,0,377000,1992
2790,17476,1,2,1450,1340,568000,1956
1760,4600,1,0,850,910,355000,1926
2100,3000,1.5,0,1500,600,640000,1911
1430,5909,1,0,1070,360,270000,1947
2450,8193,2,0,2450,0,559950,2005
1820,8261,1,0,1420,400,515000,1969
1850,5712,1,0,1850,0,352000,1954
1870,9000,1,0,1870,0,595888,1958
2580,7344,2,0,2580,0,588000,1977
3680,8580,1,3,1840,1840,1.05E+06,1959
1750,7000,2,0,1750,0,260000,1983
3890,3600,2,0,2860,1030,1.60E+06,2005
1000,4800,1,0,1000,0,380000,1952
2210,6327,1,0,2210,0,802000,2003
2850,4800,2.5,0,2700,150,1.33E+06,1905
2460,3600,2,0,1640,820,710000,1907
2630,77972,2,0,2630,0,600000,2004
1750,5355,2,0,1750,0,707900,1929
1100,7323,1,0,780,320,179950,1982
2620,10489,2,0,2620,0,683000,1990
1200,9566,1,0,1200,0,222400,1995
1920,3408,1,0,960,960,517000,1912
1690,5763,1,0,1180,510,410000,1985
1680,2552,1,0,840,840,480000,1952
3440,10428,1.5,0,3440,0,430000,1974
2190,7500,1,0,1290,900,439950,1979
3270,8223,2,0,3270,0,797500,1998
1280,5460,1.5,0,1080,200,379000,1920
1310,8667,1.5,0,1310,0,575000,1918
1660,11060,1,0,1110,550,247500,1962
2700,37011,2,0,2700,0,385000,1984
1940,6909,1,0,970,970,423000,1941
1520,5618,1,0,1170,350,550000,1953
1620,4329,1.5,0,1620,0,415000,1927
2090,45535,1,2,1280,810,693000,1952
1070,4700,1,0,1070,0,543000,1910
2000,10246,1,2,1200,800,465000,1953
1020,2217,2,0,720,300,280000,2004
2400,6653,3,2,2400,0,1.39E+06,1992
2480,9720,2,0,2480,0,665000,1972
1310,7314,1,0,1310,0,237950,1960
2420,10200,1,0,1220,1200,440000,1962
1890,4700,1,0,1030,860,618000,1928
1860,4000,1.5,0,1020,840,572000,1920
2500,4774,1.5,2,1450,1050,725000,1940
1970,22144,1,0,1970,0,454000,1970
1660,10656,1.5,0,1180,480,535000,1920
1850,7200,1,0,1500,350,249000,1979
1970,37026,1,0,1970,0,395000,1961
1890,6620,1,3,1890,0,690000,1954
1310,7236,1,0,1170,140,526500,1928
1870,7220,2,0,1870,0,325000,1956
1520,4080,2,0,1520,0,495000,1948
3070,8474,2,0,3070,0,825000,2011
1400,14850,1.5,0,1400,0,383000,1910
1960,11931,1,0,980,980,320000,1954
2680,87117,1,0,1340,1340,475000,1989
2030,6326,2,0,2030,0,275000,1993
2320,9300,1.5,4,1920,400,1.15E+06,1937
1760,11371,1,0,1760,0,455000,1959
1870,7800,1,0,1580,290,262000,1962
1280,4840,1,0,940,340,390000,1950
1730,10030,1,0,1730,0,300000,1985
2060,5721,1,2,1140,920,746300,1964
1030,8223,1,0,1030,0,267000,1952
1720,7950,1.5,0,1720,0,525000,1972
1210,7350,1,0,1210,0,570000,1977
2620,8100,1,0,1550,1070,360000,1964
1860,44431,1,0,1860,0,1.05E+06,1947
2510,4106,2,0,2510,0,699950,2003
2040,109336,1.5,0,2040,0,375000,1973
2410,6770,1,0,1220,1190,625000,1924
780,2750,1,0,780,0,464050,1928
2210,9655,1,0,1460,750,470000,1976
1590,9100,1,0,1040,550,330000,1967
2230,7957,1,0,2230,0,537000,1967
1560,32137,1,0,910,650,250000,1976
2950,48351,2,0,2950,0,835000,1986
1480,3750,1.5,0,1480,0,770000,1912
2850,4497,1.5,1,1730,1120,650000,1910
2390,30409,1,0,1560,830,335000,1953
1740,29597,1,0,1740,0,350000,1965
2060,8906,1,0,1220,840,415000,1978
2680,8778,2,0,2680,0,788000,1977
3150,7379,1.5,0,2430,720,640000,1915
2440,7155,2,0,2440,0,388000,1993
2230,10080,1,0,1390,840,360000,1969
2230,10080,1,0,1390,840,692500,1969
1600,6180,1.5,0,1600,0,425000,1946
1600,6180,1.5,0,1600,0,645000,1946
1580,8308,1.5,0,1580,0,340000,1948
2840,54400,1,0,2840,0,713000,1984
2550,11160,2,0,2550,0,430000,1994
1700,7210,1,0,1250,450,280000,1974
1470,2052,1.5,0,1470,0,215000,1986
1680,11193,2,0,1680,0,306000,1984
1110,8593,1,0,1110,0,299900,1979
2120,8625,1,0,1200,920,534000,1959
2380,5572,2,4,1930,450,1.16E+06,1939
2670,5000,2,3,2000,670,1.17E+06,1942
890,6430,1,0,890,0,199990,1935
3140,9058,1,0,2140,1000,946000,1989
1260,7800,1.5,0,1260,0,295000,1947
920,5157,1,0,920,0,475000,1909
2990,212137,2,0,2450,540,750000,1994
3120,49456,2,4,2590,530,1.23E+06,1974
1010,7520,1,0,1010,0,183500,1975
1010,3627,1,2,1010,0,450000,1924
1020,5500,1.5,0,1020,0,180000,1961
3540,21217,2,0,2940,600,707000,1926
900,3527,1,0,900,0,230000,1939
1100,9750,1,0,1100,0,192500,1966
1990,3614,2,0,1990,0,309000,2005
1980,5800,1,0,1520,460,759000,1949
4040,14212,2,0,4040,0,1.12E+06,2002
1250,10530,1,0,1250,0,462000,1966
1820,22814,1.5,0,1820,0,229000,1920
1140,1184,2,0,1010,130,399950,1999
1730,10532,1,0,1730,0,325000,1943
1170,1313,3,0,1170,0,512000,2007
2910,5802,2,0,2910,0,410000,2006
970,5500,1,0,970,0,210000,1956
2130,8499,1,0,1600,530,325000,1975
2520,10175,1,0,1630,890,685000,1979
1360,4688,1,0,780,580,488000,1944
1620,6000,1,0,1280,340,247500,1998
2120,11479,1,0,1060,1060,489000,1940
2700,6000,1,0,1450,1250,725000,1953
1370,10317,1.5,0,1370,0,199950,1958
2520,13001,2,1,2010,510,670000,1973
1540,10410,1,0,1540,0,275000,1967
2610,6360,2,2,2130,480,1.00E+06,1924
1490,8371,1.5,0,1490,0,255000,1984
2760,9137,1,0,1380,1380,465000,1960
1260,3604,1,0,1260,0,259000,2012
2630,4713,2,2,2030,600,695000,2008
1800,7210,1,0,1370,430,505000,1976
1130,2640,1,0,1130,0,631500,1927
1180,3600,1.5,0,1180,0,630500,1926
2800,19168,2,0,2800,0,999000,1992
1830,4000,1,0,1350,480,740000,1910
2220,6380,1.5,0,1660,560,650000,1931
1870,5580,1,0,1870,0,554000,2004
2580,214315,1.5,0,2580,0,400000,1946
1660,10000,1,0,1010,650,529941,1961
1330,3740,1.5,0,1330,0,310000,1903
1330,3740,1.5,0,1330,0,389000,1903
2630,4972,2,0,2630,0,731781,2006
1100,4750,1,0,1100,0,502501,1946
1810,7950,1,0,1810,0,443000,1968
2060,4080,1,0,1060,1000,607000,1921
4660,5500,2,4,3040,1620,2.15E+06,1909
2370,15200,1,0,1660,710,585000,1975
2430,10500,2,1,2430,0,1.03E+06,1989
1880,7000,2,0,1880,0,315000,1993
1150,5695,1,0,1150,0,180000,1958
1350,14200,1,0,1350,0,322500,1989
2180,7519,1,0,1310,870,568500,1981
3370,6675,1,3,1920,1450,813000,1948
3650,13068,1,0,1850,1800,1.09E+06,1976
2100,4857,2,0,2100,0,424000,1965
670,5600,1,0,670,0,235000,1903
2420,4000,2,0,1820,600,740000,1907
760,3000,1,0,760,0,415000,1900
2200,14925,1,0,1100,1100,432000,1982
4410,35192,2,2,3880,530,1.27E+06,1990
1300,2446,1,3,880,420,676500,1961
720,4592,1,0,720,0,419000,1943
2180,37042,2,0,2180,0,650000,1998
1130,15190,1,0,1130,0,239000,1954
2230,4372,2,0,1540,690,900000,1935
2100,7347,1,0,1070,1030,330000,1981
2060,58341,1,4,1100,960,510000,1982
3060,6000,2,0,3060,0,465000,2012
2810,18731,2,4,2810,0,1.70E+06,1974
2550,8588,1,4,2550,0,490000,1989
4290,20445,2,0,4290,0,2.68E+06,1985
3040,52302,1,0,3040,0,1.00E+06,2005
2530,14178,2,0,2530,0,469950,1997
1300,5413,1.5,0,1300,0,536000,1925
1790,19177,1,0,1790,0,244950,1966
1530,2400,1,0,890,640,575000,1928
2380,7500,1,0,1300,1080,361000,1984
2400,13450,1,0,1200,1200,650000,1957
1030,6000,1,0,830,200,230005,1951
3250,235063,1,2,3250,0,293000,1973
1970,24318,1,0,1970,0,445000,2010
1940,6386,1,0,1140,800,280000,1954
1850,10855,1,0,1370,480,520000,1985
3900,40962,2,0,3900,0,780000,1991
3160,76230,1,0,2160,1000,625000,1978
1440,7200,1,0,1440,0,239950,1986
2040,6000,1,0,1340,700,335000,1957
2120,7401,2,0,2120,0,612000,1989
830,8000,1,0,830,0,200000,1954
3140,8571,1,0,1670,1470,345000,1985
2410,6440,1,0,1550,860,520000,1974
2190,4080,2,0,1800,390,855000,1918
2190,5060,1,0,1190,1000,567500,1950
1210,7247,1,0,1210,0,208000,1967
1880,16239,1,0,880,1000,452000,1922
2410,12183,2,0,2410,0,555000,1988
2620,8861,1,0,1350,1270,519000,1979
1850,2575,2,0,1850,0,474950,2013
1760,16418,1,0,1190,570,419000,1990
860,1800,1,0,860,0,390000,1909
2620,6890,2,0,2620,0,539000,1961
2400,21196,1,0,1590,810,569000,1956
1850,5000,1.5,0,1850,0,611000,1922
4040,147856,2,0,4040,0,760000,2004
1940,55756,1,0,1940,0,732000,1954
3490,8343,2,4,2150,1340,1.68E+06,1939
3170,7062,2,0,3170,0,919950,2014
2530,7563,1,0,1440,1090,400000,1978
3230,21781,2,0,3230,0,785000,1993
2120,54014,2,0,2120,0,835000,1964
1640,6750,1,0,1340,300,640500,1939
2130,9013,2,0,2130,0,310000,1988
1440,7215,1.5,0,1440,0,355000,1969
1940,7313,1,1,1440,500,685000,1960
1120,8576,1,0,1120,0,202500,1943
2400,5817,2,0,2400,0,540000,1998
1810,4871,2,0,1810,0,295000,1999
1270,6612,1.5,3,1270,0,518000,1927
1350,4023,1,0,1350,0,250000,2005
1550,435600,1.5,0,1550,0,330000,1972
1620,3880,1,0,920,700,481000,1924
2650,12845,1,3,1770,880,898000,1977
2510,9750,1.5,0,2510,0,570000,1969
2040,16200,2,0,2040,0,475000,1997
1660,5250,2,0,1660,0,265000,1988
1980,17342,2,4,1580,400,380000,1984
2690,8036,2,0,2690,0,790000,1987
2910,6110,2,2,2910,0,620000,1985
2720,9000,2,0,2670,50,709050,1997
1280,5100,1,0,1280,0,296500,1948
2160,35912,2,0,2160,0,475000,1982
1760,10835,1,0,1290,470,440000,1976
800,6016,1,0,800,0,405000,1942
930,4000,1,0,730,200,269500,1943
2040,5280,1,0,1020,1020,520000,1961
1180,22000,1,2,1180,0,229500,1948
2000,10890,1,0,1390,610,335000,1961
3310,50951,2,0,3310,0,680000,1998
3130,3900,2,0,2550,580,1.39E+06,2008
2300,9900,1,2,1600,700,740000,1961
2140,9990,1,0,2140,0,270000,1962
2210,5572,1.5,3,1760,450,510000,1911
970,13700,1,0,970,0,300000,1949
2690,10800,1,3,2020,670,1.30E+06,1956
1890,5188,1.5,0,1670,220,675000,1940
3140,14923,2,0,3140,0,925850,1991
1440,43560,1,0,1150,290,255500,1965
2910,17172,2,0,2910,0,450000,1989
1310,22652,1,0,1310,0,280000,1968
2140,8800,2,0,2140,0,245000,1963
1090,6712,1,0,1090,0,344950,1972
1330,7216,1,0,1330,0,381000,1969
4690,6900,2,0,3480,1210,1.95E+06,2001
1910,21374,1,0,1910,0,1.50E+06,1955
1750,11461,2,0,1750,0,232603,1976
1760,10200,1.5,0,1760,0,220000,1925
1810,7700,1,0,1390,420,600000,1977
1360,5754,2,0,1360,0,239000,1994
1730,9211,1,0,1730,0,400000,1961
4710,11000,2,3,3690,1020,2.18E+06,1931
1010,8551,1,0,1010,0,350000,1953
2400,97138,2,0,2400,0,562000,1983
1540,8400,1,0,1540,0,380000,1968
1480,7875,1,0,740,740,511200,1927
2520,5000,2,0,2520,0,680000,2004
1210,941,2,0,1000,210,350000,2002
2670,184140,1,0,1410,1260,410000,1980
3030,12590,1.5,0,3030,0,1.05E+06,1988
1440,3900,1,0,1440,0,391265,2002
3250,16684,2,0,3250,0,1.41E+06,1979
1750,5750,1,2,870,880,575000,1956
2120,46173,2,0,2120,0,316000,1974
1050,5156,1.5,0,1050,0,165000,1919
1950,3600,1.5,0,1430,520,850000,1911
1020,6000,1,0,1020,0,210000,1900
1820,9161,1,0,1220,600,325000,1975
2390,53941,2,0,2390,0,682000,1989
1400,7508,2,0,1400,0,430000,1987
1540,8110,1,0,1190,350,325500,1959
2370,6360,1,3,1280,1090,385000,1954
670,1800,1,0,670,0,435000,1905
2420,15520,2,0,2420,0,550000,1945
1000,7800,1,0,860,140,400000,1930
2100,7350,1,0,1240,860,503000,1978
2800,5368,2,0,2800,0,676000,2003
940,11055,1.5,0,940,0,180000,1959
1640,5280,1.5,0,1640,0,234000,1910
2760,5000,1.5,0,1680,1080,734200,1928
3660,66211,2,0,3660,0,920000,2003
3070,34412,1,3,2070,1000,1.92E+06,1950
1100,10125,1,0,1100,0,224000,1969
3130,19530,1,4,1690,1440,1.40E+06,1947
1320,7155,1,0,1320,0,185000,1961
1470,5000,1.5,0,1470,0,554600,1900
1480,8009,1,0,980,500,268000,1980
2260,8715,1,0,1530,730,675000,1976
2210,10039,1,0,1710,500,620000,1967
1540,12446,1,0,1540,0,396450,1967
1910,9720,1,0,1390,520,565000,1955
1760,3520,1,0,1160,600,410000,1966
2240,6000,1.5,0,1270,970,1.19E+06,1914
2110,7279,1,0,2110,0,716125,1984
1396,111949,1,0,1396,0,225000,1940
3040,7274,2,3,2320,720,640000,1986
1140,5650,1,1,980,160,374000,1920
1780,12161,1,0,1160,620,415000,1950
3370,35150,1,0,1770,1600,592500,1993
1484,1761,3,0,1484,0,365000,2003
2230,12753,1,0,1180,1050,600000,1981
2820,39413,2,0,2820,0,465000,1989
1580,7560,1,0,1000,580,254999,1976
2040,8076,2,0,2040,0,279000,1994
2720,40813,2,0,2720,0,460000,2001
1490,956,2,0,1020,470,507000,2005
1560,9788,1,0,1560,0,291000,1964
830,1077,2,0,830,0,350000,2006
980,2490,2,0,980,0,90000,1969
1980,7000,1,0,1360,620,329000,1977
3680,11648,2,0,3680,0,909000,1986
860,5400,1,0,860,0,187000,1953
1850,5100,1,0,1020,830,580000,1909
1620,5992,2,0,1620,0,345000,2001
2240,7200,2,0,2240,0,497000,1995
1010,3060,1.5,0,1010,0,345000,1904
1610,7350,1,0,1610,0,313500,1974
2720,7250,2,0,2720,0,910000,1990
2080,5244,1,0,1190,890,399950,1959
1930,6600,1,0,1030,900,268000,1967
2250,8458,1,0,1450,800,559000,1954
1980,8755,1,0,1300,680,309000,1963
1960,4400,2,0,1960,0,410000,2006
1320,8625,1,0,1320,0,259000,1957
2940,5500,2,0,2340,600,950000,1909
1460,7200,1.5,0,1460,0,320000,1955
2330,30122,1,1,1490,840,1.15E+06,1951
2620,10107,1,3,2620,0,394250,1982
700,3876,1,0,700,0,315000,1910
1140,12000,1,0,1140,0,480000,1943
2750,35440,2,0,2750,0,556000,1994
2480,5647,2,0,2480,0,450000,2002
1130,5413,1,0,940,190,420000,1946
2770,5000,1,0,1870,900,890000,1969
1710,8814,1,0,1030,680,295000,1975
2150,27345,2,0,2150,0,410000,1976
2250,7294,2,0,2250,0,308900,1994
2960,26742,1,3,1480,1480,1.16E+06,1949
2300,6984,1,0,2300,0,665000,2006
1740,5500,1,0,970,770,577000,1953
2830,3750,3,0,2830,0,959000,2014
1240,6417,1,0,1240,0,471000,1924
2180,7169,2,0,2180,0,560000,1990
2510,9887,2,0,2510,0,955000,1972
6630,13782,2,0,4930,1700,1.24E+06,2004
2300,18540,1,0,1800,500,579000,1961
3220,7889,2,0,3220,0,335000,1978
2270,7887,2,2,2270,0,485000,2004
1840,9900,1,0,1840,0,552000,1978
3820,15293,2,0,3820,0,950000,2003
1660,7958,1,0,1130,530,203700,1983
3360,9767,2,0,2450,910,412000,1990
1350,8960,1,0,1350,0,237500,1986
2970,5000,2,2,2200,770,866800,2001
1000,5100,1,0,860,140,425000,1946
1190,6833,1,0,1190,0,200000,1995
1670,6034,1,0,990,680,280000,1957
1200,2002,2,0,1200,0,140000,1966
2250,10400,1,0,1280,970,370000,1973
1040,4000,1,0,930,110,550000,1909
3180,9400,2,4,2610,570,1.41E+06,1985
3180,9400,2,4,2610,570,1.51E+06,1985
2040,8800,1,0,1020,1020,510000,1961
1160,10518,1,0,1160,0,351000,1960
880,10800,1,0,880,0,210000,1942
2290,36900,1.5,2,1690,600,449999,1938
950,7620,1,0,950,0,137000,1954
1010,14510,1,0,1010,0,270000,1974
3100,100188,1,0,1820,1280,540000,1981
2560,12480,1,0,1590,970,565000,2012
2430,3600,2.5,0,2430,0,940000,1980
830,26329,1,3,830,0,385000,1928
2090,7634,1,0,1450,640,400000,2001
2030,8649,1,0,2030,0,365000,1998
1060,1600,2,0,1060,0,353250,1979
1090,6750,1,0,950,140,455000,1942
3400,234352,2,0,2500,900,475000,1991
1920,7455,1,0,960,960,571500,1939
1150,3000,1,0,780,370,441000,1915
3970,9500,1,0,2180,1790,810000,1970
1880,11556,2,0,1880,0,550000,1987
1500,4000,1,0,1100,400,736000,1933
2190,17550,1,0,2190,0,375000,1989
2530,9932,2,0,2530,0,717500,1995
1930,11200,1,2,1430,500,581000,1951
1510,4560,2,0,1510,0,629000,1909
5510,35000,2,4,4910,600,3.80E+06,1997
1100,5200,1,0,1100,0,225000,1969
1730,6368,2,0,1730,0,315000,1993
1480,1386,3,0,1480,0,425000,2005
1150,11802,1,0,1150,0,346500,1932
1950,26500,1,0,1570,380,550000,1965
2380,10450,1,0,1400,980,565000,1977
3100,8000,1.5,0,2040,1060,1.00E+06,1939
2010,3797,1.5,0,1450,560,400000,1922
2270,5760,2,0,2270,0,724950,1909
2050,16313,1,0,2050,0,623000,1973
650,5400,1,0,650,0,295000,1950
2780,7875,2,0,2780,0,700000,2006
1300,1229,2,0,1160,140,482000,2000
2730,11380,2,0,2730,0,770000,1995
3140,22100,1,0,1820,1320,310000,1960
2410,8400,2,0,2410,0,720000,1965
1180,5965,1.5,0,1180,0,355000,1928
2600,4506,2,0,2600,0,512000,2005
1400,1650,3,0,1400,0,303000,1999
2220,9360,1,0,1110,1110,299000,1968
1660,6263,2,0,1660,0,285000,2003
2330,9652,1,0,1590,740,680000,1968
1440,6720,1,0,720,720,285000,1954
2920,17023,1,0,1690,1230,707000,1977
1760,6428,1,0,980,780,690000,1942
2860,40284,2,0,2860,0,872000,1983
2090,12750,1,0,1360,730,290000,1967
1910,16785,1,0,1110,800,425000,1981
3280,10558,1,2,2040,1240,925000,1979
1770,12458,1,0,1770,0,340500,1957
920,6600,1,0,920,0,365000,1910
1690,8489,1,0,1690,0,725000,1959
2470,7410,2,0,1860,610,811000,1977
1040,9514,1,0,1040,0,299000,1969
1220,9147,1,0,1220,0,287500,1953
3500,13875,1,4,1830,1670,879950,1938
760,3800,1,0,760,0,135900,1950
3070,16028,1,3,1870,1200,1.23E+06,1976
2100,6480,1,0,1300,800,522500,1947
1660,6617,1,0,1660,0,399500,1947
1430,5960,1.5,0,1430,0,450000,1917
1620,17500,1,0,1620,0,218000,1962
1490,9285,1,0,1490,0,289999,1995
1170,4750,1,0,1170,0,540000,1903
1240,7500,1,0,1240,0,324950,1976
2910,6600,2,0,1920,990,718500,1900
2660,192099,1,0,2660,0,495000,1964
2220,8797,1,0,2220,0,260000,1977
1920,10000,1,0,1070,850,430000,1954
2780,4002,2,0,2780,0,402500,2009
3110,4408,2.5,3,2510,600,1.42E+06,1931
1820,9766,1,0,1450,370,275000,1987
1765,7652,2,0,1765,0,250000,1996
1800,9550,1,0,1320,480,665000,1966
2650,144183,1,0,2650,0,425000,1967
1410,3600,1.5,0,1310,100,760000,1925
1650,3076,2,0,1650,0,447000,2003
1180,8240,1,0,1180,0,205000,1967
800,8850,1,0,800,0,191000,1959
1430,7921,1,0,1430,0,350000,1983
3300,7860,2,0,2410,890,789888,2001
1220,10170,1,0,980,240,443000,1948
3530,7202,2,0,2660,870,695000,2000
1380,4048,1.5,0,1380,0,560000,1906
1410,5000,1,0,810,600,550000,1923
3360,6750,2,0,3360,0,850000,2004
2270,24237,1,0,1360,910,352750,1977
2890,9045,2,0,2890,0,550000,2001
1750,3861,1.5,0,1750,0,774900,1903
1010,8711,1,0,1010,0,250000,1944
3780,23623,2,0,3780,0,962800,1997
1880,11700,1,0,1880,0,299500,1968
800,5220,1,0,800,0,250000,1943
4720,493534,2,0,3960,760,745000,1975
1060,10600,1.5,0,1060,0,279475,1968
2530,27227,2,0,2530,0,450000,1987
1980,13132,1,0,1260,720,307700,1962
1650,5102,1,0,1300,350,665000,1953
1890,3930,2,0,1890,0,375000,1999
3360,11637,2,0,3360,0,420000,1990
630,4200,1,0,630,0,148000,1930
1980,4000,2,0,1980,0,707000,1919
990,4250,1,0,840,150,399000,1924
3420,115434,2,0,3420,0,570000,1989
3440,35025,2,0,3440,0,853000,1988
1300,14138,1,0,1300,0,400000,1943
2040,28593,1.5,3,2040,0,615000,1919
1250,7700,1,0,1250,0,463000,1955
1960,14242,1,1,1290,670,600000,1958
2720,8120,1,0,1360,1360,429000,1970
3250,11780,2,0,2360,890,980000,1944
3190,4700,2,0,3190,0,359500,2003
2570,7980,2,0,2570,0,715000,1998
1420,6984,1,0,980,440,240000,1980
2120,9442,1,0,1060,1060,455000,1968
2080,167270,1,0,2080,0,610000,2000
2740,5735,2,0,2740,0,675000,2004
1250,5375,1,0,1250,0,283500,1985
2150,4500,1.5,0,1260,890,235000,1917
3230,12100,1,0,1870,1360,827000,1977
860,8511,1,0,860,0,353000,1949
2810,11902,2,0,2810,0,747500,1993
1040,4000,1,0,1040,0,341000,1914
1160,18055,1,0,1160,0,182000,1950
1470,2781,2,0,1470,0,250000,2003
2350,13402,2,3,1670,680,655000,1994
1660,8307,1,0,1660,0,405000,1961
2020,9750,1,0,1100,920,390000,1975
890,8180,1,0,890,0,275400,1947
2430,5500,2,0,1810,620,791000,1989
1460,7700,1,0,1460,0,424500,1979
980,7200,1,0,980,0,430000,1950
2580,10631,2,2,2580,0,865000,1992
1250,7543,1,0,1250,0,163000,1962
3140,9085,1,2,1570,1570,920000,1961
2680,3011,2,0,1870,810,1.03E+06,1910
1810,8048,1,0,1290,520,325000,1983
2090,4698,2,0,2090,0,315000,1998
1120,8763,1,0,1120,0,227000,1971
1790,7175,1.5,0,1410,380,179000,1900
870,2676,1,0,820,50,276000,2004
3160,19745,1.5,0,1840,1320,335000,1968
2350,12480,1,0,1600,750,430000,1981
1810,4113,2,0,1810,0,266490,2004
3160,8197,1,0,1580,1580,655000,1962
1660,3600,1,0,1000,660,635500,1939
2500,9583,1,0,1300,1200,235000,1979
2880,11443,2,0,2880,0,885000,1986
1470,8400,1,0,1470,0,352500,1953
1460,7573,2,0,1460,0,450000,1983
5490,19897,2,0,5490,0,3.64E+06,2005
2480,15022,1,4,1330,1150,1.05E+06,1967
1140,1332,3,0,1140,0,476000,1999
1830,13042,2,0,1830,0,375000,1990
3110,6829,2,0,3110,0,600600,2014
2630,11213,1,2,1430,1200,567000,1948
2390,12000,1,0,1470,920,650000,1979
1750,10284,1,0,1750,0,190000,1943
4370,422967,1,2,2580,1790,858000,1978
1020,4512,1,0,770,250,435500,1937
2500,6733,1,0,1770,730,685000,1979
1540,7210,2,0,1540,0,252000,1984
2200,6900,2,0,2200,0,512500,1975
1940,7415,2,0,1940,0,423800,1965
1453,2225,2,0,1453,0,460000,1986
1830,3200,2,0,1830,0,434000,1991
2000,15900,1,0,1000,1000,244000,1948
1400,8451,1.5,0,1400,0,348125,1953
2400,29252,2,0,2400,0,585000,1982
1390,16000,1,0,1390,0,230000,1960
1680,11250,1,0,1680,0,450000,1967
1820,5054,1,0,910,910,393000,1970
1140,3750,1,0,1140,0,517000,1925
1060,12690,1,0,1060,0,400000,1969
3050,50965,2,0,3050,0,890000,1991
970,11963,1,0,970,0,205950,1970
1320,3954,1.5,0,1320,0,209000,1912
1890,6000,1,0,1110,780,430000,1947
2040,2750,1.5,0,1260,780,534000,1926
2370,3672,1.5,0,1650,720,735000,1916
2720,54450,2,0,2720,0,873000,1997
1970,7532,1,0,1390,580,475000,1983
2180,10230,1,0,1090,1090,325000,1961
2990,216057,2,0,2990,0,500000,1994
2180,8475,1,0,1330,850,279000,1987
1440,5469,1,0,1440,0,350000,1988
3180,13653,2,0,3180,0,660000,1978
1643,14616,1,1,1643,0,324950,1954
1530,7816,1,0,1530,0,500000,1955
1310,7697,1,0,850,460,187300,1950
2800,5120,2.5,0,2800,0,345600,1903
1510,7642,1,0,1510,0,400000,1959
2700,5001,2,0,2700,0,935000,2009
2220,15600,1,0,1140,1080,374000,1963
1440,45302,2,0,1440,0,328000,1977
1300,9334,1,0,1300,0,257500,1981
2230,3600,2,0,1630,600,1.00E+06,1906
1390,4482,1,0,1390,0,216500,1980
2760,40946,2,0,2760,0,1.19E+06,1978
3200,7282,2,0,3200,0,360000,2007
1240,4000,1,0,1240,0,699999,1968
1960,47044,2,0,1960,0,535000,1978
2190,19800,1,0,2190,0,464950,1994
3540,18168,2,0,3540,0,925000,1996
2640,4080,2,0,1840,800,930000,1912
2660,5000,1.5,3,1940,720,727500,1910
1670,9500,1,0,1670,0,325000,1976
3080,12100,2,0,2080,1000,695000,1984
2890,6825,1,0,1560,1330,585000,1973
1800,9597,1,2,1200,600,319000,1963
2000,7650,1.5,0,1790,210,265000,1960
1940,6654,1.5,0,1940,0,359000,1953
1940,6654,1.5,0,1940,0,390000,1953
960,9531,1,0,960,0,374500,1969
1750,46173,2,0,1750,0,661000,1964
2320,5000,2,0,1620,700,900000,1907
2380,8204,1,0,1540,840,600000,1957
6490,10862,2,3,3940,2550,2.00E+06,1991
1620,4240,1.5,0,1620,0,512500,1916
1770,33224,1,0,1770,0,229500,1968
2320,5663,2,0,2320,0,589000,2003
1330,2183,3,0,1330,0,539950,2014
3420,21344,2,0,3420,0,640000,2002
1270,7344,1,0,970,300,218250,1967
2550,3600,2,2,1880,670,675000,1997
1860,9000,2,0,1860,0,338000,1980
1020,7615,1,0,1020,0,231750,1981
720,7140,1,0,720,0,199900,1930
4460,16271,2,2,4460,0,1.06E+06,2001
1830,7315,1,0,1250,580,263000,1979
1520,7200,1,0,1160,360,279950,1990
1080,2940,1.5,0,1080,0,395000,1920
1900,8002,1,0,1900,0,252500,1991
5300,37034,2,0,5300,0,1.15E+06,1989
1370,10708,1,0,1370,0,205000,1969
2960,8968,1,0,1640,1320,654000,1965
960,213008,1,0,960,0,200000,1933
2190,7982,2,0,2190,0,700000,2004
3990,18115,2,0,3990,0,2.72E+06,1989
1200,2622,1,0,800,400,306000,1956
1780,5015,2,0,1780,0,270000,2010
2630,9916,2,0,2630,0,340000,1988
2300,19250,1,0,2300,0,450000,1955
3210,6825,1,0,1810,1400,580000,1975
2290,4400,1,3,1290,1000,435000,1959
2780,4688,2,0,2780,0,690000,2003
2650,11520,2,0,2110,540,720000,1988
1840,13020,1,0,1390,450,403000,1980
1560,7392,1,0,1030,530,440000,1972
1200,8470,1,0,1200,0,178500,1961
1900,8282,1,0,1900,0,270000,1968
710,9900,1,0,710,0,129888,1943
1360,15210,1,0,1360,0,260000,1987
2990,7292,2,0,2990,0,339950,1990
1640,26127,2,0,1640,0,250000,1975
3650,103672,1,0,2050,1600,680000,2011
2920,3745,2,0,1860,1060,660000,1913
3680,11491,2,2,3680,0,1.23E+06,1999
1830,9152,1,0,1830,0,550000,1959
2570,12906,2,0,2570,0,675000,1987
2730,9588,2,1,1900,830,981000,1984
1150,8000,1.5,0,1150,0,168000,1913
4260,18687,2,0,4260,0,1.00E+06,1996
1260,9600,1,0,1260,0,320000,1970
4440,17424,1,1,2220,2220,959000,1959
2300,7680,1,0,1270,1030,372000,1959
1920,9625,2,0,1920,0,391500,1993
1080,4725,1.5,0,1080,0,390000,1944
890,5000,1,0,890,0,302000,1947
1650,1577,2,0,1100,550,495000,2012
1820,1545,3,2,1640,180,504500,1998
2320,4800,1.5,0,2170,150,555000,1918
3260,5000,2,0,2630,630,1.55E+06,1937
1730,5750,1,0,1250,480,550000,1947
3320,8325,2.5,0,3320,0,1.80E+06,1905
1660,5422,1,0,830,830,655000,1908
3290,90796,2,0,3290,0,685000,1992
2280,8339,1,0,1220,1060,721000,1954
3650,5328,1.5,0,2330,1320,1.52E+06,1907
1620,219542,2,0,1620,0,365000,1980
2020,8555,1,0,1220,800,458000,1957
1150,12861,1,0,1150,0,280000,1959
1940,3060,1,0,1000,940,628000,1911
3440,6332,2,0,3440,0,781500,2001
2000,7560,1,0,1300,700,295000,1968
750,2786,1,0,750,0,435000,1947
1420,7200,1,0,1000,420,300000,1979
880,4814,1,0,880,0,208500,1906
2680,11214,1,0,2680,0,930000,2006
860,3000,1,0,860,0,316000,1906
1310,6738,1,0,1310,0,249900,1990
1780,4252,2,0,1540,240,675000,1989
1440,4667,2,0,1440,0,447000,1985
1510,3817,1.5,0,1510,0,675000,1905
2100,1397,3,0,1580,520,546000,2008
1310,1361,3,0,1310,0,310000,2003
1280,5100,1,0,880,400,190000,1961
1320,8114,1,0,1320,0,650000,1951
1740,2350,2,0,1130,610,585000,1995
2910,7364,2,0,2910,0,1.43E+06,2003
2500,12090,1,0,2500,0,565000,1983
1100,6000,1.5,0,1100,0,174900,1926
1381,1180,3,0,1381,0,360000,2007
960,9624,1,0,960,0,234000,1953
3840,15990,1,0,2530,1310,575000,1961
2200,5954,2,0,2200,0,315000,2004
1250,7820,1,0,1250,0,225000,1967
2380,14500,1,0,1850,530,370000,1961
1500,3920,1,0,1000,500,606000,1947
1410,7622,1,0,1410,0,272500,1983
1680,3420,1,0,960,720,475000,1992
1500,13500,1,0,1500,0,270000,1968
2710,9216,1,0,1440,1270,624000,1961
1730,7416,1.5,0,1730,0,355000,1954
960,3844,1,0,960,0,345000,1972
2380,7792,2,0,2380,0,342000,1993
1120,98445,1.5,2,1120,0,316000,1917
2960,37430,2,0,2960,0,539950,1990
1580,6655,1,0,790,790,221347,1944
1870,4657,2,0,1870,0,330000,2000
1810,13000,1,0,1470,340,279000,1977
2550,3784,1.5,0,1750,800,850000,1900
1910,12321,1,0,1100,810,746000,1952
1200,1867,1,0,600,600,478000,1924
2420,4635,1.5,0,2420,0,820000,1905
3080,6495,2,3,2530,550,2.16E+06,1996
3850,38830,2,1,3850,0,820000,2000
3000,22040,2,2,2470,530,887000,1942
1360,20000,1,0,1360,0,159000,1953
3670,4000,2,1,2800,870,824000,1964
2270,5000,2,0,2270,0,812000,2014
1750,11400,2,0,1750,0,242000,1975
3550,8048,2,0,3550,0,625000,2007
2370,30200,1.5,0,1570,800,399888,1948
1670,6600,2,0,1670,0,289000,1990
1860,12944,1,0,1860,0,400000,2002
4460,26027,2,0,4460,0,1.55E+06,1992
1080,4000,1,0,1080,0,345000,1940
1080,4000,1,0,1080,0,874950,1940
2280,4280,1,0,1280,1000,875000,1917
2540,32647,2,0,2540,0,628990,1996
2560,5000,1,0,1280,1280,535000,1944
2390,9300,1,0,1430,960,770126,1979
2870,8995,1,0,1870,1000,710000,1968
1510,4800,1,2,860,650,465000,1925
2200,11520,1,0,2200,0,359000,1952
720,5040,1,0,720,0,151000,1949
2970,9600,2,0,2970,0,820000,1994
960,6497,1,0,960,0,160000,1970
1420,5000,1.5,0,1420,0,535000,1945
1800,9010,1,0,1300,500,365000,1975
3090,5600,2,0,3090,0,708000,2005
1200,7280,1,0,1200,0,215000,1967
4065,18713,2,0,4065,0,1.95E+06,1987
2570,22215,2,0,2570,0,390000,1958
1530,5401,1,0,1530,0,570000,1937
1500,13430,1,0,1500,0,383000,1977
2490,5706,2,0,2490,0,370000,2005
3040,12522,2,0,3040,0,454000,2000
4140,32700,1,4,2190,1950,1.40E+06,1973
1690,10854,1,0,1690,0,371000,1977
1430,10350,1,0,1430,0,530000,1959
2490,9714,1,0,1400,1090,608000,1983
1350,7200,1,0,1350,0,450000,1954
3140,14421,2,0,3140,0,780000,1994
2340,52272,2,0,2340,0,290000,1978
1610,14182,1,0,1100,510,225000,1978
3320,38032,2,0,3320,0,805000,1991
2390,15669,2,0,2390,0,660000,1991
1180,13927,1,0,1180,0,299000,1962
1260,1312,3,0,1260,0,530000,2007
1800,4400,1,0,1350,450,680000,1970
1790,12000,1,0,1790,0,199900,1944
1760,6300,1,0,1060,700,224000,1963
1540,8885,1,0,1440,100,244000,1980
1260,3880,1,0,860,400,485000,1918
2240,7589,2,0,2240,0,330000,1994
1630,1724,1.5,0,1030,600,509000,1915
2350,7203,2,0,2350,0,440000,1989
1350,8587,1,0,1350,0,244000,1998
1320,4800,1,0,870,450,399700,1930
1950,2617,1.5,0,1250,700,519000,1910
2100,9200,1,0,1050,1050,211000,1959
3480,7800,1,0,1750,1730,950000,1941
1830,2839,2,0,1830,0,410000,1999
2640,5000,2,0,2040,600,750000,1949
900,2550,1,0,900,0,133400,1978
1553,6550,1,0,1553,0,240000,1900
1710,2300,2,0,1570,140,539000,2005
3400,292723,2,0,3400,0,688000,1998
1270,5112,1,0,1270,0,465000,1950
2960,12420,1,2,1480,1480,936000,1952
3040,9606,2,0,3040,0,620000,2003
1430,9750,1,0,1430,0,429950,1962
1520,4170,2,0,1520,0,296475,2004
1820,9450,1,0,1100,720,330000,1962
1800,11200,1,0,1270,530,445000,1979
2720,4000,2,1,2070,650,846000,2014
1980,5850,1,1,1380,600,725000,1960
2550,7349,2,0,2550,0,369000,1989
2210,16200,1,0,1390,820,625000,1958
2120,4080,2,0,2120,0,535000,2003
1570,6717,1,0,1570,0,229950,1911
1310,6960,1,0,1310,0,229999,1974
3150,4120,2,0,2460,690,850000,1911
3870,35889,2,0,2530,1340,589900,2001
1840,4322,1,0,1160,680,513000,1914
1120,8321,1,0,1120,0,401000,1941
1440,2500,2,0,1440,0,260000,2006
2300,26650,1,0,2300,0,525000,1950
2070,11658,1,0,1370,700,470000,1977
1420,8063,1,0,940,480,205000,1962
2010,7495,1,0,1570,440,620000,1979
1200,5000,1,0,1200,0,229000,1979
1150,6634,1,0,860,290,445000,1940
1240,7200,1,0,1240,0,215000,1967
1900,4871,2,0,1900,0,504975,2005
2350,10072,2,0,2350,0,495000,1980
1120,8342,1,0,1120,0,205000,1976
1020,6871,1,0,1020,0,152275,1937
1930,8338,1,0,1930,0,586000,1968
2680,7625,1,0,2680,0,779950,2002
2660,11315,2,0,2660,0,557000,1983
2200,7200,1,2,1220,980,610000,1958
1010,7683,1.5,0,1010,0,405000,1953
2310,7490,2,0,2310,0,320000,1980
920,3863,1,0,920,0,356000,1970
3030,4120,1.5,0,1930,1100,794500,1913
1590,9620,1,0,1590,0,349000,1988
2740,88426,2,0,2740,0,549000,1991
960,10761,1,0,960,0,193000,1962
2240,7227,2,1,1440,800,700000,1977
2400,6182,2,0,2400,0,523000,1998
2860,20790,1,0,1800,1060,565000,1965
2960,5027,2,0,2960,0,500000,2000
3770,4103,2,0,2710,1060,1.45E+06,1925
3830,68825,2,0,3830,0,710000,1995
2750,9001,1,0,2750,0,333000,2008
2100,6874,1,0,1300,800,580000,1943
1500,8400,1,0,1200,300,289950,1956
710,4618,1,1,710,0,375000,1925
2770,10800,1.5,0,1910,860,505000,1984
2050,6720,1,2,1050,1000,324950,1939
1960,10275,2,0,1960,0,490000,1965
1770,6000,2,0,1770,0,630000,1911
3290,22649,2,0,3290,0,595000,1993
1990,6000,1,0,1260,730,872500,1956
1760,5250,1,2,1000,760,490000,1951
5080,27755,2,0,5080,0,1.90E+06,2001
1020,8102,1,0,1020,0,310000,1956
1350,92721,1,0,1200,150,450000,1946
1740,12000,2,0,1740,0,539000,1974
3540,38322,2,0,3540,0,888550,1989
1520,8720,1,0,1080,440,269950,1981
290,20875,1,0,290,0,142000,1963
1310,9761,1,0,1310,0,300000,1967
3000,24004,1,0,2410,590,780000,1952
2660,20369,2,0,2660,0,545000,1992
2120,9804,2,0,2120,0,278000,1994
1200,2845,2,0,1200,0,342000,1986
1900,9861,1,0,1900,0,190000,1967
1010,948,3,0,1010,0,387000,1999
1850,7480,2,0,1850,0,279950,1978
4520,40164,2,0,3580,940,550000,1953
2010,251341,2,0,1510,500,439000,2003
2420,23507,1,0,2420,0,774888,1969
2732,9500,1,2,1870,862,480000,1975
1910,6960,1.5,0,1910,0,835000,1941
3520,5400,2,0,2400,1120,1.50E+06,2008
2220,3760,1.5,0,1370,850,771000,1929
2020,5800,1,3,1760,260,1.23E+06,1941
2090,7290,1,0,1420,670,600000,1966
1580,7424,1,0,1010,570,305000,1962
2650,11340,1,0,2650,0,1.39E+06,1955
1020,11652,1,0,1020,0,216500,1971
1070,1219,2,0,720,350,370000,2004
2120,9786,1,0,1640,480,492650,1967
1360,10609,1,0,1060,300,431200,1966
1700,12048,2,0,1700,0,277500,1990
1820,8712,1,0,1090,730,278000,1960
1430,8400,1,0,730,700,351000,1969
4140,7089,2,0,3160,980,850000,2003
1313,3600,1,0,1313,0,885000,1904
1590,87120,1,3,1590,0,399950,1998
1080,9262,1,0,1080,0,185000,1968
2730,6000,1,0,1470,1260,440000,1979
3800,19798,2,0,3800,0,2.40E+06,1969
2540,9961,1,0,1320,1220,299000,1969
1810,34500,1,0,1230,580,299500,1980
1540,7506,1,0,1540,0,420000,1961
1390,18000,1,0,1390,0,234000,1955
1460,4800,1,0,850,610,540000,1950
2350,63162,2,0,2350,0,649950,1994
1160,7912,1,0,1160,0,330000,1956
3500,5960,2,0,3500,0,840000,2010
1980,6922,2,0,1980,0,370000,1991
1250,7700,1,0,1250,0,410000,1968
770,7200,1,0,770,0,257000,1951
1920,6710,1,0,1320,600,350000,1959
1120,7560,1,1,1120,0,380000,1947
1150,12402,1,0,1150,0,344000,1969
1590,2550,3,0,1590,0,488000,1985
910,3880,1,0,780,130,465000,1942
1870,6625,1,0,960,910,229500,1948
2420,11250,2,0,2420,0,445000,2013
2120,7110,1.5,0,2120,0,246000,1919
2730,17240,1,0,1660,1070,545000,1958
2560,5672,2,1,2560,0,518000,2005
2620,10016,2,0,2620,0,565000,1996
2760,8558,2,0,2760,0,445000,2001
2900,9799,1,0,1450,1450,968000,1959
1820,6324,1,0,910,910,725000,1945
1870,8400,1,0,990,880,315500,1977
2010,9211,1,0,1470,540,487585,1977
940,6000,1,0,940,0,246500,1954
1850,6000,1.5,0,1650,200,819000,1913
2530,4229,2,0,2530,0,349900,2004
940,4700,1,0,940,0,267000,1942
1820,15000,1,0,1480,340,480000,1978
1510,3360,1,0,880,630,525000,1924
2070,5415,2,0,2070,0,578000,1996
1380,1547,3,0,1380,0,345000,2000
1270,6250,1,0,910,360,499000,1955
1390,9680,1,0,1390,0,425000,1956
1840,7510,2,0,1840,0,268000,1988
1600,12566,1,0,1600,0,240000,1971
1480,9606,1,0,1100,380,147000,1964
2120,7806,1,0,1770,350,500000,1949
2940,5400,1.5,2,1940,1000,1.01E+06,1910
3820,26895,2,2,3820,0,991500,1995
2740,3838,1,0,1370,1370,510000,1959
4360,12081,2,0,4360,0,1.98E+06,2007
1540,1870,2,0,1540,0,484998,2014
4660,17398,2,2,4660,0,1.28E+06,2003
1590,7617,2,0,1590,0,210000,1986
1180,10720,1,0,1180,0,450000,1955
2360,8286,1,0,1320,1040,875000,1952
1860,7500,1,0,1220,640,529950,1967
1470,4000,1,0,1070,400,415000,1979
2990,12970,1.5,2,1960,1030,590000,1948
1690,9144,1,0,1140,550,379950,1956
660,3570,1,0,660,0,385000,1906
2310,7620,2,0,2310,0,588000,1942
770,2191,1,0,770,0,252500,1937
2320,3174,2,0,2060,260,530000,1997
1370,159865,1,0,1370,0,385000,1960
1700,7650,1,0,1340,360,419000,1975
960,5508,1,0,770,190,175000,1951
1150,5664,1,0,870,280,515000,1948
2910,4680,1.5,0,1850,1060,945000,1937
2290,7420,1,0,1290,1000,359900,1973
2260,5164,2,0,2260,0,419950,1996
1300,4000,1,0,900,400,460000,1953
1850,7151,2,0,1850,0,255000,1989
1920,9500,1,0,1470,450,481000,1966
1920,9500,1,0,1470,450,719521,1966
4910,43560,2,0,4000,910,1.08E+06,1989
2210,6080,1,2,1410,800,334000,1965
2280,3200,1.5,0,1520,760,675000,1931
1640,7437,1,0,1090,550,556000,1948
1980,7200,2,3,1700,280,900000,1910
900,4084,1.5,0,900,0,400000,1910
1960,4340,1,0,980,980,724950,1912
1800,4500,2,0,1800,0,321000,2004
4270,5800,2,3,3170,1100,1.36E+06,1937
1520,19672,1,0,1020,500,171000,1920
5430,108900,2,0,5430,0,1.36E+06,1987
1950,15037,1,0,1950,0,323000,1989
2190,125452,1,2,2190,0,491500,1968
1200,10890,1,0,1200,0,226000,1972
2180,4000,1.5,0,1380,800,580000,1926
2320,11259,2,0,2320,0,640000,1982
1040,5097,1,0,800,240,619790,1944
2700,6998,2,0,2700,0,383962,2001
1400,2445,1,0,840,560,373000,2002
2060,8123,2,0,1010,1050,541338,1977
780,8160,1,0,780,0,254922,1953
2400,5000,1.5,0,1440,960,575000,1926
2900,15535,1,2,1870,1030,650000,1961
1740,9547,1,0,1740,0,269950,1962
780,6250,1,0,780,0,270950,1942
2430,14861,1,0,1530,900,495000,1988
2210,8556,1,1,1210,1000,794154,1954
1510,11200,1,0,1510,0,340768,1960
900,5413,1,0,900,0,375000,1947
3670,7000,2,0,3670,0,820000,2005
1160,954,2,0,960,200,555000,2014
1070,1200,2,0,1070,0,312500,1999
950,4560,1.5,0,950,0,450000,1925
2950,6667,2,0,2950,0,739000,2003
1420,1716,2,0,1050,370,320000,2003
1590,13000,1.5,0,1590,0,235000,1944
1290,5000,1.5,0,1290,0,275500,1957
1690,4500,1,0,1690,0,564000,2004
1340,8700,1.5,0,1340,0,263000,1958
1397,18000,1,0,1397,0,257000,1965
3750,218506,2,0,3750,0,725000,1991
2000,7560,1,0,1400,600,300000,1979
2250,7904,1.5,0,2250,0,328000,1998
840,8400,1,0,840,0,187500,1959
1100,5100,2,0,1100,0,400000,1900
1660,5100,1,0,1210,450,515000,1954
2180,18525,1,4,1580,600,1.41E+06,1952
1460,8400,1,0,1460,0,235000,1958
2470,4945,2,0,2470,0,669000,2012
1250,13503,1.5,0,1250,0,282000,1931
1480,3876,1,0,860,620,663000,1928
2240,5000,2,0,1540,700,279900,1989
1570,7200,1,0,1570,0,335000,1952
3250,10000,2,0,3250,0,689000,2014
1790,231303,1,0,1250,540,413100,1980
2080,4931,2,0,2080,0,506950,2000
1480,1171,3,0,1480,0,500000,2006
3610,9775,2,0,3610,0,540000,2003
2040,4559,2,0,2040,0,812000,1998
3850,19842,2,3,3180,670,1.20E+06,1989
3230,35306,2,0,3230,0,370000,1987
2440,23512,1,0,1640,800,338000,1933
1490,6600,1,0,1490,0,185000,1969
1150,35415,1,0,1010,140,450000,1950
900,6000,1,0,900,0,451000,1944
3210,24527,1.5,0,3210,0,785000,1984
3900,5250,1.5,1,2620,1280,850000,1931
1240,18000,1,0,1240,0,235000,1943
1760,6788,2,4,1760,0,1.15E+06,1940
1410,1377,2,0,1290,120,377500,2005
2780,11964,2,0,2780,0,825500,2009
3230,3825,2,0,2480,750,1.06E+06,2014
4600,8764,2,0,3180,1420,880000,2007
1440,4421,1,0,1440,0,413800,2007
1200,1687,3,0,1200,0,504200,2008
2793,5703,2,0,2793,0,421500,2009
2970,5050,2,0,2970,0,855169,2014
1440,3218,1,0,850,590,380000,2008
1480,1026,3,0,1480,0,580000,2014
1870,5333,2,0,1870,0,377000,2012
2475,4000,2,0,2475,0,329900,2014
2950,7024,2,0,2950,0,921800,2012
1410,905,3,0,1410,0,529500,2014
2240,3712,2,0,2240,0,363990,2014
3230,6500,2,0,3230,0,834950,2014
2100,31550,1,0,2100,0,399000,2010
1936,9495,1,0,1936,0,338900,2013
3120,6000,2,0,3120,0,419950,2007
2070,4270,2,0,2070,0,493000,2010
3700,4500,2,0,3700,0,650000,2007
2130,5205,2,0,2130,0,456000,2013
1620,997,2.5,0,1540,80,425000,2010
1490,2478,3,0,1490,0,348000,2009
4180,7232,2,0,4180,0,1.04E+06,2014
1400,1262,2,0,1160,240,299000,2008
3490,9170,2,0,3490,0,1.26E+06,2012
1300,6098,1,0,1300,0,155000,2013
2730,4962,2,0,2730,0,319500,2006
1830,2517,2,0,1830,0,274000,2005
2340,4500,2,0,2340,0,429000,2009
1410,1899,2,0,1410,0,267800,2014
1930,8254,2,0,1930,0,369950,2014
3028,18055,2,0,3028,0,480000,2005
3180,4869,2,0,2390,790,440000,2007
2950,4161,2,0,2210,740,839704,2014
1430,1276,3,0,1430,0,535000,2007
1020,1275,3,0,1020,0,290000,2008
1650,1793,3,0,1650,0,370000,2007
1060,651,3,0,1060,0,405000,2007
2620,6019,2,0,2620,0,499431,2013
1830,3868,2,0,1830,0,275000,2007
998,844,2,0,798,200,320000,2007
2070,4427,2,0,2070,0,425000,2007
2860,2199,3,0,2860,0,1.45E+06,2013
1920,5688,1,3,1920,0,340000,2007
1210,2046,2,0,920,290,299900,2008
4890,12039,2,0,3590,1300,865950,2014
3420,17038,2,0,3420,0,720000,2007
2870,3225,2,3,2070,800,460000,2006
1600,2042,2,0,1600,0,375000,2005
960,1829,2,0,960,0,386180,2005
1740,5639,1,3,1740,0,280000,2010
2575,4725,2,0,2575,0,359000,2011
3660,11995,2,2,3660,0,785000,2006
1420,1230,2,0,940,480,425000,2009
3070,7200,2,0,3070,0,575000,2005
1920,144619,1,0,1920,0,465000,2014
4160,10335,2,0,4160,0,1.85E+06,2014
3276,10801,2,0,3276,0,720000,2008
2890,5000,1,0,1310,1580,390000,2006
3430,10177,2,0,3430,0,2.21E+06,2014
3390,3979,2,0,2610,780,1.05E+06,2014
2930,14980,2,3,2930,0,915000,2013
1300,1314,3,0,1300,0,562000,2008
1250,1208,2,0,1040,210,349000,2007
2310,7800,2,0,2310,0,375000,2011
1360,1336,3,0,1360,0,479950,2008
2020,5100,2,0,2020,0,319000,2010
1270,1067,3,0,1270,0,325000,2009
2790,8092,2,0,2790,0,505657,2013
2320,4142,2,0,2320,0,340000,2010
1750,6351,2,0,1750,0,250000,2012
2030,4596,2,0,2030,0,349500,2014
1270,865,2,0,1080,190,290750,2008
2710,2356,2,0,2230,480,715000,2013
2520,8433,2,0,2520,0,689950,2014
1340,1263,3,0,1340,0,425000,2008
1570,1281,3,0,1570,0,657000,2014
2690,5564,2,0,2690,0,359950,2007
2475,4276,2,0,2475,0,319900,2014
2260,2050,2,0,1170,1090,532000,2010
840,863,3,0,840,0,291000,2008
1720,1330,2,0,1030,690,675000,2004
2940,6500,3,0,2940,0,885000,2014
4170,9090,2,0,4170,0,1.45E+06,2008
4310,10000,2,0,2950,1360,780000,2008
3010,7200,2,0,3010,0,839950,2014
2170,1984,2.5,0,2170,0,645000,2008
1584,3200,2,0,1584,0,263000,2011
1110,1290,3,0,1110,0,345000,2006
2420,5006,2,0,2420,0,505000,2013
1430,1210,2,0,1340,90,522500,2005
2393,4788,2,0,2393,0,400000,2012
1240,949,3,0,1240,0,543000,2008
2980,12075,1,0,1910,1070,495000,2007
2970,6587,2,0,2260,710,549995,2014
2329,5720,2,0,2329,0,327555,2010
3340,9075,2,0,2600,740,690000,2005
2580,2875,2,0,2580,0,673000,2015
2029,3906,2,0,2029,0,384435,2014
3430,6500,2,0,3050,380,780000,2006
3330,5042,2,2,2470,860,1.38E+06,2014
3220,5081,2,0,3220,0,950968,2013
1240,750,2,0,1150,90,334950,2008
1500,1249,2,0,1240,260,489000,2004
3530,8345,2,0,3530,0,600000,2006
1260,915,2,0,1020,240,282000,2007
4168,8485,2,0,3222,946,442000,2007
1030,2850,2,0,1030,0,220000,1995
3080,5598,2,0,3080,0,489000,2006
1072,4339,2,0,1072,0,250000,2009
2790,5000,2,0,2790,0,484259,2014
4090,16972,2,2,3590,500,1.68E+06,2007
1800,4357,2,0,1800,0,450000,2013
830,1276,2,0,830,0,299000,2005
2280,4557,2,0,2280,0,450000,2010
2110,1286,2,0,1710,400,585000,2007
1570,1680,3,0,1570,0,660000,2014
830,1333,2,0,830,0,301500,2005
4120,8258,2,0,4120,0,949950,2012
2540,5760,2,0,2540,0,759990,2009
2050,4000,2,0,2050,0,355000,2014
3080,7242,2,0,3080,0,889950,2014
2390,1984,2,0,2220,170,629800,2008
3170,5100,2,0,3170,0,745000,2012
1240,1331,2,0,1050,190,379900,2007
1090,1139,2,0,960,130,335000,2009
4630,6324,2,0,3210,1420,809000,2006
3230,5899,2,0,3230,0,569950,2012
3510,9263,2,0,3510,0,723000,2001
1785,2552,2,0,1785,0,282000,2009
2360,3873,2,0,1990,370,569900,2006
2340,9716,1,0,2340,0,385000,2009
1620,1075,3,0,1540,80,420000,2009
3890,3452,2,0,2890,1000,2.25E+06,2006
3590,5335,2,2,3140,450,1.21E+06,2006
1984,4460,2,0,1984,0,292000,2012
1640,1023,3,0,1640,0,645000,2014
1350,942,3,0,1350,0,304500,2008
2730,5707,2,0,2000,730,489500,2011
5610,11063,3,0,4750,860,1.58E+06,2006
962,1992,2,0,962,0,390000,2012
3040,4006,2,0,2350,690,815000,2013
2540,10578,2,1,2010,530,719000,2014
2240,4800,2,0,2240,0,331210,2014
1260,1270,2,0,1040,220,245000,2005
3210,7200,2,0,2410,800,465000,2011
1620,1171,3,4,1470,150,580000,2008
1580,1972,2.5,2,1180,400,540000,2007
1430,1250,3,0,1430,0,399000,2007
1850,5388,2,0,1850,0,328000,2009
3340,5314,2,0,3340,0,701000,2010
2670,4800,2,0,2670,0,408000,2014
4660,16200,2,2,4660,0,2.64E+06,2005
1550,930,2,0,1060,490,445000,2006
3470,6651,2,0,3470,0,672500,2005
3010,7014,2,0,3010,0,538000,2009
3931,9497,2,0,2650,1281,450000,2014
1800,2700,2,0,1800,0,362500,2011
1570,1551,3,0,1570,0,414950,2008
2230,3939,2,0,2230,0,679950,2014
2423,7292,2,0,2423,0,290000,2005
1160,1174,2,0,790,370,230000,2007
1440,4666,1,0,1440,0,439950,2010
2052,3723,2,0,2052,0,349900,2014
2780,9272,2,0,2780,0,550000,2014
3720,5750,2,2,2960,760,1.05E+06,2006
1460,1851,2,0,1180,280,655000,2014
1370,1540,2,0,1100,270,385000,2006
3600,6110,2,0,2510,1090,729999,2012
1420,1282,3,0,1420,0,523950,2006
980,895,2,0,670,310,369000,2009
1790,2700,2,0,1790,0,509900,2010
2010,5399,2,0,2010,0,282000,2006
2370,4200,2,0,2370,0,387865,2014
2560,6238,2,0,2560,0,385000,2007
1900,6224,2,0,1900,0,536000,2005
1350,1493,2,0,1050,300,395000,2007
2650,6717,2,0,2650,0,545000,2014
3020,7035,2,4,3020,0,715000,2001
1500,2255,2,0,1500,0,348000,2005
1320,1014,3,0,1320,0,455000,2015
3120,7644,2,0,3120,0,575000,2010
1540,1270,3,0,1540,0,449950,2014
1800,2790,2,0,1800,0,364000,2011
3640,6389,2,0,3640,0,932990,2014
2440,4153,2,0,2440,0,710000,2003
3970,7314,2,0,3970,0,949990,2014
2060,4200,2,0,2060,0,326989,2014
2538,4600,2,0,2538,0,335606,2013
4270,8076,2,0,3400,870,1.53E+06,2007
1320,3150,2,0,1320,0,299950,2005
3340,5700,2,0,3340,0,962000,2013
1590,1679,2,0,1590,0,395825,2012
2710,4500,2,0,2710,0,419354,2014
3140,7258,2,1,3140,0,920000,2006
1445,1028,2,0,1300,145,366000,2005
2430,5000,2,0,2430,0,480000,2009
1370,915,2,0,1100,270,388000,2006
5050,9520,2,0,3610,1440,2.32E+06,2007
1860,1290,2,0,1240,620,730000,2010
5330,6000,2,2,3570,1760,950000,2006
1710,2171,2,0,1400,310,358990,2014
2650,4120,2,0,2650,0,398651,2014
2590,7891,2,0,2590,0,530000,2006
2610,5562,2,0,2610,0,610360,2013
1770,1235,3,0,1600,170,436110,2007
3730,8014,2,0,3730,0,925000,2012
2420,5244,2,0,2420,0,449950,2007
3330,7399,2,0,3330,0,760000,2009
1910,3481,2,0,1910,0,293000,2009
2170,7665,1,2,2170,0,695000,2013
2437,5136,2,0,2437,0,285000,2011
4180,12042,2,0,4180,0,1.26E+06,2014
1800,2791,2,0,1800,0,379900,2011
2570,7412,2,0,2570,0,472000,2006
2090,5195,2,0,2090,0,300000,2007
2789,3960,2,0,2789,0,272000,2007
2906,5893,2,0,2906,0,418395,2014
2550,6405,2,0,2550,0,465000,2008
3550,9400,2,0,3550,0,659950,2014
1590,926,3,0,1590,0,484950,2014
1950,1968,2,0,1160,790,359000,1979
3250,4500,2,0,3250,0,519000,2009
4590,14685,2,0,4590,0,1.71E+06,2009
3070,7201,2,0,3070,0,535000,2006
3030,7644,2,0,2830,200,622950,2006
2610,5845,2,0,2610,0,515000,2005
3150,6202,2,0,3150,0,330000,2005
1240,983,3,0,1240,0,318000,2009
1680,2801,2,0,1680,0,439000,2011
2220,5279,2,0,2220,0,540000,2006
4800,12727,2,0,4800,0,1.08E+06,2011
3100,4699,2,0,3100,0,435000,2010
7850,89651,2,0,7850,0,2.70E+06,2006
3590,5625,2,0,3590,0,1.10E+06,2012
1590,942,3,0,1590,0,293467,2008
2242,4800,2,0,2242,0,328000,2013
2490,3582,2,0,1720,770,550000,2005
1530,1442,3,0,1530,0,649000,2015
2150,3143,2,0,2150,0,435000,2010
2440,4800,2,0,2440,0,625000,2014
1270,1483,3,0,1270,0,415000,2007
1450,4706,2,0,1450,0,400000,2009
2690,4047,3,0,2690,0,979000,2014
2755,4831,2,0,2755,0,625250,2003
2650,3474,2,0,2230,420,665000,2011
2310,3075,2,0,1730,580,589500,2005
1460,1452,2,0,1140,320,437000,2007
1400,9000,1,0,1400,0,320000,1959
2196,7475,2,0,2196,0,333500,2006
2020,2750,2,0,1680,340,430000,2008
4280,8465,2,0,4280,0,995500,2014
2340,5002,2,0,2340,0,427874,2013
2220,4228,2,0,2220,0,334990,2014
4420,5940,2,0,3410,1010,909500,2006
1580,4961,2,0,1580,0,210000,2006
3550,6558,2,0,3550,0,952990,2013
1510,851,3,0,1420,90,622500,2013
1360,1419,2,0,1040,320,515000,2007
2040,13590,2,0,2040,0,350000,2009
1120,912,3,0,1120,0,310000,2011
4490,5099,2,0,3390,1100,700000,2006
3560,6786,2,0,2930,630,907687,2014
2150,5760,1,0,2150,0,741500,2010
2130,5088,2,0,1840,290,395000,2011
2990,6370,2,0,2990,0,559950,2014
1847,8000,2,0,1847,0,215000,2008
2610,7227,2,0,2610,0,390000,2011
1670,107157,1,0,1670,0,425000,2007
1860,415126,2,0,1860,0,472000,2006
3440,9776,2,0,3440,0,1.33E+06,2006
3510,9364,2,0,3510,0,695000,2001
1740,1279,3,0,1740,0,545000,2008
2240,5500,2,0,2240,0,389950,2013
1550,1485,3,0,1550,0,380000,2011
1390,745,3,0,1390,0,288790,2008
2500,6000,2,0,2500,0,432500,2012
2710,3326,2,0,1650,1060,615000,2005
1720,3012,2,0,1720,0,500000,2011
1760,1146,3,0,1760,0,615000,2014
2270,8196,1,0,1150,1120,500000,1963
1690,1765,2,0,1370,320,622000,2006
4000,9234,2,0,4000,0,802945,2015
2880,9003,2,0,2880,0,1.26E+06,2008
1480,1531,3,0,1480,0,598950,2014
1950,4949,2,0,1950,0,430000,2009
2700,5150,2,0,2700,0,515000,2009
2210,3917,2,0,1500,710,1.26E+06,2008
2370,3692,2.5,0,2370,0,400000,2013
1310,1254,2,0,850,460,390000,2007
2410,4293,2,0,2410,0,450000,2007
3360,5402,2,0,3360,0,804995,2014
3040,4155,2,0,2350,690,825000,2013
2140,6355,2,0,2140,0,435000,2002
1720,1715,2,0,1240,480,398000,2004
2658,3960,2,0,2658,0,411605,2014
1480,983,2,0,1180,300,315000,2013
1350,1209,3,0,1350,0,455000,2013
1150,1194,2,0,1020,130,452950,2006
1690,1468,2,0,1380,310,380000,2008
1270,1916,2,0,1270,0,340000,2012
2655,5080,2,0,2655,0,409950,2013
880,1165,2,0,880,0,360000,2005
4645,7757,2,0,3855,790,1.60E+06,2006
1270,1443,3,0,1270,0,440000,2007
1728,95950,1,3,1728,0,730000,2012
1950,7221,1,0,1950,0,408000,2006
3170,3862,3,0,3170,0,820000,2008
1233,1244,2,0,963,270,360000,2007
2570,4600,2,0,2570,0,339990,2014
1560,1020,3,0,1560,0,515000,2014
1630,1166,2,0,1020,610,541000,2013
2510,7245,2,0,2510,0,375000,2007
2223,5780,2,0,2223,0,320000,2010
1230,1058,2,0,1160,70,325000,2008
3050,7520,2,0,3050,0,740000,2014
2710,6220,2,0,2710,0,450000,2014
2090,4400,2,0,2090,0,455000,2011
1440,1068,2,0,1160,280,292500,2006
2500,51836,1,0,1510,990,650000,2013
2740,7872,2,0,2740,0,530000,2015
3360,6120,2,0,3360,0,829995,2014
2280,5013,2,0,2280,0,395000,2009
3520,5500,2,0,3520,0,859990,2014
1320,826,2,0,1100,220,342500,2008
3410,5838,2,0,3410,0,743000,2012
2730,9388,1,0,1390,1340,345000,1975
1780,2778,2,0,1530,250,443000,2007
1427,4337,2,0,1427,0,260000,2009
2910,6555,2,0,2910,0,810000,2005
3250,5600,2,0,3250,0,570000,2011
3630,8100,2,0,3630,0,1.56E+06,2008
1680,975,3,0,1680,0,840000,2009
2280,2296,3,0,1890,390,950000,2013
3310,4682,2,0,2380,930,572800,2015
1290,1112,3,0,1290,0,305000,2008
3940,7067,2,0,3230,710,1.70E+06,2008
2170,6000,2,0,1630,540,445000,2008
3290,8059,2,0,3290,0,801000,2012
2550,5376,2,0,2550,0,711000,2004
1140,977,2,0,850,290,268500,2008
2300,3825,2,0,2300,0,320000,2012
2670,5001,1,0,1640,1030,500000,2013
2440,6651,2,0,2440,0,631625,2014
1611,2210,2,2,1611,0,850000,2005
2710,3290,2,0,1650,1060,600000,2006
2015,16807,2,4,2015,0,988500,2007
3444,5166,2,0,2714,730,430236,2014
3060,9576,2,0,3060,0,1.27E+06,2005
2050,2772,2,0,2050,0,689500,2013
1390,1882,2,0,1390,0,175003,2014
1240,1249,3,0,1240,0,459000,2006
3750,74052,2,0,3750,0,1.18E+06,2013
1410,1442,3,0,1360,50,358000,2006
2448,4949,2,0,2448,0,447055,2014
2600,64626,1.5,0,2600,0,415000,2009
3330,9000,2,0,2870,460,1.21E+06,2004
1160,1010,2,0,1000,160,495000,2006
1330,1380,2,0,1060,270,479000,2005
2830,4334,3,4,2830,0,1.90E+06,2006
1610,3517,2,0,1610,0,249900,2005
2800,4000,2,0,2800,0,1.47E+06,2011
4570,10194,2,0,4570,0,1.04E+06,2006
2820,6120,2,0,2820,0,897000,2014
2570,9470,2,0,2570,0,1.10E+06,2006
1710,1193,2,0,1140,570,685000,2014
1220,3286,2,0,1220,0,295000,1982
1650,946,3,0,1650,0,619000,2014
1130,1340,2,0,910,220,439108,2008
1489,2800,2,0,1489,0,260000,2011
2690,5557,2,0,2690,0,279000,2012
1530,1305,2,0,1116,414,380000,2007
1600,6315,2,0,1600,0,287000,2013
1000,1251,2,0,930,70,377000,2006
2440,3012,3,1,2440,0,649950,2005
1260,1102,3,0,1260,0,445000,2007
1660,1692,3,0,1610,50,605000,2005
1190,1137,2,0,960,230,475000,1999
1520,1884,3,0,1520,0,399000,2009
3250,8100,2,0,3250,0,718000,2014
4700,9160,1,4,2520,2180,1.40E+06,2005
1480,1663,2,0,1180,300,341000,2012
2380,9374,1,2,2380,0,818000,2011
1640,1873,3,0,1640,0,759000,2014
1650,2262,3,0,1650,0,547500,2010
5305,8401,2,2,3745,1560,2.70E+06,2005
1278,987,2,0,1002,276,358000,2007
1200,813,3,0,1200,0,412000,2010
690,1058,2,0,690,0,245000,2005
3202,4964,2,0,3202,0,460940,2014
1347,1292,3,0,1347,0,321000,2010
2960,6000,2,0,2960,0,633634,2014
740,1284,1,0,740,0,290000,1928
1200,1137,3,0,1200,0,445000,2007
4320,7502,2,0,3500,820,887250,2012
2310,7348,1,3,2310,0,739000,2010
1490,1286,3,0,1490,0,429900,2014
1480,800,2,0,1000,480,459000,2014
1481,2820,2,0,1481,0,240000,2012
1730,1902,3,0,1730,0,566950,2014
3900,8391,2,0,3900,0,1.04E+06,2006
1130,1449,3,0,1130,0,343000,2005
3230,4838,2,0,3230,0,572115,2014
3920,5150,2,0,2820,1100,918000,2004
1190,1361,2,0,1190,0,555000,2007
2311,4396,2,0,2311,0,399440,2014
1810,914,3,0,1380,430,450000,2008
3290,6203,2,0,3290,0,648000,2008
3250,5000,2,0,3250,0,580000,2008
2544,4071,2,0,2544,0,415000,2013
1380,1389,3,0,1380,0,527500,2008
1430,800,2,0,1140,290,384000,2011
3490,28213,1.5,2,2242,1248,692000,2009
910,966,2,0,820,90,455000,2006
3080,4120,2,0,2380,700,1.28E+06,2014
2280,6031,2,0,2280,0,415000,2011
1660,1344,3,0,1660,0,975000,2008
3320,7429,2,0,3320,0,799950,2014
1680,7268,1,0,1370,310,545000,2008
2584,5005,2,0,2584,0,429900,2014
2217,8019,2,0,2217,0,275000,2009
2480,4136,2,0,2480,0,498000,2009
2610,7256,2,0,2610,0,754950,2014
3240,5562,2,0,3240,0,895000,2013
3569,8327,2,0,3569,0,580000,2013
3181,5831,2,0,3181,0,379900,2014
1921,4888,2,0,1921,0,245000,2009
1570,4926,2,0,1570,0,417000,2014
1940,3211,2,0,1940,0,555000,2009
1940,3211,2,0,1940,0,555000,2009
2210,13721,2,0,2210,0,353000,2009
1280,1187,2,0,1080,200,539000,2008
1520,5040,2,0,1520,0,434900,1977
1230,1078,2,0,1160,70,325000,2008
1480,2159,3,0,1480,0,650000,2007
2612,5850,2,0,2612,0,379950,2014
2350,4975,2,0,2350,0,700000,2012
1300,1590,2,0,1100,200,675000,2014
2020,7560,1,0,2020,0,379000,1960
2140,2867,2,0,1960,180,571000,2005
1380,1621,2,0,1140,240,475000,2007
2730,3047,2,0,2400,330,769900,2006
4220,5817,2,0,2910,1310,633000,2006
1570,1433,3,0,1570,0,635000,2010
4670,6000,2,3,3820,850,1.24E+06,2007
1370,1007,3,0,1330,40,524000,2009
3273,5115,2,0,2671,602,485000,2014
3880,13095,2,3,3700,180,1.03E+06,2009
1494,1262,3,0,1494,0,650000,2011
2930,5641,2,0,2930,0,754842,2013
2598,5553,2,0,2598,0,428900,2014
2242,4995,2,0,2242,0,329900,2011
2830,5932,2,0,2830,0,1.04E+06,2014
2710,6937,2,0,2710,0,544999,2009
2320,4344,2,0,2320,0,449950,2012
2720,7991,2,0,2720,0,635000,2006
1650,1180,3,0,1650,0,599000,2014
1430,1348,2,0,1160,270,478000,2008
2090,5040,2,0,2090,0,388000,2014
3660,4903,2,0,2760,900,809950,2014
4220,8417,3,0,4220,0,1.06E+06,2012
1450,1213,2,0,1110,340,659000,2015
3460,6738,2,0,3460,0,971971,2013
1350,874,3,0,1270,80,389000,2006
3000,5470,2,0,3000,0,355000,2005
2950,10003,2,0,2950,0,551500,2006
2530,5048,2,0,2530,0,417838,2014
4650,7660,2,0,3640,1010,1.75E+06,2008
710,1131,2,0,710,0,399950,1943
3050,8000,2,0,3050,0,740000,2007
1150,683,2,0,1150,0,335000,2013
3410,8118,2,0,3410,0,2.25E+06,2006
1370,1921,3,0,1370,0,667000,2007
3540,7009,2,0,3540,0,920000,2007
1370,1350,2,0,1010,360,368000,2007
1714,3080,2,0,1714,0,307000,2009
3650,4534,2,0,2940,710,550000,2014
2990,6037,2,0,2990,0,594491,2013
3284,6516,2,0,3284,0,460458,2014
3550,13900,1,0,1830,1720,859000,2010
1860,2875,2,0,1710,150,399950,2009
1720,1977,2,0,1360,360,547500,2007
2540,4775,2,0,2540,0,310000,2006
3270,12880,2,0,3270,0,939000,2014
980,1021,3,0,980,0,329900,2008
1150,1193,2,0,1020,130,436000,2006
1820,1855,2,0,1570,250,320000,2008
1580,3825,2,0,1580,0,375000,2011
1460,3696,2,0,1460,0,392137,2010
2900,4950,2,0,2900,0,520000,2004
2620,6389,2,0,2620,0,535000,2007
1340,999,2,0,940,400,407000,2008
3266,5398,2,0,3266,0,424950,2014
1076,1060,3,0,1076,0,290000,2006
1680,1478,2,0,1360,320,399000,2009
1930,1348,2,0,1300,630,439990,2005
2880,3091,2,0,1940,940,635000,2014
2240,5000,2,0,2240,0,635000,2013
2594,4455,2,0,2594,0,351000,2012
1210,1232,3,0,1210,0,437500,2007
3760,5000,2,0,2860,900,919204,2014
3600,6055,2,0,3600,0,923990,2014
2050,2772,2,0,2050,0,639888,2012
1510,2064,2,0,1220,290,675000,2008
2580,3909,2,0,2580,0,899900,2013
1670,4020,2,0,1670,0,252000,2009
3190,10034,2,0,3190,0,925000,2007
1280,1920,3,0,1280,0,552000,2009
2718,6197,2,0,2718,0,388500,2006
1370,1878,3,0,1370,0,548000,2004
1794,4769,2,0,1794,0,254950,2005
5120,41327,2,0,3290,1830,1.24E+06,2008
2160,1912,2,0,1970,190,629000,2014
2180,7204,2,0,2180,0,734000,2014
1490,1294,2,0,1220,270,309000,2010
2950,10254,2,0,2950,0,554950,2006
2990,207781,2,0,2990,0,785000,2000
2700,5150,2,0,2700,0,550000,2007
3130,5000,3,0,3130,0,1.01E+06,2014
3620,14250,2,0,3220,400,1.58E+06,2007
2481,4045,2,0,2481,0,309000,2014
1730,3600,2,0,1730,0,328423,2014
1420,1192,2,0,1140,280,345000,2008
3160,5175,2,0,3160,0,660000,2014
1320,1327,2,0,1040,280,385000,2008
1010,1107,2,0,710,300,459000,2006
1870,4046,2,0,1870,0,248000,2007
5220,15411,2,3,3550,1670,1.48E+06,2006
2260,5824,2,0,2260,0,379000,2011
4340,5722,3,4,4340,0,2.95E+06,2010
1620,1841,2,0,1540,80,395000,2004
2280,2289,2,0,1880,400,535000,2006
3400,9804,2,0,2550,850,970000,2008
830,1020,2,0,830,0,205000,2006
2310,7384,2,0,2310,0,310000,2010
830,1858,2,0,830,0,334500,2005
4130,7197,2,0,4130,0,995000,2012
2050,4000,2,0,2050,0,370228,2014
2050,4953,2,0,2050,0,383000,2014
1600,2610,2,0,1600,0,384500,2005
3190,8160,2,0,3190,0,865000,2014
3860,5474,2.5,0,3860,0,1.05E+06,2007
2040,5616,2,0,2040,0,502000,2012
3845,8400,2,0,3845,0,1.75E+06,2013
2650,6875,2,0,2650,0,569995,2014
3430,64441,2,0,3430,0,749950,2013
2430,5400,2,0,2430,0,550000,2007
2876,5086,2,0,2360,516,525000,2007
2550,8698,2,0,2550,0,516000,2007
4100,61419,2,0,4100,0,1.35E+06,2014
2730,4526,2,0,2730,0,440000,2009
1780,1729,2,0,1080,700,660000,2008
1880,5000,2,0,1880,0,261950,2010
3090,4943,2,0,3090,0,551000,2010
2460,14155,2,0,1900,560,665000,2014
2910,5260,2,0,2910,0,610000,2012
2910,5260,2,0,2910,0,645000,2012
1930,6360,1,0,1930,0,536751,2013
1413,3403,2,0,1413,0,260000,2009
4030,6300,2,0,3630,400,1.31E+06,2006
2880,5929,2.5,0,2880,0,429900,2014
2360,15100,1,0,2360,0,535000,2014
1070,1276,3,0,1070,0,462550,2006
1460,1367,3,0,1460,0,602000,2008
3800,9606,2,0,3800,0,730000,2008
1190,801,3,0,1190,0,300500,2010
3200,6455,2,0,3200,0,675000,2009
1970,2377,2,0,1680,290,415000,2008
2830,5831,2,0,2830,0,614000,2010
2630,5701,2,0,2630,0,385000,2010
2720,4613,2,0,2720,0,594000,2005
3160,8097,2,0,3160,0,860000,2014
3770,8899,2,0,2940,830,1.10E+06,2006
3500,6226,2,0,3500,0,775000,2004
2710,4685,2,0,2710,0,430760,2014
2170,6361,1,2,2170,0,755000,2009
1540,958,3,0,1540,0,640000,2007
1876,1531,3,0,1876,0,613500,2009
3720,213073,1,2,3720,0,780000,2007
3148,9612,2,3,3148,0,550000,2014
3240,4852,2,0,3240,0,789500,2010
3340,5000,2,0,2580,760,592000,2012
2413,5701,2,0,2413,0,454950,2014
2500,4500,2,0,2500,0,475000,2010
1180,904,2,0,780,400,659000,2014
2890,5801,2,0,2890,0,570000,2005
2230,6551,1,0,1330,900,347500,2014
1767,4500,2,0,1767,0,205000,2006
1450,1468,2,0,1100,350,380000,2009
2930,7663,2,0,2930,0,718000,2013
2710,4136,2,0,2710,0,515805,2014
3600,18645,2,1,3000,600,1.03E+06,2013
1800,3265,2,0,1800,0,437718,2014
2290,5515,2,0,2290,0,450000,2006
1510,1178,2,0,1060,450,515000,2007
1090,13444,2,0,1090,0,204000,2007
1270,1323,3,0,1270,0,360000,2006
1540,1005,3,0,1540,0,550000,2008
2930,6050,2,0,2930,0,650880,2008
4360,8504,2,4,3530,830,1.79E+06,2014
3640,4983,2,3,2790,850,895900,2014
2430,4747,2,0,2430,0,585000,2008
1520,1464,2,0,1240,280,380000,2010
2730,5820,2,0,2730,0,565997,2014
2440,2076,2,0,1930,510,459000,2006
1580,1303,2,0,1340,240,550000,2010
1420,983,3,0,1420,0,500000,2006
2820,3275,2,0,2230,590,461500,2006
5060,10320,2,0,5060,0,2.15E+06,2008
2650,5000,2,0,2650,0,790000,2007
1490,1212,2,0,1040,450,735000,2011
3060,7710,2,0,3060,0,588000,2009
3240,4185,2,0,2770,470,724500,2011
2820,5348,2,0,2820,0,749000,2008
4140,7642,2,0,4140,0,720000,2003
982,846,2,0,806,176,250000,2006
2460,3600,2,0,2460,0,790000,2007
2547,4800,2,0,2547,0,392440,2014
1834,7460,2,0,1834,0,280000,2012
3130,5126,3,0,2450,680,1.33E+06,2014
2730,4847,2,0,2730,0,649000,2008
1380,1329,2,0,1050,330,457000,2008
4700,10800,2,1,3910,790,2.23E+06,2002
2330,4284,2,0,1920,410,453000,2004
1730,3600,2,0,1730,0,329780,2014
2350,2390,3,2,2000,350,1.05E+06,2007
4000,6713,2,0,4000,0,771005,2015
3350,7752,1,0,2180,1170,1.30E+06,2009
1530,1612,3,0,1530,0,607500,2006
1610,1968,2,0,1610,0,278000,1979
2620,6178,2,0,2620,0,475000,2013
1300,1920,2,0,850,450,270000,2006
3590,5334,2,2,3140,450,1.30E+06,2006
2490,5647,2,0,2490,0,778983,2014
1320,1780,2,0,880,440,221000,2005
1800,2752,2,0,1800,0,338800,2014
3360,5225,2,0,3360,0,834995,2014
3220,9328,2,0,3220,0,550000,2006
2514,1559,2,0,2024,490,575000,2007
3130,9711,2,0,3130,0,649000,2014
2720,4738,2,0,2720,0,545000,2012
1390,916,2,0,1165,225,625000,2007
4920,270236,2,3,3820,1100,1.04E+06,2006
2134,1984,2.5,0,2134,0,611000,2008
1741,5701,2,0,1741,0,300000,2012
2560,5238,2,0,2560,0,577000,2001
2220,3561,2,0,2220,0,349990,2014
1910,4363,2,0,1910,0,650000,2006
980,853,2,0,820,160,378000,2009
1950,4197,2,0,1950,0,313200,2013
4150,12015,2,0,4150,0,1.21E+06,2014
1110,986,2,0,950,160,252500,2009
1250,1150,2,0,1080,170,308000,2009
3310,5404,2,0,3310,0,803100,2004
2020,5501,2,0,2020,0,415000,2010
3310,4850,2,0,3310,0,785000,2010
2798,4473,2,0,2798,0,499950,2012
1847,8000,2,0,1847,0,216000,2008
2420,4981,2,0,2420,0,380000,2009
2020,3600,2,0,2020,0,345000,2012
2400,6811,2,0,2400,0,456500,2007
1760,5390,1,0,1760,0,382495,2014
2110,4178,2,0,2110,0,324950,2013
2692,8392,2,0,2692,0,436472,2014
1490,4522,2,0,1490,0,365250,2009
3960,6352,2,0,3960,0,919990,2014
1740,4642,2,0,1740,0,316475,2012
1940,4517,1,0,1190,750,425000,2010
970,3279,2,0,790,180,302860,2007
1852,4000,2,0,1852,0,298000,2014
4810,18851,2,3,4810,0,3.20E+06,2007
5635,9695,2,3,4360,1275,950000,2011
1520,3041,2,0,1520,0,333000,2009
2099,4275,2,0,2099,0,289950,2010
1250,811,3,0,1250,0,419950,2014
1090,1183,3,0,1090,0,306000,2008
3216,5902,2,0,3216,0,498445,2014
2970,4400,2,0,2970,0,775950,2014
2610,6405,2,0,2610,0,605000,2001
1340,1368,2,0,1060,280,520000,2006
3300,4987,2,0,3300,0,849990,2014
1630,7599,1,0,1630,0,767450,2006
1590,929,2,0,1060,530,665000,2014
1310,1268,3.5,0,1310,0,525000,2007
3600,5697,2,0,2940,660,870515,2014
2154,4153,2,0,2154,0,390000,2012
1530,825,3,0,1530,0,500000,2015
1360,1041,2,0,1094,266,399950,2006
1320,2480,2,0,1320,0,305000,2005
1660,6724,2,0,1660,0,255000,2009
2891,6499,2,0,2891,0,415000,2014
2340,2155,2,0,2120,220,716500,2012
2320,2267,3,0,2320,0,425000,2009
2190,3855,2,0,2190,0,540000,2010
2060,4742,2,0,2060,0,324747,2014
1740,4145,2,0,1740,0,385000,2010
1400,3825,2,0,1400,0,270000,2012
4410,14380,2,0,4410,0,1.24E+06,2006
1780,1647,2,0,1080,700,672000,2008
1760,10137,2,0,1760,0,310000,2010
4410,10756,2,4,3430,980,3.00E+06,2014
5550,11547,2,2,4270,1280,2.35E+06,2014
2432,9391,2,2,2432,0,427000,2005
2283,3996,2,0,2283,0,389950,2008
1860,3730,2,0,1860,0,309620,2012
2701,4500,2,0,2701,0,399895,2014
2930,4875,2,0,2930,0,442515,2014
1540,1561,3,0,1540,0,375000,2010
2242,4500,2,0,2242,0,309780,2014
1950,4345,2,0,1950,0,425000,2007
1160,1073,2,0,880,280,405000,2007
2060,5115,2,0,2060,0,356250,2014
1230,875,3,0,1230,0,550000,2013
1160,1438,2,0,1160,0,340000,2001
2245,4301,2,0,2245,0,362865,2014
4120,12626,2,1,3970,150,1.36E+06,2014
3400,9692,2,0,3400,0,830000,2007
4270,7500,2,0,3210,1060,1.60E+06,2014
2890,5911,2,0,2370,520,855000,2014
3220,8000,2,0,2900,320,1.21E+06,2008
4010,15365,2,1,4010,0,1.39E+06,2006
2260,30250,2,0,2260,0,400200,2013
1140,1730,1.5,0,1010,130,235000,2007
1640,4714,1,0,1640,0,349950,2009
3510,9400,2,0,3510,0,659950,2014
3010,1842,2,0,3010,0,785000,2011
1060,925,2,0,980,80,475000,2006
1658,2700,2,0,1658,0,263900,2014
1960,3540,2,0,1960,0,342000,2012
2420,4725,2,0,2420,0,367899,2014
3420,23786,1.5,0,3420,0,657044,2014
893,965,2,0,893,0,359950,2007
3020,7203,2,0,3020,0,879950,2014
2470,5954,2,0,2470,0,550000,2013
2009,4800,2,0,2009,0,279000,2012
1530,1116,2.5,0,1530,0,255000,2005
1590,1113,3,0,1590,0,609500,2014
2630,3149,2,0,1670,960,420000,2013
3230,7187,2,0,3230,0,570000,2008
1430,2343,2,0,1430,0,439000,2012
2242,5744,2,0,2242,0,310000,2012
2500,4000,2,0,2500,0,635000,2014
1230,922,2,0,1080,150,399950,2009
3020,3600,2.5,0,3020,0,805000,2009
3480,4000,2,0,2460,1020,1.80E+06,2015
3330,7650,1,0,1830,1500,1.21E+06,2008
3400,4840,2,0,3190,210,745000,2006
830,1119,2,0,830,0,329445,2005
3110,4464,2,0,3110,0,588000,2007
1910,2091,2,0,1910,0,494815,2014
3230,5250,2,0,2680,550,591975,2014
3380,8179,2,0,3380,0,600000,2011
2830,3496,2,0,2830,0,673000,2012
3700,7055,2,0,3700,0,889950,2014
2520,4104,2,0,2520,0,500000,2002
1530,1396,2,0,1240,290,500000,2007
4420,5750,2,0,3410,1010,890000,2006
1460,1180,3,0,1460,0,437000,2006
1450,1486,2,0,1160,290,419700,2006
1160,3441,1,0,580,580,394000,1930
1640,4802,1,0,1640,0,342000,2010
1444,249126,1.5,0,1444,0,420000,2008
1620,1173,3,4,1470,150,580000,2008
1100,1228,2,0,900,200,343000,2007
1340,1402,2,0,1120,220,390000,2008
1450,4694,2,0,1450,0,274000,2011
3040,7200,2,0,3040,0,700000,2008
2560,7210,2,0,2560,0,838000,2006
2744,9926,2,0,2744,0,300000,2006
1420,990,3,0,1420,0,467000,2008
700,7457,1,0,700,0,395000,1943
4110,42755,2,2,2970,1140,734000,2000
2670,4780,2,0,2670,0,480000,2013
2130,1400,2,0,1080,1050,539000,2010
3078,6371,2,0,3078,0,459950,2014
840,892,2,0,840,0,306500,2006
1800,2731,2,0,1800,0,408474,2014
2580,5200,2,0,2580,0,437000,2008
1270,2356,2,0,1270,0,160797,2012
3065,5440,3,0,3065,0,729000,2014
1861,1587,2,0,1578,283,499000,2007
2260,5705,2,0,2260,0,359950,2014
4150,7100,2,0,4150,0,929000,2013
1500,1174,2,0,1140,360,529950,2014
1620,998,2.5,0,1540,80,461000,2012
830,1325,2,0,830,0,271115,2005
3120,5137,2,0,3120,0,653000,2003
1870,1058,3,0,1380,490,565000,2007
1240,1250,3,0,1240,0,529950,2014
2820,5612,2,0,2820,0,585000,2007
1630,1526,3,0,1630,0,609000,2014
1584,2800,2,0,1584,0,267000,2012
2840,4500,2,0,2840,0,557000,2012
3910,6293,2,0,3130,780,709950,2006
1730,1301,3,0,1730,0,625000,2011
1840,2060,2,0,1700,140,599000,2013
4030,503989,2,0,4030,0,920000,2008
3440,3800,3,0,3440,0,1.29E+06,2014
2110,3825,2,0,2110,0,324500,2012
2430,5866,2,0,2430,0,471500,2009
4690,207141,2,0,4030,660,1.02E+06,2007
3500,43560,2,0,2850,650,998000,2014
2070,8685,2,0,2070,0,262000,2006
3350,6350,2,2,2610,740,844000,2009
2440,4850,2,0,2440,0,745641,2013
3010,7357,2,0,3010,0,659950,2008
2060,4200,2,0,2060,0,339989,2014
1570,2399,2,0,1180,390,352500,2009
1580,1161,2,0,1010,570,525000,2008
4280,6530,2,3,4280,0,1.14E+06,2014
2815,4900,2,0,2815,0,491000,2011
2620,6114,2,0,2620,0,675000,2011
1250,1033,3,0,1250,0,344000,2007
3250,4500,2,0,3250,0,530000,2008
2510,7686,2,0,2510,0,290500,2003
1270,1685,2,0,1270,0,335000,2012
6670,16481,2,0,4960,1710,3.00E+06,2007
1580,3075,2,0,1580,0,379000,2013
1360,2030,3,0,1360,0,385000,2008
2400,9612,1,0,1230,1170,500012,1962
1571,2017,3,0,1571,0,366750,2008
1405,1073,2,0,1140,265,405000,2007
1010,1546,2,0,1010,0,356999,1971
1450,1281,2,0,1220,230,590000,2006
1420,1361,2,0,960,460,294000,2014
2650,4644,2,0,2650,0,731500,2013
3030,7679,2,0,3030,0,837219,2014
6530,871200,2,2,6530,0,1.60E+06,2008
2670,3738,1,0,1720,950,798800,2013
1170,809,2,0,1170,0,482500,2007
3260,26772,2,0,3260,0,820000,2007
1480,1722,3,0,1480,0,319000,2007
2700,6947,2,3,2700,0,950000,2013
4640,13404,2,0,4640,0,1.27E+06,2007
1601,2491,3,0,1536,65,378000,2007
5350,15360,1,1,3040,2310,3.35E+06,2008
2540,5237,2,0,2540,0,489950,2011
1030,1106,2,0,765,265,345000,2006
2730,7136,2,0,2730,0,510000,2012
3172,5033,2,0,3172,0,432500,2014
3160,8530,2,0,3160,0,650000,2006
2850,12429,2,0,2850,0,750000,2008
2780,3100,2,0,2120,660,870000,2014
3860,6543,2,0,3860,0,900000,2014
1180,900,2,0,780,400,664950,2014
1410,1290,2,0,1290,120,391000,2004
6370,205603,2,0,6370,0,1.80E+06,2008
3223,6371,2,0,3223,0,479349,2014
2600,2074,2,0,2150,450,661000,2011
1380,1234,3,0,1380,0,379000,2006
1620,998,2.5,0,1540,80,415000,2010
1370,1227,3,0,1370,0,375000,2007
1220,1186,3,0,1220,0,355000,2007
1280,1889,3,0,1280,0,540000,2009
770,850,2,0,770,0,290000,2006
1210,1200,3,0,1210,0,500000,2008
2890,6322,2,0,2890,0,416000,2011
1580,2765,2,0,1580,0,349900,2011
1530,1245,2,0,1050,480,465000,2014
3670,7680,2.5,0,3670,0,950000,2007
1850,2340,2.5,0,1850,0,496800,2014
2440,6581,2,0,2440,0,680000,2014
2190,4265,2,0,1540,650,920000,2015
4360,8030,2,0,4360,0,1.29E+06,2015
3990,6637,2,0,3990,0,825000,2003
1270,1283,3,0,1270,0,292000,2007
3340,6924,2,0,3340,0,576000,2009
1500,761,3,3,1500,0,670000,2008
3120,5086,2,0,2480,640,953007,2008
2480,4334,2,0,2480,0,399000,2012
1110,1155,3,0,980,130,399000,2008
2760,5670,2,0,2760,0,847093,2014
1510,1493,3,0,1510,0,599950,2014
1460,1614,2,0,1180,280,499000,2007
3980,285318,2,2,3980,0,760000,2006
3320,8234,2,0,3320,0,1.70E+06,2014
3270,5187,2,0,3110,160,1.03E+06,2014
2670,8765,2,0,2670,0,515000,2006
1410,1332,2,0,1290,120,355000,2004
2475,4000,2,0,2475,0,319900,2014
1600,1431,2,0,1240,360,460000,2006
1290,3383,2,0,1290,0,305000,2008
1608,4818,2,0,1608,0,280000,2012
1300,2104,2,0,1010,290,394950,2011
2530,3000,2,0,1850,680,382000,2014
1390,1411,3,0,1390,0,560000,2008
1640,1204,3,0,1640,0,772000,2014
2229,5723,2,0,2229,0,324950,2012
1790,3078,2,0,1790,0,530000,2010
990,736,2.5,0,880,110,384000,2009
3240,6863,2,0,3240,0,719950,2013
1280,819,2,0,1060,220,319950,2006
1610,3848,2,0,1610,0,292000,2006
3670,3959,2,0,2410,1260,1.50E+06,2008
1150,1027,3,0,1150,0,425000,2008
3760,4702,2,0,2780,980,799950,2014
1320,1157,2,0,990,330,499000,2014
2700,7992,2,0,2700,0,572000,2012
1480,804,3,0,1480,0,459000,2008
1410,905,3,0,1410,0,529500,2014
3135,5811,2,0,3135,0,374500,2005
1480,1485,2,0,1280,200,584000,2007
4020,9656,2,0,4020,0,1.90E+06,2007
1060,1209,2,0,940,120,505000,2006
1950,2457,3,0,1950,0,565000,2009
3340,5677,2,0,3340,0,799000,2011
1570,1452,2.5,0,1240,330,547000,2007
1930,6604,2,0,1930,0,550000,2014
1590,8100,1,0,1060,530,250000,1996
3720,7746,2,0,3720,0,960000,2014
4470,5884,2,1,3230,1240,2.95E+06,2010
1290,1289,2,0,1030,260,441000,2005
1489,2800,2,0,1489,0,265000,2012
2075,39553,1,0,2075,0,430000,2012
1413,3600,2,0,1413,0,286800,2011
1300,1362,2,0,880,420,375000,2008
1480,983,2,0,1180,300,312500,2013
3320,5559,2,0,3320,0,850000,2012
1530,1279,2,0,1116,414,390500,2007
1180,932,3,0,1180,0,455000,2010
1190,1303,2,0,800,390,455000,2009
1300,1180,3,0,1300,0,515000,2008
1710,2212,2,0,1400,310,362500,2013
2390,47480,2,0,2390,0,460000,2007
3510,6005,2,0,2750,760,540000,2010
1140,1165,2,0,1140,0,230000,2014
1320,1329,2,0,1180,140,425000,2007
2100,9752,1,0,1200,900,298450,2007
2400,4848,2,0,2400,0,344000,2004
1408,989,3,0,1408,0,416286,2005
2560,5102,2,0,2560,0,379500,2013
1260,1347,3,0,1260,0,350000,2005
1290,1624,2,0,1290,0,258800,2014
2730,9260,2,0,2730,0,620000,2008
1630,1368,2,0,1280,350,295000,2009
3530,6844,2,0,3530,0,908990,2014
2714,12558,2,0,2714,0,485230,2014
1630,2520,2,0,1630,0,475000,2005
5790,13726,2,3,4430,1360,1.24E+06,2014
2230,1407,2.5,0,1850,380,635000,2013
1380,1590,2,0,1160,220,350000,2012
1320,1161,3,0,1320,0,345000,2010
1490,713,3,0,1490,0,700000,2014
1280,1520,2,0,1080,200,490000,2008
3870,5929,2,0,3870,0,1.30E+06,2014
1280,1051,2,0,1080,200,579000,2009
1300,1435,2,0,1120,180,552500,2007
2170,5024,2,0,2170,0,467000,2012
1763,3717,2,0,1763,0,305000,2012
1020,1525,2,0,1020,0,212000,2004
1840,4593,2,0,1840,0,429000,2010
1820,1358,3,0,1820,0,479950,2014
2670,3000,2,0,1870,800,825000,2014
6260,10955,2,0,4840,1420,1.18E+06,2007
1400,3814,2,0,1400,0,250000,2012
1160,2158,2,0,1160,0,289000,1982
1400,3368,2,0,1400,0,265000,2013
1232,1130,3,0,1232,0,344000,2007
2700,6000,2,0,2100,600,749000,1910
2550,6382,2,0,2550,0,492000,2007
3260,6902,2,0,3260,0,552500,2008
1680,1240,2,0,1120,560,653500,2014
2630,2550,2,0,2030,600,855000,2006
1260,5758,2,0,1260,0,333000,1999
2550,4500,2,0,2550,0,415000,2009
3450,5000,2,0,3450,0,445000,2008
1550,3402,2,0,1550,0,273500,2009
4150,8436,2,0,4150,0,969990,2014
3900,4400,2,0,2650,1250,1.20E+06,2014
1550,1444,3,0,1550,0,430000,2006
2130,4000,2,0,2130,0,392000,2014
2890,7798,2,0,2890,0,795000,2005
1220,1330,2,0,1010,210,457000,2008
2502,8306,2,0,2502,0,453000,2013
1340,1384,3,0,1340,0,376000,2008
2350,3800,2,0,2350,0,469995,2014
1810,3930,2,0,1810,0,540000,2008
3310,6500,2,0,3310,0,555000,2012
1620,5101,1,0,590,1030,445000,2006
1070,635,2,0,720,350,256950,2008
2230,4952,2,0,2230,0,297000,2011
1970,4558,2,0,1970,0,320000,2005
4600,7810,2,0,3200,1400,805000,2006
3110,6050,2,0,3110,0,799990,2014
3490,3677,2,0,2850,640,680000,2007
1600,1936,2,0,1600,0,395000,2007
1960,3060,2,0,1960,0,732000,2010
1000,1092,2,0,990,10,163800,2004
1000,1092,2,0,990,10,220000,2004
1500,1408,3,0,1500,0,308625,1999
2424,5931,2,0,2424,0,375000,2014
2303,3826,2,0,2303,0,300000,2006
1880,6008,2,0,1880,0,284000,2009
1210,740,2,0,780,430,610000,2014
3720,6765,2,0,3720,0,955000,2012
3610,8580,2,0,3610,0,982000,2014
1360,885,3,0,1360,0,359000,2008
2590,7084,2,0,2590,0,779380,2014
4390,11250,2,0,4390,0,1.51E+06,2007
2290,1407,2.5,0,1890,400,635000,2014
3880,9979,2.5,0,3880,0,1.06E+06,2007
1350,874,3,0,1270,80,389500,2006
2170,2752,2,0,2170,0,359800,2014
1296,1051,3,0,1296,0,399950,2009
1530,1602,2,0,1140,390,320000,2013
1489,3266,2,0,1489,0,255900,2014
2130,4467,2,0,2130,0,380000,2014
1430,1521,2,0,1130,300,580000,2009
2380,7268,1,0,1430,950,545000,2008
1420,814,2,0,1140,280,451300,2008
3450,6184,2,0,3450,0,852880,2014
1914,3150,2,0,1914,0,305000,2009
988,1080,3,0,988,0,295000,2007
1584,2800,2,0,1584,0,261000,2012
2630,5710,2,0,2630,0,560000,2001
3520,5250,2,0,3520,0,795000,2012
2380,4913,2,0,2380,0,384950,2006
1410,1197,3,0,1410,0,500000,2012
3220,5741,2,0,3220,0,640000,2013
3266,5969,2,0,3266,0,418000,2014
2550,4794,2,0,2550,0,799000,2007
3828,18900,2.5,0,3828,0,552900,2014
1670,1596,3,0,1670,0,539950,2014
3056,11385,2,0,3056,0,524225,2014
1000,1188,3,0,1000,0,424950,2005
1530,1786,2,0,1200,330,560000,2007
3490,6091,2,0,3490,0,715000,2009
2760,6000,2,0,2760,0,300000,2006
1440,2163,2,0,1440,0,405000,2005
1370,1001,3,0,1370,0,327000,2009
3180,6551,2,0,3180,0,859950,2014
2720,7570,2,0,2720,0,560000,2008
1800,2792,2,0,1800,0,379900,2011
3220,6409,2,0,3220,0,625000,2008
2370,5321,2,0,2370,0,398096,2014
1410,1325,2,0,1180,230,315000,2007
3640,6049,2,0,3640,0,939000,2014
1920,3624,2,0,1920,0,674000,2003
2267,3577,2,0,2267,0,306000,2014
5780,17004,2,0,4260,1520,2.32E+06,2006
1131,1304,3,0,1131,0,394950,2011
2940,6431,2,0,2940,0,914154,2014
2180,4533,2,0,2180,0,496000,2010
1400,1078,2,0,940,460,430100,2009
2680,5539,2,0,2680,0,449990,2013
2680,5539,2,0,2680,0,502000,2013
1300,3612,2,0,1300,0,310000,2005
2796,3520,2.5,0,2796,0,349950,2013
1460,1500,2,0,1000,460,625000,2008
4210,6481,2,3,3260,950,1.05E+06,2014
2330,3920,2,0,2330,0,680000,2005
3930,5680,2,1,2820,1110,828950,2013
1608,4000,2,0,1608,0,274950,2014
1610,1968,2,0,1610,0,293000,1979
3200,3250,2,0,2670,530,795000,2007
1710,3500,2,0,1710,0,282900,2014
3050,8972,2,0,3050,0,909950,2014
3560,4951,2,0,3560,0,922755,2014
2650,8685,2,0,2650,0,424000,2006
3490,12410,2,0,2590,900,630000,2009
4140,46173,2,0,4140,0,810000,2007
1670,4441,1,0,1670,0,256703,2014
1720,3600,2,0,1720,0,386380,2010
1510,3961,1,0,1510,0,485000,2010
1450,4040,2,0,1450,0,275000,2010
1812,5026,2,0,1812,0,370000,2011
1060,1208,2,0,940,120,499950,2005
1600,3073,3,0,1600,0,502000,2009
1530,1565,2,0,1280,250,654000,2005
2070,1230,3,0,1500,570,575000,2013
3630,7482,2,0,3630,0,500000,2008
2140,4126,2,0,1960,180,554000,2005
2010,12188,1,0,1150,860,360000,1960
2630,4501,2,0,2630,0,619990,2015
2233,6025,2,0,2233,0,317500,2012
2990,4521,2,0,2990,0,564950,2014
1240,2150,2,0,1240,0,545000,2014
2230,5050,2,0,2230,0,333700,2006
3700,2264,2,0,2280,1420,1.48E+06,1998
2290,5105,2,0,2290,0,530000,2012
950,865,3,0,950,0,396000,2006
1120,758,2,0,1120,0,305000,2012
2420,4670,2,0,2420,0,380000,2013
1714,3250,2,0,1714,0,305000,2010
2230,5650,2,0,2230,0,440000,2011
2530,10000,2,0,2530,0,459000,2013
1550,1233,2,0,1160,390,530000,2005
3110,11225,2,0,3110,0,600000,2012
2100,2409,2,0,1660,440,515000,2008
2150,3721,2,0,2150,0,275000,2007
1630,1404,2,0,1020,610,540000,2014
2230,7934,2,0,2230,0,445000,2005
1320,955,3,0,1320,0,285000,2009
1590,1431,2,0,1060,530,480000,2010
2610,3642,2,0,2080,530,440000,2005
1440,2500,2,0,1440,0,287450,2008
2630,6283,2,0,2630,0,507950,2006
3390,10078,2,0,3040,350,750000,2012
1400,1022,3,0,1400,0,425000,2007
1900,2133,2,0,1520,380,420000,2009
1350,1250,3,0,1270,80,394950,2006
3420,6752,2,2,3030,390,635000,2012
2150,161607,2,0,1330,820,513000,1995
2110,5306,2,0,2110,0,380000,2012
3810,8519,1,1,2680,1130,1.13E+06,2007
2870,4369,2,0,2090,780,540000,2007
1240,705,2,0,1150,90,352499,2009
3610,6345,2,0,2370,1240,603000,2008
2310,5100,2,0,2310,0,685000,2013
1930,3031,1,0,1200,730,330675,2006
1390,1080,2,0,1140,250,275000,2006
1578,7340,2,0,1578,0,259950,2010
1720,15000,1,0,1720,0,441000,2011
4700,11237,2,0,2930,1770,1.14E+06,2006
1970,5079,2,0,1680,290,590000,2007
1460,1353,2,0,1050,410,497000,2012
1930,4000,2,0,1930,0,345500,2014
1300,907,2,0,1000,300,562500,2006
1445,1087,2,0,1300,145,355000,2005
860,696,2,0,860,0,345000,2009
3040,4535,2,0,3040,0,478000,2007
2424,6143,2,0,2424,0,391500,2014
1084,3427,2,0,1084,0,265000,1976
2510,5320,2,0,2510,0,395000,2005
1220,1036,3,0,1220,0,286308,2006
1280,835,2,0,1080,200,370000,2009
3740,5610,2,0,2860,880,1.08E+06,2014
1852,4000,2,0,1852,0,298900,2014
2580,5787,2,0,2580,0,775000,2007
3190,31450,2,0,3190,0,790000,2010
3400,5119,2,0,2300,1100,1.05E+06,2014
1090,2686,2,0,1090,0,249000,1982
2360,6145,1,0,2360,0,348000,2011
2460,5604,2,0,2460,0,358000,2011
2025,7760,2,0,2025,0,260000,2007
4410,5104,2,0,3400,1010,765000,2006
2810,5400,2,0,2810,0,739000,2005
4490,6000,2,0,3200,1290,890000,2006
3070,6432,2,0,3070,0,462000,2006
1984,32400,1,0,1564,420,380000,1962
4750,8234,2,2,3350,1400,770000,2013
2760,4104,2,0,1900,860,641000,2014
4360,8175,2.5,4,3940,420,2.30E+06,2007
3060,27251,1.5,0,3060,0,369000,2008
2770,2650,2,0,2180,590,1.11E+06,2014
2990,9240,2,0,2990,0,357000,2015
1540,1251,2,0,1230,310,650000,2002
1400,1312,3.5,0,1400,0,563500,2007
1680,2229,2,0,1680,0,345000,2007
2260,7163,1,0,2260,0,479950,2012
3400,5196,2,0,3400,0,660000,2012
2930,5000,2,0,2760,170,800000,2007
1239,6036,1,0,1239,0,253101,2009
2100,2479,2,0,1450,650,555000,2011
1200,2171,1.5,0,1200,0,240000,1933
1200,2171,1.5,0,1200,0,380000,1933
680,772,2,0,680,0,239000,2005
2690,3995,2,0,2060,630,760000,2014
2750,7200,2,0,2750,0,430000,2011
2450,4332,2,0,2450,0,660000,2010
2620,4050,2,0,2620,0,399963,2014
1130,1148,2,0,800,330,411000,2007
2790,5527,2,0,2790,0,483453,2014
1820,1357,3,0,1820,0,469950,2014
2910,7467,2,0,2910,0,504058,2013
2568,5000,2,0,2568,0,425996,2014
3090,5859,2,0,3090,0,760005,2010
1460,1085,2,0,950,510,699999,2014
2010,2263,2,0,1340,670,749950,2014
2610,5140,2,0,2610,0,674600,2006
960,1000,2,0,920,40,450000,2008
1528,7616,2,0,1528,0,272000,2011
1310,1264,2,0,1120,190,450000,2006
1760,2122,3,0,1760,0,643950,2015
1420,3542,2,0,1310,110,290000,2007
1650,2082,3,0,1650,0,378000,2007
2320,6775,1,0,2320,0,728050,2008
2628,11466,2,0,2628,0,499160,2014
2520,4831,2,0,2520,0,536000,2009
2880,5000,2,0,2260,620,419900,2012
1440,1362,3,0,1440,0,469000,2014
2185,6042,2,0,2185,0,374000,2009
1500,2106,2,0,1500,0,182568,2014
1769,7324,2,0,1769,0,334888,2012
3650,18223,2,3,3330,320,799900,2013
2160,6223,2,0,2160,0,383000,2010
1820,374616,2,0,1820,0,580000,1999
2370,4200,2,0,2370,0,351999,2014
3180,2758,2,2,2240,940,1.33E+06,2008
1780,4077,2,0,1780,0,312000,2011
2650,3127,2,0,2230,420,674950,2011
3300,7560,2,0,3300,0,1.11E+06,2007
1160,1219,3,0,1160,0,415000,2007
3460,5353,2,0,2850,610,1.25E+06,2007
1390,2450,2,0,1390,0,208800,2009
1260,1131,3,0,1260,0,452000,2006
2940,5225,2,0,2760,180,837000,2010
3190,4247,2,0,2430,760,780000,2013
3930,6120,2,0,3310,620,1.49E+06,2007
3570,10125,2,0,3570,0,1.60E+06,2014
2420,4725,2,0,2420,0,369946,2014
3400,7200,2,2,2470,930,530000,2009
2478,6079,2,0,2478,0,386000,2012
3070,7830,2,2,1970,1100,1.90E+06,2009
3200,7605,2,2,2500,700,735000,2013
5790,12739,2,3,4430,1360,1.75E+06,2014
1590,926,3,0,1590,0,489950,2014
1730,1442,2,0,1440,290,357500,2008
2303,3680,2,0,2303,0,329995,2013
1790,3754,2,0,1790,0,414000,2013
2490,3517,2,0,1720,770,533500,2005
2669,5385,2,0,2669,0,402395,2014
2610,2552,2,0,2160,450,725000,2008
6160,27490,2,0,4040,2120,1.28E+06,2007
1290,1493,2,0,1290,0,239800,2014
3560,5008,2,0,2810,750,616950,2013
4360,6000,2,3,3400,960,1.26E+06,2007
1230,1238,2,0,1080,150,435000,2009
3640,60086,2,0,3640,0,925000,2005
1780,2493,3,0,1780,0,631500,1981
1140,1069,3,0,1140,0,399995,2005
1270,1320,3,0,1270,0,369950,2006
2780,3583,2,0,2180,600,475000,2005
1912,5000,2,0,1912,0,353000,2012
2300,9690,2,0,2300,0,329950,2006
2828,4050,2,0,2828,0,367000,2013
2425,9017,2,0,2425,0,447500,2013
3730,4560,2,0,2760,970,595000,2015
730,1942,1,0,730,0,325000,2009
1990,1756,3,0,1780,210,690000,2005
1300,812,2,0,880,420,329950,2008
2560,7492,2,0,2560,0,399500,2014
2450,5047,2,0,2450,0,555000,2007
1440,725,2,0,1100,340,427000,2011
1140,1557,3,0,1140,0,375000,2007
1110,957,2,0,930,180,499000,2005
2620,43832,2,0,2620,0,750000,2013
1690,1200,2,0,1410,280,336900,2014
1950,1610,3,0,1950,0,555000,2009
3530,8126,2,0,3530,0,1.28E+06,2007
3310,4684,2,0,2290,1020,999950,2014
2620,5477,2,0,2620,0,975000,2009
1350,3582,2,0,1350,0,299000,2010
1741,1439,2,0,1446,295,479000,2007
1650,2201,3,0,1650,0,428000,2007
1890,6500,2,0,1890,0,409000,2012
1950,1833,3,0,1610,340,798500,2009
4490,5805,2,0,3390,1100,689000,2006
3206,5793,2,0,3206,0,375000,2012
4130,77832,2,2,4130,0,775000,2011
2800,5700,2,0,2800,0,639983,2014
1984,4419,2,0,1984,0,300000,2010
2750,11830,2,0,2750,0,627000,2014
1740,5757,1,0,1740,0,275000,2010
1800,2752,2,0,1800,0,352800,2014
1540,1005,3,0,1540,0,565000,2008
2030,2222,2,0,1610,420,765000,2015
3310,4839,2,0,3310,0,644000,2007
1270,1416,3,0,1270,0,461000,2007
2406,7093,2,0,2406,0,270500,2006
1540,965,3,0,1540,0,640000,2007
2820,6983,2,0,2820,0,457000,2013
2540,5100,2,0,2540,0,355000,2014
1230,989,3,0,1230,0,356000,2007
1900,2766,2,0,1900,0,425000,2014
2920,6327,2,0,2920,0,562500,2007
1450,1053,2,0,940,510,460000,2008
5370,69848,2,0,3500,1870,790000,2005
1270,1333,3,0,1270,0,401000,2006
2550,5100,2,0,2550,0,1.10E+06,2014
3070,7150,2,0,3070,0,850000,2007
1450,4050,2,0,1450,0,274500,2010
4230,16526,2,0,4230,0,1.94E+06,2008
3480,6262,2,0,3480,0,808000,2003
1490,974,2,0,1220,270,312000,2009
1200,1400,3,0,1200,0,320000,2005
2150,4332,2,0,2150,0,410000,2013
3690,8837,2,0,3690,0,725000,2001
1900,3301,2,0,1900,0,335000,2007
1690,1321,2,0,1320,370,519990,2014
2790,8853,2,0,2790,0,533112,2013
1936,6612,2,0,1936,0,274900,2014
1150,711,2,0,1150,0,325000,2013
2040,22653,2,0,2040,0,350000,2011
2470,7539,2,0,2470,0,550000,2006
1890,4158,2,0,1890,0,311850,2014
1626,1583,2.5,0,1419,207,526000,2007
2250,5306,2,0,2250,0,375000,2012
1350,1234,2,0,1160,190,299999,2007
1460,1238,2,0,1200,260,436000,2008
2056,3564,2,0,2056,0,303000,2014
1160,1458,2,0,1040,120,525000,2012
1384,1287,2,0,1144,240,575000,2006
1100,1107,3,0,1100,0,420000,2008
2456,7566,2,0,2456,0,329950,2012
4500,215186,2,3,2630,1870,1.83E+06,2009
3780,10099,1,1,2240,1540,1.18E+06,2006
1320,1157,2,0,990,330,499950,2014
5940,11533,2,4,4950,990,1.15E+06,2004
1650,5027,1.5,0,1650,0,400000,2009
1670,4440,1,0,1670,0,246950,2014
1610,1275,2,0,1220,390,630000,2005
3370,10315,2,0,3370,0,561000,2006
2660,4082,2,0,2660,0,287000,2010
1690,1473,2,0,1380,310,600000,2008
1620,1062,3,0,1620,0,490000,2014
1300,958,2,0,840,460,330000,2011
1610,4052,2,0,1610,0,286950,2013
3530,4920,2,0,2660,870,1.55E+06,2015
3550,8618,2,0,3550,0,880000,2007
1730,1755,3,0,1730,0,577450,2014
2400,4900,2,0,2400,0,405000,2011
1420,1237,3,0,1420,0,510000,2014
1220,1120,2.5,0,1110,110,465000,2008
2360,4000,2,0,2360,0,1.30E+06,2013
3990,11270,2,3,2930,1060,609000,2007
1260,1211,3,0,1260,0,336000,2004
1580,2407,2,0,1580,0,375000,2013
1760,2688,2,0,1760,0,294500,2005
3420,4216,2,0,2520,900,925000,2008
2870,6593,2,0,2870,0,730000,2006
1934,5677,2,0,1934,0,280000,2013
1220,962,3,0,1220,0,500000,2014
2450,5750,2,0,2450,0,605000,2013
1860,1787,3,0,1860,0,379950,2007
1500,1119,3,2,1110,390,605000,2008
1570,1108,3,0,1570,0,720000,2007
1280,960,2,0,1040,240,549900,2014
3192,5653,2,0,3192,0,427000,2014
1690,1479,3,0,1420,270,492000,2005
1590,1426,2,0,1590,0,419190,2014
2870,7288,2,0,2870,0,650000,2012
2580,4818,2,0,2580,0,379950,2005
1830,3420,2,0,1830,0,269800,2012
2927,6000,2,0,2927,0,407000,2011
1320,1250,3,0,1320,0,580000,2008
1720,3581,2,0,1720,0,389700,2011
828,4524,1,0,828,0,110000,1968
1040,1264,2,0,900,140,230000,2015
2790,6685,2,0,2790,0,533380,2014
1410,1332,2,0,960,450,295500,2014
4040,8400,2,0,3220,820,860000,2006
3370,3634,2,0,2750,620,812000,2007
1660,3990,2,0,1660,0,324500,2009
910,2550,1,0,910,0,193000,2004
1280,959,3,0,1280,0,355000,2005
2360,4924,2,0,2360,0,525000,2008
2529,9653,2,0,2529,0,370950,2012
4700,10183,1,2,2660,2040,1.24E+06,2002
2780,275033,1,0,2780,0,950000,2006
3540,5500,2,0,3540,0,888990,2014
1580,1321,2,2,1080,500,705000,2014
1700,2250,2,0,1700,0,268000,2014
1600,3573,2,0,1600,0,305450,2013
1410,1005,1.5,0,900,510,399900,2011
1580,1228,3,0,1580,0,495000,2014
3940,11632,2,0,3940,0,857326,2014
4450,9600,2,0,3650,800,845950,2014
2009,5000,2,0,2009,0,303210,2014
2732,7655,2,0,2732,0,343000,2009
2090,4590,2,0,2090,0,300000,2005
980,1013,3,0,980,0,334900,2008
2815,5619,2,0,2815,0,477500,2012
3170,8523,2,0,3170,0,820000,2008
3030,7410,2,0,2150,880,580000,2014
1280,940,2,0,1060,220,350000,2006
2030,1160,3,0,1970,60,910000,2007
2490,4540,2.5,0,2490,0,414000,2012
3030,4500,2,0,3030,0,525000,2009
1470,690,3,3,1470,0,650000,2008
1620,997,2.5,0,1540,80,450000,2012
5520,8313,2,3,3570,1950,1.27E+06,2008
3200,10344,2,0,3200,0,699000,2007
2580,3943,2,0,2580,0,899000,2013
2050,4000,2,0,2050,0,353500,2014
2430,5867,2,0,2430,0,485000,2011
3060,3898,2,0,2300,760,782900,2014
1540,9714,2,0,1540,0,529000,2008
1310,1072,2,0,1060,250,514700,2008
1800,3168,2,0,1800,0,409316,2014
2370,4200,2,0,2370,0,388598,2014
1445,1512,2,0,1300,145,415000,2004
1450,1619,2,0,1140,310,521500,2006
1740,1236,3,2,1740,0,580000,2008
3560,5265,3,0,3560,0,882566,2014
2130,1400,2,0,1080,1050,525000,2010
2980,4502,2,0,2980,0,515000,2007
2840,7201,2,0,2840,0,589410,2014
3420,6845,2,0,3420,0,757500,2009
1660,4083,2,0,1660,0,284000,2013
1150,711,2,0,1150,0,338500,2013
1410,1287,2,0,1290,120,379500,2005
1420,1369,2.5,0,1340,80,550000,2007
1860,5025,2,0,1860,0,294900,2010
1340,1210,2,0,1120,220,345000,2008
1530,1012,2,0,1200,330,450000,2005
1509,1114,3,0,1509,0,420000,2014
2350,3798,2,0,2350,0,740000,2013
1010,825,3,0,1010,0,286000,2007
4495,10079,2,0,3580,915,870000,2013
1580,991,3,0,1580,0,727000,2009
2750,7965,2,0,2750,0,395000,2012
1890,3615,2,0,1890,0,535000,2005
1320,963,2,0,1040,280,255000,2007
2150,3721,2,0,2150,0,260000,2006
3340,8384,2,0,3340,0,810000,2014
1850,3400,2,0,1850,0,359782,2010
1950,2162,2,0,1500,450,500000,2012
4240,9588,2,0,4240,0,1.05E+06,2014
2700,2868,2,0,1920,780,810000,2006
3040,6000,2,0,2280,760,605000,2011
2460,7930,2,0,2460,0,730000,2005
2110,3825,2,0,2110,0,327000,2013
780,1133,2,0,780,0,370000,2009
2640,6895,2,0,2640,0,459000,2001
5190,14600,2,1,5190,0,2.90E+06,2013
2420,8404,2,0,2420,0,365000,2013
1987,6000,2,0,1987,0,255000,2011
720,3166,1,0,720,0,375000,1920
1130,912,2,0,1000,130,375000,2006
2810,4500,2,0,2810,0,518380,2014
1500,1442,2,0,1150,350,346000,2007
1390,745,3,0,1390,0,302059,2008
2500,4945,2,0,2500,0,575000,2013
3906,9674,2,2,3906,0,549950,2014
7120,40806,2,4,5480,1640,900000,2007
1470,1256,2,0,930,540,397500,2006
3230,7560,2,0,3230,0,1.08E+06,2007
2700,5764,2,0,2700,0,775900,2014
4073,17334,2,0,4073,0,510000,2008
3361,5038,2,0,3361,0,471275,2014
1610,3560,2,0,1610,0,288000,2010
3830,7150,2,0,3830,0,989990,2014
1470,1235,2,0,1180,290,300000,2008
3190,7081,1,2,1890,1300,664950,2013
3250,5478,2,0,3250,0,699188,2014
1490,4539,2,0,1490,0,390000,2009
2900,5155,2,0,2900,0,670000,2008
2540,5001,2,0,2540,0,487000,2005
3360,12080,2,0,3360,0,769995,2014
860,1277,2,0,860,0,321950,2007
3020,6068,2,0,3020,0,613500,2006
1330,1200,3,0,1330,0,300000,2002
2578,4554,2,0,2578,0,400950,2014
2640,4725,2,0,2640,0,389517,2014
1260,1133,2,0,810,450,255000,2011
1990,1891,3,0,1990,0,1.08E+06,2012
3340,4900,2,2,2500,840,637850,2014
2840,6284,2,0,2840,0,636230,2013
1530,1131,3,0,1530,0,375000,2009
1780,1487,3,0,1600,180,586500,2006
2340,6973,2,0,1930,410,544000,2005
2390,5021,2,0,2390,0,425000,2002
2090,3777,2,0,2090,0,374950,2012
1140,8400,1,0,1140,0,294570,1960
1960,1477,2,0,1670,290,300000,2012
2738,6031,2,0,2738,0,395950,2014
3691,11088,2,1,3691,0,800000,2013
2340,5171,2,0,2340,0,439990,2013
2510,3763,2,0,1990,520,680000,2013
2800,4213,2,0,2800,0,677790,1998
1650,4777,2,0,1650,0,424950,2013
1061,2884,2,0,1061,0,223990,2013
3402,14355,2,0,2846,556,498000,2014
2542,6120,2,0,2542,0,359950,2014
3150,151588,2,0,3150,0,720000,2007
3010,9000,2,0,3010,0,530000,2008
1660,4898,2,0,1660,0,295000,2011
1770,5000,2,0,1770,0,255500,2009
1960,1168,2,0,1600,360,556000,2007
1889,6000,2,0,1889,0,277950,2012
3040,6000,2,0,3040,0,431000,2007
3420,6787,2,0,3420,0,780000,2010
1720,936,2,0,1030,690,649000,2004
1740,3043,2,0,1740,0,447000,2012
2450,4247,2,0,2450,0,712198,2013
1190,785,2,0,920,270,277140,2014
3753,7204,2,0,3336,417,363000,2008
3440,6037,2,0,3440,0,598992,2014
2160,1250,3,0,1830,330,585000,2010
3820,8850,2,0,3820,0,1.27E+06,2014
1120,1039,2,0,840,280,380950,2007
2250,3916,2,0,2250,0,333490,2014
1540,1487,2,0,1540,0,520000,2011
1240,705,2,0,1150,90,315000,2009
1160,1118,2,0,1020,140,487000,2007
2760,3865,2.5,0,2760,0,424950,2013
1580,1487,3,0,1580,0,542300,2013
1480,1192,2,0,1180,300,320000,2013
3740,11467,2,0,3740,0,1.14E+06,2014
1950,5000,2,0,1950,0,425000,2012
1530,1568,3,0,1530,0,474950,2012
1820,4200,2,0,1820,0,307635,2014
2760,6187,2,0,2760,0,834538,2014
3010,5398,2,0,3010,0,769995,2014
3860,9387,2,2,3860,0,820875,2006
2490,6537,2,0,2490,0,595500,2013
3236,9608,2,0,3236,0,450000,2005
2830,14538,2,0,2830,0,695000,2003
1451,7159,1,0,1451,0,300000,2010
2910,5027,2,0,2040,870,515000,2013
1280,1845,3,0,1280,0,545000,2009
1110,979,2,0,960,150,365000,2008
2840,8800,2,0,2840,0,718500,2008
1410,2052,2,0,1410,0,279800,2014
3250,13360,2,0,3250,0,486940,2014
3030,6625,2,0,3030,0,525000,2011
1983,6002,2,0,1983,0,345000,2012
2440,2812,2,0,1710,730,613000,2005
2313,5700,2,0,2313,0,370000,2011
1260,2556,2,0,1260,0,449500,2005
2000,3837,2,0,2000,0,515000,2011
1150,698,2,0,1150,0,346100,2013
2820,6666,2,0,2820,0,398500,2007
1160,2500,2,0,1160,0,310000,2008
1481,2820,2,0,1481,0,250000,2012
4390,6220,2,3,3170,1220,1.88E+06,2013
1570,1207,3,0,1570,0,695000,2007
3410,6541,2,2,2680,730,1.09E+06,2007
3480,6507,2,0,3480,0,864327,2014
3430,9870,2,0,3430,0,749995,2014
2880,8364,2,0,2880,0,525000,2006
2990,9413,2,0,2990,0,659950,2006
4490,10279,2,0,3930,560,1.80E+06,2013
4100,8120,2,0,4100,0,950000,2011
3870,10046,2,0,3870,0,1.40E+06,2005
800,2119,2,0,800,0,265050,2008
1620,1057,3,0,1540,80,450000,2009
2910,4356,3,0,2910,0,915000,2010
3530,8589,2,0,3530,0,963000,2007
2701,5821,2,0,2701,0,270000,2013
1380,889,2,0,1140,240,294000,2012
2050,4185,2,0,2050,0,700000,2011
3370,8252,2,0,3370,0,1.07E+06,2014
2040,2500,2,0,1470,570,494900,2008
1610,3600,2,0,1610,0,415000,2010
2680,5539,2,0,2680,0,459990,2013
3560,6562,2,0,3560,0,882990,2014
3880,8244,2,0,3060,820,620000,2007
1824,7120,1,0,1824,0,375900,2010
2220,2873,2,0,2010,210,654000,2012
4140,11007,2,0,4140,0,1.84E+06,2013
1322,6006,2,0,1322,0,215000,2009
1909,1300,3,0,1766,143,630500,2006
3460,7702,2,0,3460,0,855000,2010
1954,5075,2,0,1954,0,235245,2007
3000,7912,1,0,1610,1390,770000,2007
2650,6884,2,0,2650,0,734990,2012
2580,3436,2,0,2580,0,880000,2013
2650,4924,2,0,2650,0,525000,2011
3390,3960,2,0,3390,0,775000,2008
1470,873,3,0,1470,0,687015,2009
1910,5125,2,0,1910,0,663000,2006
3030,7187,2,0,3030,0,815000,2005
2930,25020,2,0,2930,0,1.05E+06,2013
1650,2787,2,0,1650,0,433190,2014
2870,5118,2,0,2870,0,725000,2006
1608,4800,2,0,1608,0,279950,2013
1620,3795,2,0,1620,0,272167,2014
1350,1186,2,0,1120,230,468500,2007
1950,3600,2,0,1950,0,298000,2010
3390,7200,2,0,2440,950,303500,2007
1300,1237,2,0,1060,240,308000,2008
2230,1407,2.5,0,1850,380,646800,2014
1880,3853,2,0,1880,0,530200,2010
3370,5092,2,0,3370,0,405000,2006
1320,1395,2,0,990,330,529000,2014
2920,9096,2,0,2920,0,675900,2013
1550,1280,2,0,1220,330,570000,2013
2301,6452,2,0,2301,0,375500,2010
1710,1960,2,0,1360,350,445000,2004
2890,4164,2,0,2240,650,1.10E+06,2013
2100,5060,2,0,2100,0,477000,2006
2240,3360,2,0,2100,140,450000,2014
1460,1200,3,0,1460,0,427005,2006
1370,1990,3,0,1370,0,720000,2014
3760,5634,2,4,2830,930,2.23E+06,2014
2510,5311,2,0,2510,0,450800,2009
1210,1267,2,0,1120,90,461100,2010
2990,6695,2,0,2990,0,1.06E+06,2014
1710,2875,2,0,1710,0,590000,2006
3274,4950,2,0,3274,0,478830,2014
3300,8365,3,0,3300,0,760000,2014
4370,10860,2,0,4370,0,1.03E+06,2008
2050,5276,2,0,2050,0,385000,2006
1310,1500,2,0,1160,150,500000,2006
1680,8000,1.5,0,1680,0,425000,2012
1330,1379,2,0,1120,210,552100,2005
1950,1983,3,0,1610,340,785000,2009
3090,7069,2,0,3090,0,615000,2012
1950,3825,2,0,1950,0,309000,2013
1108,1128,3,0,1108,0,369500,2009
2190,3850,2,0,2190,0,391000,2006
1590,1322,2,0,1060,530,465000,2014
3010,7215,2,0,3010,0,879950,2014
1330,1042,2,0,1060,270,372000,2014
1550,3569,2,0,1550,0,259000,2011
1260,1575,2,0,1260,0,374000,2001
2550,5395,2,0,2550,0,561000,2001
1300,1331,3,0,1300,0,610000,2007
2230,1407,2.5,0,1850,380,635000,2014
1170,1456,2,0,1070,100,235000,2007
4170,4524,2,0,3500,670,623300,2007
1680,5246,1,0,1680,0,412500,2007
2864,8035,3,0,2864,0,380000,2014
1630,3817,2,0,1630,0,497000,2005
2716,7850,2,0,2716,0,452000,2014
1750,4076,2,0,1750,0,312000,2013
3223,6371,2,0,3223,0,469950,2014
2600,4284,2,0,2600,0,775000,2014
3320,8653,2,0,3320,0,679990,2014
1350,942,3,0,1350,0,288790,2008
3410,4726,2,0,3410,0,800000,2007
1572,4000,2,0,1572,0,299000,2013
2300,4482,2,0,2300,0,332000,2013
1030,5923,1,0,1030,0,525000,1940
1458,858,2,0,950,508,620000,2014
2190,6896,2,0,2190,0,452000,2007
3640,5096,2,0,2740,900,630000,2010
2790,7803,2,0,2790,0,485000,2013
2632,4117,2,0,2632,0,349950,2013
2910,6334,2,0,2910,0,499990,2013
1470,1101,2,0,1340,130,510000,2005
2240,21477,2,2,2240,0,1.08E+06,1995
2310,4729,2,0,2310,0,494000,2011
2370,5353,2,0,2370,0,429900,2009
2980,9825,1,0,1910,1070,505000,2007
1870,6551,1,3,1870,0,272000,2009
1770,1714,3,0,1770,0,671500,2012
3510,10010,2,0,3510,0,729950,2001
3281,5354,2,0,3281,0,471835,2014
1670,4438,1,0,1670,0,249950,2014
2760,3846,2.5,0,2760,0,424950,2013
5430,10327,2,2,4010,1420,1.24E+06,2007
2990,7928,2,0,2990,0,440000,2011
3170,3858,2,0,2530,640,495000,2008
3520,6773,2.5,0,2650,870,870000,2006
1650,960,3,0,1350,300,559000,2015
2656,21195,2,0,2656,0,495000,2014
2230,4850,2,0,2230,0,722000,2014
2280,2502,2,0,1880,400,567500,2006
2798,5085,2,0,2798,0,440000,2011
2398,5988,2,0,2398,0,400000,2008
2350,3760,2,0,2350,0,459995,2014
2410,5003,1,0,1410,1000,365000,2008
1580,920,3,0,1580,0,389950,2015
1450,1387,2,0,1180,270,320000,2013
1750,4779,2,0,1750,0,415500,2009
3020,4120,2,0,2360,660,775000,2008
1740,1100,3,0,1740,0,590000,2007
2200,2043,2,0,1760,440,950000,2007
1867,15314,2,0,1867,0,378950,2013
1020,1060,3,0,1020,0,441750,2008
2475,4000,2,0,2475,0,335900,2014
1110,1773,2,0,1110,0,229800,2014
1900,1258,2.5,0,1700,200,645000,2007
1560,1345,2,0,1260,300,448000,2009
2510,5436,2,0,2510,0,706000,2011
4150,6303,3,0,4150,0,988990,2014
1660,1849,3,0,1660,0,716000,2013
1090,847,3,0,1090,0,319000,2009
1914,3272,2,0,1914,0,300000,2009
2730,54014,1,0,1560,1170,625000,2007
2470,3600,2,0,2470,0,773000,2007
2340,5670,2,0,2340,0,392000,2009
2660,5690,2,0,1920,740,549995,2014
2410,4656,2,0,2410,0,480000,2009
1430,4777,2,0,1430,0,355000,2010
1570,1268,3,0,1570,0,208400,2007
3010,4919,2,0,3010,0,831548,2014
1613,4338,2,0,1613,0,279500,2009
2380,5269,2,0,2380,0,445000,2008
2570,9962,2,0,2570,0,492500,2006
2550,5200,2,0,2550,0,435000,2009
1330,969,3,0,1330,0,325000,2007
1160,1269,2,0,970,190,453000,2005
3240,6919,2,0,2760,480,612995,2014
2710,9248,2,0,2710,0,540000,2011
1150,18200,1,0,1150,0,465000,1959
1860,1386,3,0,1860,0,799950,2014
1280,1517,2,0,1080,200,495000,2008
1810,1585,3,0,1810,0,579950,2014
1240,720,2,0,1150,90,331000,2008
1460,951,3,0,1460,0,580000,2008
1640,1953,2,0,1640,0,669000,2014
5010,19412,2,1,4000,1010,2.35E+06,2014
1300,1325,2,0,1080,220,539900,2005
2510,4349,2,0,2510,0,490000,2010
2710,3475,2,0,1650,1060,627000,2005
3217,4000,2,0,2587,630,458000,2008
1650,4929,2,0,1520,130,440000,2007
3950,6240,2,0,3950,0,1.70E+06,2015
1680,977,3,0,1680,0,935000,2009
3420,6403,2,2,2700,720,641000,2013
2300,5090,2,0,1700,600,452000,2007
3010,6854,2,2,2570,440,625000,2012
4680,12495,2,0,3040,1640,1.35E+06,2008
3630,4911,2,0,2790,840,834950,2014
3530,3610,2,0,2370,1160,1.50E+06,2008
2280,3800,2,0,2280,0,305000,2006
3090,384634,2,0,3090,0,659000,2007
550,1279,2,0,550,0,353000,2008
2840,4000,2,3,2330,510,535000,2014
3130,10849,2,0,3130,0,999000,2013
1440,1102,3,0,1440,0,375000,2009
2840,4637,3,0,2840,0,685000,2008
2623,7184,2,0,2623,0,333000,2012
390,2000,1,0,390,0,245000,1920
5640,35006,2,2,4900,740,2.00E+06,2015
1260,1032,2,0,1170,90,329950,2008
894,1552,2,0,894,0,403000,2011
3370,4934,2,0,3370,0,559630,2014
1250,871,3,0,1250,0,344000,2007
1180,1231,3,0,1180,0,435000,2008
1520,1588,2,0,1240,280,430000,2007
2000,4500,2,0,2000,0,417000,2010
3180,9255,2,0,3180,0,895950,2014
3050,4750,2,0,3050,0,563950,2014
2580,47480,1,0,1360,1220,332220,1953
6880,279968,2,3,4070,2810,1.49E+06,2007
2570,3600,2.5,0,2570,0,680000,2007
2950,3737,2,0,2270,680,825750,2012
1690,1760,2,0,1410,280,338000,2014
2790,6969,2,0,2790,0,535365,2012
1720,5234,2,0,1240,480,608000,2011
2890,5000,3,0,2890,0,930000,2014
1130,276170,1,0,1130,0,565000,2006
1460,1623,2,0,1260,200,495000,2005
2510,3819,2,0,2510,0,667000,2007
3390,7870,2,0,3390,0,495000,2014
3570,6054,2,0,3570,0,928990,2014
2280,5000,2,0,2280,0,345000,2006
2920,3000,2,0,2260,660,1.07E+06,2014
2590,6160,2,0,2590,0,519995,2014
3210,8001,2,0,3210,0,924000,2014
1230,3405,1,0,1230,0,295000,2010
3800,104979,2,0,3210,590,472000,2005
1500,2314,2,0,1500,0,405000,2005
2510,4090,2,0,1840,670,410000,2012
1400,1091,3,0,1400,0,419500,2007
1450,4667,2,0,1450,0,382000,2009
1390,1821,2,0,1180,210,370000,2007
3160,9072,2,0,3160,0,553000,2005
4350,7965,2,0,4350,0,2.07E+06,2013
2720,5771,2,0,2720,0,455950,2015
1290,1153,3,0,1290,0,331000,2008
1606,1452,3,0,1606,0,417250,2009
4460,2975,3,2,3280,1180,490000,2015
2800,5291,2,0,2800,0,325000,2011
3250,4800,2,0,2410,840,705000,2010
4310,7760,2,0,3260,1050,1.17E+06,2013
1310,915,2,0,1060,250,365000,2007
1240,1101,2,0,1080,160,403000,2009
1950,7263,2,0,1950,0,409000,2007
1800,1120,2,0,1800,0,391000,2011
2650,5600,2,0,2650,0,542525,2014
820,681,3,0,820,0,339950,2006
2620,7001,2,0,2620,0,499990,2012
3980,10249,2,0,3980,0,1.77E+06,2011
1660,2298,2,0,1260,400,608000,2009
2130,4028,2,0,2130,0,392000,2014
1790,66250,1.5,0,1790,0,320000,2003
1410,1988,2,0,1410,0,274800,2014
1330,1198,2,0,1080,250,325000,2007
2190,4866,2,0,2190,0,418500,2009
2540,5050,2,0,2540,0,300000,2006
2244,4079,2,0,2244,0,269950,2012
2026,7611,2,0,2026,0,358000,2010
1730,4086,2,0,1730,0,350000,2013
3910,8095,2,0,3130,780,782000,2007
1580,1487,3,1,1580,0,779000,2009
2510,3479,2,0,2510,0,685000,2007
1000,905,3,0,1000,0,305000,2006
1660,2500,2,0,1660,0,350000,2007
3060,4573,2,0,2410,650,775000,2012
1980,4500,2,0,1980,0,317750,2012
980,1179,2,0,980,0,438000,2010
1050,1609,2,0,1050,0,325000,2005
3080,4287,2,0,2230,850,830000,2012
1900,3800,2,0,1900,0,353000,2006
2200,6400,2,0,2200,0,460000,2010
1360,1167,3,0,1360,0,370000,2008
2238,7209,2,0,2238,0,330000,2011
2590,6474,2,0,2590,0,569888,2014
2517,3900,2,0,2517,0,353900,2014
3510,9084,2,0,3510,0,695000,2001
1290,1237,2,0,1060,230,288790,2008
2230,8642,1,0,1330,900,334950,2014
3140,7928,2,0,3140,0,869950,2013
3350,5025,2,2,2670,680,557500,2014
2245,4330,2,0,2245,0,389990,2014
1420,1189,3,0,1420,0,455000,2006
1560,2091,3,0,1560,0,598500,2006
2810,5497,2,0,2810,0,750000,2011
1630,1686,2,0,1330,300,729999,2014
1740,4497,2,0,1740,0,299950,2012
1390,1484,3,0,1390,0,374950,2007
1070,1089,2,0,900,170,386950,2009
2850,4551,2,0,2370,480,535000,2006
4100,7578,2,2,4100,0,890000,2011
3260,5974,2,1,2820,440,1.05E+06,2007
3660,4760,2,0,2840,820,1.11E+06,2014
2708,4772,2,0,2708,0,436952,2014
1800,2700,2,0,1800,0,365000,2011
1150,887,3,0,1150,0,288000,2007
2230,4006,2,0,2230,0,700000,2014
3540,159430,2,0,3540,0,800000,2007
2490,5500,2,0,1780,710,899000,2015
2670,4534,2,0,2670,0,465750,2007
1430,923,3,0,1410,20,485000,2008
2670,3800,2,0,2670,0,494995,2014
2555,5720,2,0,2555,0,255000,2006
1970,6295,2,0,1970,0,530000,2011
1980,2674,3,0,1980,0,435000,2007
2010,3300,2,0,1610,400,639000,2014
1270,1413,3,0,1270,0,440000,2007
3950,10856,3,0,3950,0,914500,2013
1870,5300,1,0,1870,0,580000,2009
1180,1688,2,0,1070,110,250000,2007
1420,1269,3,0,1420,0,410000,2007
2810,5046,2,0,2810,0,531155,2014
1400,1529,2,0,1400,0,358000,2005
1950,5689,2,0,1950,0,425000,2009
1930,3462,2,0,1930,0,326000,2004
2210,4861,2,0,2210,0,650000,2013
2630,3757,2,0,2200,430,749950,2008
1600,4888,1,0,1600,0,239950,2014
1480,1590,2,0,1150,330,315000,2010
750,1430,2,0,750,0,375000,2006
1290,1213,3,0,1290,0,375000,2007
1340,1151,3,0,1340,0,349000,2008
1020,1049,3,0,1020,0,450000,2008
2330,1944,2.5,0,1950,380,669950,2014
2360,5000,1,0,1390,970,504600,2008
1495,936,3,0,1405,90,400000,2006
3770,8501,2,0,3770,0,1.02E+06,2008
2890,13104,2,0,2890,0,518000,2006
1320,1125,3,0,1320,0,535000,2008
2330,4907,2,0,2330,0,337500,2013
3120,5001,2,0,3120,0,380000,2005
2960,15152,2,0,2960,0,875000,2004
1630,1598,3,0,1630,0,385000,2008
5230,8960,2,0,4450,780,1.99E+06,2014
3150,6599,2,0,3150,0,649500,2008
3280,11000,2,0,2320,960,1.05E+06,2008
1030,24750,1,2,1030,0,249000,1943
3130,5795,2,0,3130,0,525000,2008
1240,1666,2,0,1000,240,402000,2008
3560,8975,2,0,3560,0,1.75E+06,2014
2170,2752,2,0,2170,0,359800,2014
1520,3003,2,0,1520,0,330000,2009
1270,1062,2,0,1060,210,433000,2008
3610,4000,2,0,2640,970,1.01E+06,2007
3230,5200,2,0,2680,550,599832,2014
2300,8214,2,0,2300,0,312891,2013
1460,1296,2,0,1160,300,449000,2008
1750,1548,3,0,1750,0,495000,2013
3030,10335,2,0,3030,0,819995,2013
1522,1465,2,0,1248,274,407500,2006
3890,22000,2,0,3890,0,850000,2007
4590,35046,2,0,4590,0,1.72E+06,2008
4620,130208,2,0,4620,0,1.46E+06,2014
3220,9825,2,0,3220,0,579000,2012
3170,8093,2,0,3170,0,890776,2014
980,1010,3,0,980,0,352500,2008
2340,7724,1,0,2340,0,529000,2010
1620,1425,3,0,1540,80,484000,2009
1910,4408,3,0,1910,0,400000,2007
2420,6847,2,0,2420,0,649950,2009
3850,62726,2,0,3120,730,915000,2013
3220,10572,2,0,3220,0,534950,2006
3040,6425,2,0,3040,0,776000,2008
1496,1423,2,0,1248,248,370000,2006
1630,1500,3,0,1630,0,610000,2014
4200,5400,2,0,3140,1060,850000,2012
2430,7049,2,0,2430,0,443000,2007
4010,8252,2,0,4010,0,1.15E+06,2015
1510,1618,2.5,0,1330,180,453000,2011
2340,2810,2,2,1730,610,735000,2011
2700,8572,1,0,2700,0,810000,2007
4360,6240,2,3,2960,1400,1.56E+06,2008
7270,130017,2,0,6420,850,2.24E+06,2010
1350,886,3,0,1270,80,377500,2006
1380,1120,3,0,1380,0,482000,2008
1830,1988,2,0,1530,300,600000,2011
1470,1571,2,0,1180,290,420000,2007
2940,9172,2,0,2940,0,480000,2006
1110,1095,3,0,980,130,406000,2008
2790,5602,2,0,2790,0,505000,2009
3790,8797,2,0,3290,500,1.87E+06,2006
3570,6218,2,0,3570,0,942990,2014
1230,1097,3,0,1230,0,440000,2009
1370,913,2,0,1100,270,390000,2006
1380,1121,3,0,1380,0,475000,2008
1070,675,2,0,880,190,420000,2007
4920,50621,2,0,4280,640,1.41E+06,2012
5150,12230,2,2,3700,1450,1.38E+06,2007
2390,4000,2,0,2390,0,462500,2014
2460,8643,2,0,2460,0,579950,2011
3650,7090,2,0,3650,0,861111,2008
4300,108865,2,0,4300,0,1.45E+06,2014
1610,3764,2,0,1610,0,290000,2012
2610,4595,2,0,2610,0,535000,2008
1750,1381,3,0,1750,0,585000,2008
3310,5300,2,2,2440,870,670000,2008
5090,14823,1,0,4180,910,3.00E+06,2013
1060,1184,2,0,730,330,346000,2006
4420,16526,2,0,4420,0,1.33E+06,2013
2100,4097,2,0,2100,0,999999,2008
1650,1180,3,0,1650,0,599000,2014
2380,5737,2,0,2380,0,332000,2010
1170,1011,2,0,1170,0,336750,2009
2531,6843,2,0,2531,0,370000,2013
998,904,2,0,798,200,324000,2007
1333,1470,3,3,1333,0,338500,2009
4410,13000,2,3,2920,1490,1.88E+06,2014
1160,1073,2,0,880,280,402723,2007
2630,7770,2,0,2630,0,715000,2014
1160,1031,3,0,1160,0,459000,2008
2140,3628,2,0,1960,180,589999,2006
1980,5020,2,0,1980,0,405000,2007
3030,9053,2,0,3030,0,509900,2009
1490,1627,2,0,1190,300,327000,2009
2370,184231,2,0,2370,0,1.06E+06,2005
1820,1866,2,0,1570,250,327500,2008
1260,1125,2,0,810,450,249000,2011
4350,13405,2,0,4350,0,1.38E+06,2014
1100,638,3,0,1100,0,516500,2014
2050,15035,2,0,2050,0,465000,2006
2198,6222,2,2,2198,0,388000,2010
1230,1380,3,0,1230,0,549000,2013
1400,1512,2,0,940,460,553000,2006
1410,1250,2,0,1140,270,530000,2010
2110,1339,2,0,1410,700,747450,2014
1590,2656,2,0,1220,370,305000,2009
3370,4850,2,0,3370,0,540000,2007
4500,8130,2,0,4500,0,750000,2007
2930,5973,2,0,2930,0,422000,2008
2470,5100,2,0,2470,0,337000,2005
3080,5752,2,0,3080,0,579950,2014
2260,4440,2,0,2260,0,341780,2014
1670,2642,2,0,1350,320,710200,2008
1540,1428,3,0,1540,0,690000,2013
3830,8963,2,0,3120,710,1.70E+06,2014
980,1020,3,0,980,0,329000,2008
1450,5008,1,0,840,610,330000,2007
2850,5577,2,0,1950,900,608500,2014
1140,1201,2,0,1140,0,230000,2014
3070,4684,2,0,2190,880,785000,2009
1680,1570,3,0,1680,0,610950,2014
3087,5002,2,0,3087,0,399950,2014
4850,10584,2,4,3540,1310,3.57E+06,2007
1900,2631,2,0,1250,650,579000,2014
940,1768,2,0,940,0,362500,2009
1730,1229,2,2,1320,410,645000,2008
2780,6000,2,0,2780,0,594866,2013
2780,6000,2,0,2780,0,625000,2013
1500,1290,2,0,1220,280,490000,2006
710,1157,2,0,710,0,399950,1943
1260,900,2,0,940,320,380000,2007
1870,5000,2,0,1870,0,270000,2009
1430,1201,3,0,1430,0,505000,2009
1520,1488,3,0,1520,0,385000,2006
1210,1278,2,0,1020,190,414500,2007
2540,4760,2,0,2540,0,347500,2010
4910,9444,1.5,0,3110,1800,1.22E+06,2007
2770,3852,2,0,2770,0,572000,2014
1190,1200,3,0,1190,0,475000,2008
4170,8142,2,2,4170,0,1.09E+06,2006
2500,5995,2,0,2500,0,350000,2008
1530,981,3,0,1480,50,520000,2006
3600,9437,2,0,3600,0,679950,2014
3410,10125,2,0,3410,0,1.58E+06,2007
3118,7866,2,2,3118,0,541800,2014
3990,7838,2,0,3990,0,810000,2003
4470,8088,2,0,4470,0,1.54E+06,2008
1425,1179,3,0,1425,0,467000,2008
1500,11968,1,0,1500,0,224000,2014
2270,5536,2,0,2270,0,507250,2003
1490,1126,3,0,1490,0,429000,2014
2520,6023,2,0,2520,0,610685,2014
3510,7200,2,0,2600,910,1.01E+06,2009
1310,1294,2,0,1180,130,475000,2008
1530,1131,3,0,1530,0,360000,2009
2310,5813,2,0,2310,0,400000,2014
1020,1350,2,0,1020,0,402101,2009
1600,2388,2,0,1600,0,400000,2004
1020,1076,2,0,1020,0,325000,2008
